iets => something; anything; pander; some; somewhat; abstract; a bit; aught; rather
kans => chance; opportunity; possibility; fortune; luck; odds; probability; danger; prospect; risk
weeronline => weather online
er => there; it; yonder; there be; yon; over there; atthatplace; be
worden => become; get; be; grow; turn; concrete; fall; happen; catch a cold; darken
vandaag => today; day; to-day; nowadays; now
daar => there; because; since; over there; yonder; for; yon; as; 'cause; due to
later => later; see you later; cheers; afterwards; hind; hindmost; posterior; see you; later on; after
zo => so; thus; that; directly; as; immediately; right now; such; at once; forthwith
devies => motto; slogan; watchword; device; currency; devise motto
ook => too; also; as well; likewise; either; moreover; at that; absolutely; additionally; certainly
midden => middle; mid; center; centre; mean; amidst; midst; crown; inside; medium
helemaal => all; completely; entirely; wholly; totally; quite; clear; absolutely; altogether; fully
tot => until; till; to; towards; on; toward; upon; belong; up to; at
flink => solid; brave; energetic; considerable; gallant; very; big; considerably; large; sturdy
en => and; plus; what about; both; along with; as well as; in addition to; together with; too; one
zuiden => south
overigens => by the way; moreover; besides; otherwise; though; in any case; also; asfortherest; for the rest; fortherest
door => through; by; with; after; along; on; landlocked; due to; for; on account of
wolkenvelden => cloud fields
de => the; bus; able; exposure; one; outran; repaid; earthy; sneer; you
binnenland => hinterland; interior; internal; inland; midland; outback
relatief => relative; relatively; comparatively; concerning; in relation
dertig => thirty
bereikt => reached
onbeschermde => unprotected
uiteindelijk => finally; eventually; final; net; in the long run; ultimate; ultimately; at last; eventual; after all
kwartier => residence; quarter; dwelling; phase; accommodation; home; abode; domicile; neighborhood; neighbourhood
onweer => thunderstorm; storm; lightning; tempest; gale; thunder; electrical storm; lightning storm; thundershower; rainstorm
ietsjes => slightly
verbranden => burn; incinerate; cremate; burndown; consume; fire; scald; beburntdown; set light to; swinge
op => on; up; at; upon; by; upwards; in; worn; heighten; look
vermoedelijk => presumably; presumptive; putative; assumedly; conjectural; presumable; probable; probably; supposedly; alleged
zuidoosten => southeast; south-east; southeasterly; southeastern
dan => than; then; afterwards; subsequently; next; afterward; dan; consequently; so; accordingly
het => it; the; one; her; him; he; she; this; so; tothe
onophoudelijk => incessant; continuous; incessantly; ceaselessly; sustained; constantly; lasting; constant; unceasing; ceaseless
dinsdagochtend => Tuesday morning
breekt => breaks
wel => well; probably; spring; now; source; surely; though; why; do; yes
vanwege => because of; after; by; through; due to; for; on account of; owing to; becauseof; forsakeof
zee => sea; ocean; billow; lake; brine; deep; deep sea; drink; wave
ongeveer => about; approximately; around; odd; some; thereabouts; approximate; roughly; round; roundabout
begint => begins
erg => very; quite; important; serious; erg; bad; extremely; much; terribly; badly
zonkracht => sun power
warmer => warmer
schrijft => writes
schijnen => seem; shine; appear; look; strike; glow; act; appear to be; light; appeartobe
afkomstig => original; coming; coming from; native; native of; originally; originating
vervolgens => subsequently; next; then; thereafter; afterwards; afterward; accordingly; consequently; so; thus
van => of; from; on; surname; upon; belong; suffice; about; concerning; for
zal => shall
graden => degrees
zegt => says
dag => day; goodbye; hello; bye; hi; bye-bye; so long; daytime; farewell; good day
woensdag => Wednesday; wednesday
een => one; an; a; cast; some; globe-trot; be; by; characterise; characterize
dinsdag => Tuesday; tuesday
zonnebrandcrème => sun block
belooft => promises
n => finance
donderdag => Thursday; thursday
noordzee => north sea
pas => only; just; passport; pass; step; footstep; pace; stride; just now; gait
noordenwind => aquilon; boreas; north; north wind
veel => many; much; a lot; often; a lot of; plenty of; regularly; numerous; frequently; mazel tov
koude => cold; chill; coldness
kust => coast; shore; seaside; seashore; beach; edge; bank; coastal; seaboard; coastline
aan => on; to; at; toward; towards; upon; after; up; behind; by
zon => sun; Sun; daystar; day; fixed star; heat of the sun; star; päikesevalgus; sun in splendour; sunshine
wordt => is becoming
stijgen => rise; ascend; climb; grow; increase; accrue; arise; augment; lift; alight
temperatuur => temperature
welhaast => nearly; soon; almost; about; presently; shortly; speedily; approximately; practically; roughly
met => with; by; bus; on; to; through; fight; upon; acute; bear
nog => yet; still; even; as yet; other; already; at last; at long last; finally; heretofore
twintig => twenty; score; units
huid => skin; hide; pelt; integument; fur; leather; tegument; coat; derm; dermis
middag => noon; midday; afternoon; noontime; noonday; noontide; nooning; in the afternoon
te => too; at; in; to; inside; into; on; per; within; a
noorden => north; North
kan => jug; can; pitcher; pot; khan; ewer; canister; crock; jar; mug
eerst => first; firstly; previously; at first; initially; initial; primary; 1st; before; earlier
is => is; it's; are
in => in; inside; into; at; nest; on; per; within; during; a
binnen => inside; in; into; within; per; a; on; until; landlocked; internally
loop => course; tube; pipe; stream; barrel; run; gait; current; walk; gun barrel
warm => warm; hot; warmly; affectionate; goodhearted; heat; warm-hearted; caloric; fervent; fervently
maar => but; only; just; however; solely; exclusively; although; nevertheless; yet; I wish
al => already; all; yet; though; although; every; each; everyone; even though; at last
kouder =>  
treedt => occurs
gitaarspel => guitar play
dirty => dirty
prince => prince
ze => they; she; them; one; her; break a leg; elles; ils; it; she l
werkte => worked
samen => together; fellow; tandem; co-; with each other; co‐
zijn => be; his; are; its; her; bear; their; have; belong; conflict
amsterdam => amsterdam
dit => this; these; this here; it; that; thishere
voor => before; for; in front of; to; against; toward; towards; furrow; until; of
hidden => hidden
nummer => number; digit; numeral; cipher; song; issue; act; figure; track; digits
eerder => earlier; before; previously; formerly; sooner; ahead; rather; beforehand; in advance; in former times
hit => hit; nag; pony; success; hit song
single => single; single person
moonlight => moonlight
uit => out of; from; out; off; down; through; extinct; for; of; in
opvolger => successor; heir; scion
amerikaanse => american
figures => figures
scoorde => scored
films => movies
volledige => total
monáe => monae
eerste => first; prime; fore; chief; initial; initially; main; original; primary; 1st
voorverkoop => presale
album => album; book; scrapbook; LP; phonograph record; record
bracht => brought
horen => hear; belong; must; should; horn; read; listen; befit; befitting; harken
me => me; tome; I; I elandic; i
fun => fun
september => September; september
jaar => year; an; grade; solar year; twelvemonth; years
are => are; square decametre; ar; squaredecametre
we => we; us
start => start; beginning; commencement; starting; take off; launch; inception; incipience; initial; initiation
zangeres => singer; songstress; vocalist; singeress; female singer; femalesinger
vrijdag => Friday; friday
electric => electric
young => young
groep => group; circle; set; band; bunch; herd; team; moiety; bevy; collection
computer => computer; microcomputer; personal computer; terminal
lady => dame; lady; queen; king
haar => hair; her; its; their; she; hairs; his; fur; head of hair; him
meer => lake; more; loch; mere; on; any more; rather; most; one more; lough
zien => see; regard; show; think; witness; consider; view; behold; look; deem
was => wax; laundry; washing; dope; clothes; wash; beeswax; growth; was; were
onder => under; beneath; below; underneath; among; between; while; whilst; amongst; during
feel => feel
the => the
make => make
actrice => actress; actor
washington => washington
groepje => groupuscule
bewijzen => prove; demonstrate; show; acquit; evince; attest; remonstrate; certify; manifest; establish
aangeklaagd => sued
beïnvloeden => influence; affect; impact; interact; manipulate; act; control; impinge; rig; shape
banden => ties
politici => politicians
oekraïense => ukrainian
europese => european
dat => that; which; those; who; what; even though; it; that ... over there; that one; that one over there
mueller => mueller
manafort => manafort
heeft => it's; has
tekstberichten => mobile messaging; text messaging
zou => would
campagneteam => campaign team
hen => hen; chicken; them; fowl; they; ass; baby; billet-doux; chook; pig
naar => to; toward; towards; after; nasty; ill; sick; for; bad; unpleasant
stuurde => sent
gebeld => called
die => that; who; which; those; that one; these; whom; such; that ... over there; that one over there
trump => trump
regering => government; reign; administration; rule; ministry; control; ascendance; ascendancy; executive; governance
staat => state; nation; condition; country; status; realm; shape; standing; empire; estate
rechter => judge; right; recorder; justice; off; right hand; right-hand
februari => February; Horning; february
hebben => have; have got; able; own; I wish; bear with; if only; possess; stand; be
bij => bee; at; by; with; near; to; towards; about; toward; belong
hem => him; he; it; her; he l; him y; them; tohim
tussen => between; among; amongst; betwixt; inter
verklaringen => explanations
voorwaarden => requirements; conditions
rusland => russia
onderzoek => research; investigation; survey; examination; test; inspection; study; inquiry; physical; search
wilde => barbarian; savage
verhullen => disguise; conceal; veil; becloud; befog; dissemble; fog; haze over; obnubilate; obscure
vrijgelaten => released
oud => old; aged; back; ancient; stale; venerable; erstwhile; long in the tooth; oud; archaic
maandag => Monday; monday
lobbyen => lobby; lobbying
twee => two; deuce; pair; twain
fraude => fraud; con; racket; cheating; deception; deceit; embezzlement; cheat; misappropriation; rig
zogeheten => so-called
blijkt => turns out
leden => party; supporters; disciples; following; adherents; members; membership
hij => he; it; she; him; they; you; I; him y; s/he
doet => is doing
inleverde => hand in
witwassen => money laundering; launder; laundering; whitewash
stukken => papers; document; paper; regarding
rechtbank => court; tribunal; court of law; forum; judicature; law court; chancellery; courtroom; judiciary; law-court
hapsburg => hapsburg
hun => their; them; its; her; his; theirs; they; tothem
tegen => against; to; towards; by; toward; fight; from; with; per; upon
week => week; soft; slack; hebdomad; weak; flowing; gentle; melting; milk-and-water; sennight
uren => hours
blijft => remains
vrij => free; sufficiently; vacant; quite; rather; unoccupied; clear; enough; pretty; available
avond => evening; night; afternoon; even; early evening; late afternoon; eve; eventide; in the evening; nocturnal
westen => west; West; Occident; westerly
bewolking => clouds; cloud
zonneschijn => sunshine; sun; sunlight; shine
bepaalt => determines
koel => cool; cold; chilly; dispassionately; brittle; coldly; coolly; aloof; chill; distant
tijd => time; tense; age; while; period; hour; season; geological age; grammatical tense; temporal
vanuit => from; out of; outof
droog => dry; wry; austere; parched; arid; sec; brut; dried; drily; droughty
alleen => alone; only; just; solely; merely; solitary; singly; exclusively; lone; lonely
vooral => especially; particularly; above all; principally; specially; chiefly; mainly; primarily; in particular; notably
nu => now; nu; at present; nowadays; henceforth; well; currently; presently; right now; present
raakt => touches
wisselvallig => protean; faltering; precarious; tottering
vergelijkbaar => comparable; similar; alike; identical; same
vaker => more often
weerbeeld => reflection
halen => get; fetch; catch; hit; strike; run across; accomplish; achieve; arrive at; attain
hooguit => at most; atmost
of => or; whether; either; if; questionparticle; whether or not
bewolkt => cloudy; overcast; dismal; dreary; clouded; bleak; dark; depressed; desolate; dim
motregenen => drizzle; mizzle; mist; sprinkle
land => land; country; state; earth; nation; soil; field; landlocked; area; countryside
nacht => night; night-time; nighttime; Night Without End; at night
tamelijk => quite; relatively; fairly; sufficiently; rather; pretty; enough; some; somewhat; to some extent
mogelijk => possible; maybe; possibly; perhaps; feasible; mayhap; perchance; thinkable; can be; conceivable
regenen => rain; rained
toch => nevertheless; however; yet; surely; anyway; still; yes; indeed; rather; even so
limburg => limburg
geheel => whole; total; entire; entirely; wholly; altogether; completely; fully; integer; overall
nachtelijke => nocturnal
provincies => provinces
anders => else; otherwise; different; differently; other; in another way; unlike; or else; alien; changing
noordelijke => northern
druilerig => drowsy; rainy; sleepy
elke => each; any; every; @; at; at ... each; each at; each for; for ... each
tweede => second; sophomore; 2nd; another; runner-up
kwik => mercury; quicksilver; hydrargyrum
bui => shower; mood; whim; storm; caprice; fit; coldburst; drizzle; rain shower; squall
gaat => goes
even => even; momentarily; equally; as; likewise; so; that; awhile; alike; just
licht => light; bright; lite; lightly; insubstantial; shallow; superficial; weak; weakly; clear
helft => half; moiety
neemt => takes
daarin => therein; in it; in there
kinderen => children; offspring; kids
gaan => go; travel; bed; shall; sound; do; walk; ride; let's go; step
verhuizen => move; move house; migrate; relocate; remove; flit; move out; transmigrate
wending => turn; bank; roll; twist
foto => photo; photograph; picture; photography; still
zwanger => pregnant; expectant; with young; expecting; with child; gravid; big; enceinte; withyoung
opvallende => striking
familieleden => family members
man => man; husband; male; spouse; wife; guy; mate; fellow; bloke; old man
af => down; ready; finished; through; off; on; out; flawless; perfect; completed
nam => ok; took
gemist => missed
wereld => world; realm; universe; Earth; World; earth
lokale => local
maart => March; march
laten => let; leave; make; allow; get; hang; burn; down; line; cause
dorpje => village
falls => falls
heel => very; whole; entire; quite; wholly; all; complete; completely; entirely; fully
rouwadvertentie => death notice; obituary
oordeel => judgment; sentence; verdict; discretion; estimation; judgement; opinion; doom; impression; thought
winter => winter; winter (northern hemisphere); winter (southern hemisphere)
zij => she; they; silk; side; he; her; aspect; flank; hand; way
geboren => born; talented; natural; gifted; bear; birth; deliver; give birth; innate; be born
verloop => process; turnover; lawsuit; transformation; course; perspicacity; action; development; progress; alteration
overleden => deceased; dead; defunct; departed; late; decedent; passed away
inwoner => inhabitant; citizen; native; resident; dweller; indweller; habitant; denizen; tenant
dennis => dennis
huwelijk => marriage; matrimony; wedding; wedlock; hymeneals; marriage ceremony; nuptials; wedding ceremony; Holy Matrimony; alliance
broer => brother; sibling; bro; friar; male sibling; older brother; older sibling; younger brother; younger sibling
kreeg => received
californië => california
kathleen => kathleen
jay => jay
omschreven => described
krijgt => gets
zonder => without; sans; -less; absent; free; minus; lacking; no; with no; but
aldus => thus; so; therefore; in that way; in this manner; in this way; like that; like this; that way; this way
dehmlow => dehmlow
vrouw => woman; wife; female; queen; lady; spouse; dame; missus; husband; missis
negentiende => nineteenth
trouwde => married
krant => newspaper; magazine; gazette; journal; paper; periodical; daily newspaper; newsprint; daily; daily paper
achter => behind; after; back; rear; next; past; abaft; in back of; slow; astern
woorden => words
onverwachte => unexpected
berecht => tried
overleed => died
springfield => springfield
stel => pair; couple; set; outfit; suit; group; herd; heap; bunch; bevy
gazette => gazette
om => around; about; on; at; in order to; per; to; towards; upon; able
las => junction; weld; joggle; joint; scarf; welding
feit => fact; actuality; circumstance; event; datum; deed
werd => was
beter => better; rather; ranking; superior; bettor; out; preferable; superiorly
laatste => last; final; ultimate; latter; terminal; conclusion; end; son
leven => life; live; noise; be alive; din; ado; exist; occupy; racket; row
redwood => redwood
gina => gina
verschenen => last; past
advertentie => advertisement; ad; advert; announcement; commercial; notice; classified advertising
niet => not; no; staple; nope; miss; unavailable; nay; don't; rivet; there is not