kans => chance
weeronline => weather online
worden => darken
daar => there
later => later
zo => so
devies => device
midden => middle
tot => to
zuiden => south
overigens => besides
door => for
de => the
binnenland => hinterland
relatief => relative
dertig => thirty
kwartier => quarter
op => on
zuidoosten => southeast
dan => than
het => it
breekt => breaks
wel => well
zee => sea
begint => begins
erg => very
warmer => warmer
schijnen => shine
zal => shall
dag => day
woensdag => Wednesday
een => one
dinsdag => Tuesday
pas => pass
noordenwind => north wind
koude => cold
aan => on
zon => sun
temperatuur => temperature
met => bear
twintig => twenty
huid => hide
middag => midday
te => too
noorden => north
kan => can
eerst => first
is => is
in => in
warm => warm
al => all
gitaarspel => guitar play
dirty => dirty
prince => prince
werkte => worked
amsterdam => amsterdam
dit => this
voor => before
hidden => hidden
nummer => number
eerder => earlier
hit => hit
single => single
moonlight => moonlight
uit => out
amerikaanse => american
figures => figures
scoorde => scored
monáe => monae
eerste => first
album => album
bracht => brought
horen => horn
me => me
fun => fun
september => September
jaar => year
are => are
we => we
start => start
zangeres => singer
vrijdag => Friday
electric => electric
young => young
groep => group
computer => computer
lady => lady
haar => hair
meer => mere
zien => view
was => wax
onder => under
feel => feel
the => the
make => make
actrice => actress
washington => washington
groepje => groupuscule
politici => politicians
europese => european
dat => that
mueller => mueller
manafort => manafort
campagneteam => campaign team
hen => hen
die => these
trump => trump
staat => state
rechter => right
februari => February
hem => him
rusland => russia
oud => old
maandag => Monday
lobbyen => lobby
twee => two
fraude => fraud
hij => him
witwassen => whitewash
hapsburg => hapsburg
week => week
westen => west
koel => cool
tijd => time
droog => dry
alleen => alone
nu => nu
of => or
bewolkt => desolate
land => land
nacht => night
regenen => rain
limburg => limburg
provincies => provinces
elke => each
even => even
licht => light
helft => half
daarin => therein
kinderen => children
gaan => go
foto => photo
man => man
wereld => world
lokale => local
laten => let
falls => falls
winter => winter
geboren => born
overleden => deceased
inwoner => dweller
dennis => dennis
broer => brother
californië => california
kathleen => kathleen
jay => jay
dehmlow => dehmlow
negentiende => nineteenth
achter => after
woorden => words
springfield => springfield
stel => set
gazette => gazette
om => on
feit => fact
beter => better
laatste => last
leven => life
redwood => redwood
gina => gina
advertentie => advertisement
niet => not