nunca => nooit; nimmer; geen; ooit
meses => maand; maanden
derrota => nederlaag; verlies; verliezen
combatientes => strijders
devastado => verwoest
controlan => zij controleren
otra => ander; andere; anderen; een andere; nog een
podrían => kon
el => de; het; hem; hij
los => de; het; haar; hem; d’r; 'm; Nederland; ’m
intercomunitarias => gemoenschappelijkheid
las => de; het; d’r; haar; hem; 'm; ’m
lacra => litteken
colegios => hogescholen
mayoritaria => meerderheid
apertura => opening; diafragma
estarán => zal zijn
conozcan => weten
capital => hoofdstad
proporción => verhouding; evenredigheid
elegidos => gekozen
diputados => kamerleden
cerrarán => ze zullen sluiten
body => Rompertje
controlaban => ze controleerden
además => bovendien; ook; daarenboven; verder; daarbij; buitendien; behalve; eveneens; tevens; alsmede
guerra => oorlog; krijg; oorlogvoering; gevecht; slag
minoría => minderheid
caras => gezichten
queden => blijven
llamados => riep
tendrá => zal hebben
voté => ik heb gestemd
espera => afwachting; verwachting
evitar => vermijden; mijden; ontwijken; uit de weg gaan; verhinderen; voorkomen; afweren; decoreren; opsieren; sieren
hace => geleden; eertijds; maakt; voorbij
tras => achter; na; aan; na verloop van; over; achterna; bij; op het moment van
muy => erg; heel; zeer; bijster; bijzonder; aanzienlijk; grotendeels; aardig; goed; heerlijk
debería => moeten
también => ook; eveneens; tevens; evenzeer; mede; trouwens; alsmede; alsook; evenals; evenzo
principal => voornaamste; belangrijkste; hoofd-; hoofdzakelijk
tiene => heeft
datos => gegevens
poder => kunnen; macht; mogen; kracht; vermogen; berekend; capabel
predecesor => voorganger; vorige activiteit
desempleo => werkloosheid
comicios => verkiezing
comunidad => gemeenschap; gemeente; gemenebest; samenleving
afirma => staten
antigua => oud; oudheid
gubernamentales => regerings-
perpetrada => gepleegd
cambiar => veranderen; wisselen; wijzigen; variëren; aanpassen; afwisselen; werken; zich aanpassen; kenteren; ruilen
al => de; etsen
impedir => verhinderen; hinderen; belemmeren; beletten; voorkomen; maken; vertragen; weerhouden; bemoeilijken; blokkeren
vida => leven; levend; levensduur
su => zijn; haar; hun; uw; je; jouw; jullie
después => na; achteraf; daarna; dan; nadien; vervolgens; achter; naderhand; over; later
escuela => school; leerschool; kunstrichting; onderwijsinstelling
vuelta => draaien; terugtocht; wisselgeld; omwenteling; ronde; toer; achterkant; beurt; omdraaien; rondrit
fuerte => sterk; luid; krachtig; hard; straf; fiks; zwaar; geducht; machtig; luide
año => jaar; jaarcijfer; jaartal
votado => gekozen
que => dan; dat; die; wat; welke; als; mogen; opdat; waaraan; waarvoor
salvar => redden; behouden; bergen; verlossen; bewaren; opslaan; komen; sparen
periodista => journalist; reporter; verslaggever; redacteur; verslaggeefster; dagbladschrijfster; dagbladschrijver; journaliste
electorales => verkiezing
fuertes => sterk
casi => bijna; nagenoeg; vrijwel; haast; bijkans; schier; zo goed als; zowat; welhaast; amper
para => voor; tegen; om
esfumándose => fading
fuera => buiten; heen; over; uit; vandoor; verwijderd; voort; weg; buitenshuis; daarbuiten
precedentes => voorgaand
sur => zuiden; zuid; Zuiden
destrucción => vernietiging
afecta => beïnvloedt
victoria => overwinning; zege
dominan => heersen
cada => ieder; elk; elke; iedere; al; alle; per; alleman; beide; telkens
escaños => zetels
cinco => vijf
dignatarios => hoogwaardigheidsbekleders
anterior => vorig; voorgaand; voormalig; voorafgaand; verleden; vroeger; oud; voorgaande; vorige
cerrados => gesloten
saliente => projectie
partidos => lucifers
último => laatste; laatst; afgelopen; recent; achterste; dichtsbijzijnde; finaal; jongstleden
frente => voorhoofd
retomaron => ze hervatten
parte => deel; onderdeel; stuk
cerró => gesloten
representantes => vertegenwoordigers
no => nee; niet; neen; geen; nr
sufren => lijden
seguir => volgen; bijhouden; doorgaan; opvolgen; bewandelen; verdergaan; voortzetten; aanblijven; continueren; verderzetten
digirió => verteerd
permanecerán => ze zullen blijven
count => tellen
ser => zijn; wezen; bestaan; levend wezen; plaatsvinden; verkeren; werken; worden; existeren; persoon
va => zullen
quiere => wil
atribuirán => zal toeschrijven
empañada => beslagen
espero => ik hoop het
amenazase => bedreigd
tenga => hier; hierzo; kijk; ziedaar; ziehier
siglas => acroniem
país => land; staat; natie; gebied; gewest; regio; landstreek; streek; thuisland; volk
esta => dit; deze; dit hier
votar => stemmen; verkiezen; kiezen; balloteren; stemming
urnas => polls
deficientes => gebrekkig
en => in; bij; aan; op; te; binnen; over; per; voor; met
uno => een; één; men; je; 'n; ge; u; ze; ’n; en
la => het; de; haar; hem
espacio => ruimte; bestek; kamer; speling; wereldruim; heelal
sus => zijn; haar; hun; uw; de zijne; echte zwijnen
causa => oorzaak; reden; aanleiding; beweegreden; motief; doel; grond; proces; rechtszaak; zaak
estirpes => stammen
ocupando => het nemen
según => volgens; overeenkomstig; ingevolge; blijkens; conform; in overeenstemming met; op grond van; door; luid; uit hoofde van
llevado => gedragen
tenían => ze hadden
día => dag; etmaal; overdag; ochtend
compromisos => passiva
y => en
fue => het was
seguridad => veiligheid; zekerheid; beveiliging; veiligheidsdienst; borgstelling; geborgenheid
formación => samenstelling
jóvenes => jongeren; jongelui; jong
petrolera => olie
lugar => plaats; dorp; plek; ruimte; locatie; oord; zetel; aanleiding; betrekking; elders
menos => min; minder
acabar => beëindigen; eindigen; ophouden; afmaken; afwerken; opmaken; afsluiten; stoppen; uitmaken; voltooien
aliados => bondgenoot
gobierno => regering; overheid; bewind
primer => eerst; eerste
novedad => nieuwigheid; nieuwheid; nieuwtje; noviteit
entre => tussen; te midden van
mejorado => uitgebreid; benadrukt; vermeerderd; versterkt
martes => dinsdag
nuevo => nieuw; vers; opkomend; opnieuw; weer; nieuwe; recent
se => men
calles => straten
bloqueaba => ik heb geblokkeerd
desierta => uitgestorven
dispositivo => apparaat; toestel; huishoudstoestel; installatie; instrument; voorziening; hulpmiddelen
pasado => verleden; verleden tijd; afgelopen; praeterium; voorbij; muf; beurs; het verleden; laatstleden; onfris
primeros => eerste
enemigos => vijanden
incluyen => zij omvatten
cerca => dichtbij; nabij; bij; omheining; dierbaar; naverwant; ongeveer; hek; omheen; bij de hand
claves => sleutel
años => jarig; leeftijd; jaar; ouderdom
víctimas => slachtoffers
todo => alles; heel; gans; geheel; al; totaal; alle; compleet; helemaal; vol
chiíes => sjiieten
prohibida => verboden
ya => al; reeds; alreeds; nu; alvast; direct; meer; meteen; onmiddellijk; langer
este => deze
así => zo; aldus; zodanig; bijgevolg; alzo; zulk; zulke; dus; daarbij; dermate
nuevos => nieuw
deseos => wensen
número => aantal; getal
desempleado => werkloos; werkloosheid; werklozende; arbeidsloos
abed => in bed
hasta => tot; zelfs; totdat; naar; eens; tot aan; tot en met
desde => sinds; sedert; uit; van; vanaf; met ingang van; sindsdien; aangezien; vermits
había => ik had
estos => deze; die; dit
amenazas => bedreigingen
obtuvo => behaalde hij
liza => harder
conducen => leiden
votación => stemming
de => van; uit; tegen; door; niet-telbaar substantief; niet-telbaar zelfstandig naamwoord; over; sedert; sinds; vanaf
con => met; bij; voor; samen met; aan; binnen; dichtbij; elk; gemarmerde cake; hengelen
independencia => onafhankelijkheid; zelfstandigheid
llave => sleutel; kraan; Engelse sleutel; accolade; haan; schroefsleutel; dongle; klep; moersleutel; tap
barrio => wijk; buurt; stadswijk; kwartier
fuerzas => krachten
parece => zo lijkt het
un => een; één; ene; de; eens; het; ooit; op; je; men
una => een; één; nagel; ene; een paar; enige; enkele; sommige; teennagel; vingernagel
cual => dewelke; hetwelk; welk; hoe; welke; waarom; waarover; waarvan; waarvandaan
presentan => aanwezig
atacar => aanvallen; aantasten; aangrijpen; aanranden; vergrijpen; attaqueren; overvallen; tackelen; bestormen; aanvreten
decena => tien
cuatro => vier
lucha => gevecht; worstelen; slag; strijd; veldslag; worsteling; vecht; ruzie maken; twist; vechten
dos => twee
tensiones => spanningen
unidos => verenigd
violencia => geweld; agressie; gewelddaad; gewelddadigheid; geweldpleging; heftigheid
supervisar => controleren; surveilleren; waken
común => gemeenschappelijk; algemeen; gewoon
contrario => tegendeel; tegengestelde; tegengesteld; tegenovergesteld; tegenovergestelde; nadelig; strijdig; tegenpool; tegenwerkend; tegenwerkende
quienes => zij die
inédita => onuitgegeven
debilitados => verzwakte
explica => verklaart
vio => hij zag
perder => verliezen; missen; mislopen; misgrijpen; zoekmaken; absent zijn; afvallen; afwezig zijn; juffrouw; lekken
pensado => gedacht
sábado => zaterdag
altos => hoog
resultados => nasleep
primera => eerste; eerst; eerstgenoemde; deze
figuran => opgesomd
jubilado => gepensioneerd; gepensioneerde; in ruste; pensioentrekker; rustend
alterar => veranderen; wijzigen; manipuleren; met; onrechtmatig wijzigen; prutsen; modificeren; afwisselen
equilibrio => evenwicht; balans
elegir => kiezen; verkiezen; uitkiezen; uitlezen; uitpikken; uitzoeken; stemmen; aanduiden; aangeven; aanwijzen
están => zijn
respondan => antwoord
podría => kon
mismo => hetzelfde; dezelfde; gelijk; zelf; zelfde; ikzelf; mezelf; mijzelf; zelfs; identiek
iraquí => Iraaks
influencia => invloed; beïnvloeding; voordeel; gezag; macht; impact
contra => tegen; met
vez => keer; maal; beurt; een keer; eenmaal; eens; file; gelid; reeks; rij
encuentro => ontmoeting; bijeenkomst; vergadering; aanneming; aanvaarding; acceptatie; betrekking; binnengaan; entree; het vinden
alto => hoog; lang; groot
pero => maar; echter; doch; hoewel; in tegendeel; perenboom
preocupación => zorg; ongerustheid; belangstelling; opwinding; bezorgdheid; tobberij; betreffen; vooringenomenheid; vooroordeel
pese => desalniettemin; desondanks; in weerwil van; niettemin; ofschoon; ondanks; ondanks alles; ondanks dat; ongeacht; spijts
jugó => hij speelde
aéreo => bovengronds; met lucht gevuld; lucht; lucht-; luchtig
donde => waar; waarvan; waarvandaan; waarheen; bij; waarin
votos => stemmen
civiles => burgers
dinero => geld; poen; zilver
caída => val; vallen; ineenstorting; neerslag; ondergang; daling; stort
tarde => avond; namiddag; laat; middag; avondje; nachtje; valavond; vooravond; avondstond; late