corroe => corrodeert
nunca => nooit; nimmer; geen; ooit
meses => maand; maanden
derrota => nederlaag; verlies; verliezen
combatientes => strijders
devastado => verwoest
tres => drie; Cubaanse tres; derde
controlan => zij controleren
otra => ander; andere; anderen; een andere; nog een
podrían => kon
el => de; het; hem; hij
los => de; het; haar; hem; d’r; 'm; Nederland; ’m
intercomunitarias => gemoenschappelijkheid
las => de; het; d’r; haar; hem; 'm; ’m
lacra => litteken
durante => gedurende; tijdens; in; voor; hangend; ondertussen; over; terwijl; terzelfdetijd
colegios => hogescholen
millones => miljoenen
febrero => februari; sprokkelmaand; regenmaand; Februari; kortemaand; reinigingsmaand; schrikkelmaand; slijkmaand
policías => politie
mayoritaria => meerderheid
territorios => territoria
mohamed => mohamed
apertura => opening; diafragma; apertuur; perforatie
estarán => zal zijn
diciembre => december; wintermaand; December
conozcan => weten
capital => hoofdstad; kapitaal; fonds; vermogen; dood; hoofd-; bezitting; boerderij; goed; hoofdzakelijk
proporción => verhouding; evenredigheid; proportie; ratio; wiskundige proportionaliteit
movilización => mobilisatie
elegidos => gekozen
sistema => systeem; stelsel; bestel; Systeem; apparaat
diputados => kamerleden
cerrarán => ze zullen sluiten
facto => facto
body => Rompertje
controlaban => ze controleerden
confesionalismo => confessionalisme
además => bovendien; ook; daarenboven; verder; daarbij; buitendien; behalve; eveneens; tevens; alsmede
papel => papier; rol; papieren; personage; eend et; flutkrant; hoofdrol; roddelblad; woerd
estabilicen => stabiliseren
guerra => oorlog; krijg; oorlogvoering; gevecht; slag
minoría => minderheid; minoriteit
caras => gezichten
confesional => confessioneel
queden => blijven
llamados => riep
tendrá => zal hebben
haber => hebben; zijn; er; worden; bestaan; gebeuren; credit; er zijn; existeren; liggen
fronteras => borders
voté => ik heb gestemd
espera => afwachting; verwachting
evitar => vermijden; mijden; ontwijken; uit de weg gaan; verhinderen; voorkomen; afweren; decoreren; opsieren; sieren
irak => irak
hace => geleden; eertijds; maakt; voorbij
tras => achter; na; aan; na verloop van; over; achterna; bij; op het moment van
muy => erg; heel; zeer; bijster; bijzonder; aanzienlijk; grotendeels; aardig; goed; heerlijk
suní => sunni
debería => moeten
septiembre => september; herfstmaand; September
también => ook; eveneens; tevens; evenzeer; mede; trouwens; alsmede; alsook; evenals; evenzo
principal => voornaamste; belangrijkste; hoofd-; hoofdzakelijk; primair; hoofdzaak; balkon; belangrijk; belangrijkst; grond-
activó => geactiveerd
es => is; bent
tiene => heeft
alianza => alliantie; bondgenootschap; verbond; trouwring; verbintenis; overeenkomst; regeling; trouw; unie; verstandhouding
datos => gegevens; data; informatie
poder => kunnen; macht; mogen; kracht; vermogen; berekend; capabel; power; de mogelijkheid hebben; gevolmachtigde
predecesor => voorganger; vorige activiteit
desempleo => werkloosheid
comicios => verkiezing
nuri => nuri
comunidad => gemeenschap; gemeente; gemenebest; samenleving; community; gezelschap; communiteit; gemeenschappelijkheid; buitenpost
afirma => staten
antigua => oud; oudheid; antiek; ex; gewezen; middeleeuws; oudbakken; ouderwets; prehistorisch; voormalig
isis => isis
jaafar => jaafar
gubernamentales => regerings-
perpetrada => gepleegd
cambiar => veranderen; wisselen; wijzigen; variëren; aanpassen; afwisselen; werken; zich aanpassen; kenteren; ruilen
al => de; etsen
ministro => minister; bewindsman; dominee
crucial => cruciaal; doorslaggevend; kritiek; beslissend; hachelijk
impedir => verhinderen; hinderen; belemmeren; beletten; voorkomen; maken; vertragen; weerhouden; bemoeilijken; blokkeren
vida => leven; levend; levensduur; vida; aanzijn; hachje; in leven; levenswandel
su => zijn; haar; hun; uw; je; jouw; jullie; su; de zijne; d’r
posición => positie; houding; stand; ligging; plaatsvector; standpunt; plaats; posities; functie; mening
irán => iran
del => der; van de; de; del; nabla
después => na; achteraf; daarna; dan; nadien; vervolgens; achter; naderhand; over; later
escuela => school; leerschool; kunstrichting; onderwijsinstelling
alí => alí
vuelta => draaien; terugtocht; wisselgeld; omwenteling; ronde; toer; achterkant; beurt; omdraaien; rondrit
recientemente => recentelijk; onlangs; laatst; kortelings; kortgeleden; nieuw; recent; de laatste tijd; kort geleden; nu
fuerte => sterk; luid; krachtig; hard; straf; fiks; zwaar; geducht; machtig; luide
sami => Sami; Samisch; Saami; Saamen
año => jaar; jaarcijfer; jaartal
militares => militair
votado => gekozen
kirkuk => kirkuk
que => dan; dat; die; wat; welke; als; mogen; opdat; waaraan; waarvoor
yihadista => jihadist; Jihadistisch; moedjahedien
salvar => redden; behouden; bergen; verlossen; bewaren; opslaan; komen; sparen
periodista => journalist; reporter; verslaggever; redacteur; verslaggeefster; dagbladschrijfster; dagbladschrijver; journaliste
electorales => verkiezing
fuertes => sterk
casi => bijna; nagenoeg; vrijwel; haast; bijkans; schier; zo goed als; zowat; welhaast; amper
para => voor; tegen; om; per; aan; bij; naar; op; ten behoeve van; ten einde
esfumándose => fading
proclamada => geproclameerd
ei => ei
han => Han
fuera => buiten; heen; over; uit; vandoor; verwijderd; voort; weg; buitenshuis; daarbuiten
precedentes => voorgaand
sur => zuiden; zuid; Zuiden
destrucción => vernietiging; destructie; verwoesting; ravage; vernieling
afecta => beïnvloedt
victoria => overwinning; zege; victorie; triomf; victoria; succes
dominan => heersen
cada => ieder; elk; elke; iedere; al; alle; per; alleman; beide; telkens
escaños => zetels
hakim => hakim
maliki => maliki
fragmentación => fragmentatie
cinco => vijf
reconstrucción => reconstructie; wederopbouw
organizados => georganiseerd
dignatarios => hoogwaardigheidsbekleders
anterior => vorig; voorgaand; voormalig; voorafgaand; verleden; vroeger; oud; voorgaande; vorige
policía => politie; politieagent; agent; politieman; politieagente; agente; smeris; bedrijver; dealer; vertegenwoordiger
familia => familie; gezin; huis; huisgezin; verwanten; serie; geslacht; huishouden
omar => omar
iraq => irak
cerrados => gesloten
legislatura => legislatuur; wetgevende macht; zittingsduur
rehabilitar => rehabiliteren
saliente => projectie
estructuras => structuren
partidos => lucifers
último => laatste; laatst; afgelopen; recent; achterste; dichtsbijzijnde; finaal; jongstleden; ultiem; vorig
frente => voorhoofd; front; voorkant; voorzijde; gevel; frontlinie; fronton; tegen; voor
retomaron => ze hervatten
parte => deel; onderdeel; stuk; part; aandeel; elders; bonk; brok; deels; eindje
cerró => gesloten
iraquíes => irakezen
representantes => vertegenwoordigers
no => nee; niet; neen; geen; nr; no; hè; nr.; verboden; nee, niet
sufren => lijden
seguir => volgen; bijhouden; doorgaan; opvolgen; bewandelen; verdergaan; voortzetten; aanblijven; continueren; verderzetten
digirió => verteerd
permanecerán => ze zullen blijven
electoral => electoraal; kies-; stem-
estados => staten
count => tellen
campaña => campagne; veldtocht; platteland; actie; schildvoet; tent
ser => zijn; wezen; bestaan; levend wezen; plaatsvinden; verkeren; werken; worden; existeren; persoon
va => zullen
quiere => wil
sadam => sadam
atribuirán => zal toeschrijven
empañada => beslagen
provincias => provincies
espero => ik hoop het
amenazase => bedreigd
tenga => hier; hierzo; kijk; ziedaar; ziehier
siglas => acroniem
país => land; staat; natie; gebied; gewest; regio; landstreek; streek; thuisland; volk
candidato => kandidaat; kandidate; sollicitant
hikma => hikma
esta => dit; deze; dit hier
invasión => invasie; huisvredebreuk; inval
dictadura => dictatuur; autoritarisme; despotisme; tirannie
seis => zes
votar => stemmen; verkiezen; kiezen; balloteren; stemming
regionales => regionaal
organizado => georganiseerd
urnas => polls
deficientes => gebrekkig
en => in; bij; aan; op; te; binnen; over; per; voor; met
uno => een; één; men; je; 'n; ge; u; ze; ’n; en
circulación => circulatie; omloop; oplage; verkeer; bloedsomloop; passage
política => politiek; beleid; politica; politicus; aanpak; politieker; strategie; staatkunde
listas => lijsten
dominante => dominant; dominerend; doordringend; Dominant; dominantakkoord
la => het; de; haar; hem; la; d’r; er; hij; A; 'm
espacio => ruimte; bestek; kamer; speling; wereldruim; heelal; spatie; vertrek; Spatie; interplanetaire ruimte
contexto => context; samenhang
husein => husein
sus => zijn; haar; hun; uw; de zijne; echte zwijnen
causa => oorzaak; reden; aanleiding; beweegreden; motief; doel; grond; proces; rechtszaak; zaak
estirpes => stammen
ocupando => het nemen
según => volgens; overeenkomstig; ingevolge; blijkens; conform; in overeenstemming met; op grond van; door; luid; uit hoofde van
presentado => presenteren
llevado => gedragen
tenían => ze hadden
día => dag; etmaal; overdag; ochtend
kurdistán => koerdistan
compromisos => passiva
y => en; y; hoe zit het met; boeiend; lekker belangrijk
fue => het was
seguridad => veiligheid; zekerheid; beveiliging; veiligheidsdienst; borgstelling; geborgenheid
formación => samenstelling; formatie; vorming; opvoeding; opleiding
jóvenes => jongeren; jongelui; jong
petrolera => olie
estado => staat; toestand; land; situatie; rijk; stand; natie; gesteldheid; status; constellatie
sadr => sadr
lugar => plaats; dorp; plek; ruimte; locatie; oord; zetel; aanleiding; betrekking; elders
por => per; door; bij; voor; op; te; via; binnen; in; langs
menos => min; minder; minus; minteken; missen; voor
acabar => beëindigen; eindigen; ophouden; afmaken; afwerken; opmaken; afsluiten; stoppen; uitmaken; voltooien
aliados => bondgenoot
gobierno => regering; overheid; bewind; gouvernement; bestuur; heerschappij; houding; leiding; bestel; bevel
primer => eerst; eerste
novedad => nieuwigheid; nieuwheid; nieuwtje; noviteit
entre => tussen; te midden van; onder; ertussen; tussendoor; tussenin
mejorado => uitgebreid; benadrukt; vermeerderd; versterkt
martes => dinsdag; marter; marters
nuevo => nieuw; vers; opkomend; opnieuw; weer; nieuwe; recent
se => men; ze; je; u; zichzelf; elkaar; ge; jou; worden; haar
calles => straten
bloqueaba => ik heb geblokkeerd
economía => economie; zuinigheid; spaarzaamheid; volkshuishoudkunde
desierta => uitgestorven
marginal => marginaal
dispositivo => apparaat; toestel; huishoudstoestel; installatie; instrument; voorziening; hulpmiddelen
islámico => islamitisch; islamitische
pasado => verleden; verleden tijd; afgelopen; praeterium; voorbij; muf; beurs; het verleden; laatstleden; onfris
hadi => hadi
primeros => eerste
padre => vader; ouder; papa; pater; eerwaarde; mijnheer pastoor; pap; ouders; pappa; ouwe
candidatos => kandidaten
enemigos => vijanden
incluyen => zij omvatten
karrada => karrada
cerca => dichtbij; nabij; bij; omheining; dierbaar; naverwant; ongeveer; hek; omheen; bij de hand
amal => amal
claves => sleutel
corrupción => corruptie; omkoping; omkoperij; bederf; zedenbederf
años => jarig; leeftijd; jaar; ouderdom
víctimas => slachtoffers
todo => alles; heel; gans; geheel; al; totaal; alle; compleet; helemaal; vol
chiíes => sjiieten
lista => lijst; cedel; ceel; rol; wachtrij; band; haal; kandidatenlijst; nominatie; oplijsten
tropas => troepen; heer; leger
centro => centrum; middelpunt; midden; hart; binnenstad; binnenste; centre; kern; draaischijf; middelbaar
dólares => dollars
prohibida => verboden
ya => al; reeds; alreeds; nu; alvast; direct; meer; meteen; onmiddellijk; langer
este => deze; oosten; oost; dit; de; oriënt
tenor => tenor; teneur
así => zo; aldus; zodanig; bijgevolg; alzo; zulk; zulke; dus; daarbij; dermate
líder => leider; aanvoerder; chef; hoofd; baas; leidster; aanvoerster; bazin; cheffin; chief
nuevos => nieuw
deseos => wensen
número => aantal; getal; nummer; hoeveelheid; tal; kwantiteit; drie; hekje; kruisje; maat
desempleado => werkloos; werkloosheid; werklozende; arbeidsloos
abed => in bed
hasta => tot; zelfs; totdat; naar; eens; tot aan; tot en met
desde => sinds; sedert; uit; van; vanaf; met ingang van; sindsdien; aangezien; vermits
popular => populair; getapt; veelgeliefd; geliefd; gewild; in trek; algemeen; volk; volks
local => lokaal; plaatselijk; regionaal; faciliteit; inrichting; voorzienining; beleg; belegering; bril; inheems
wadi => wadi
había => ik had
estos => deze; die; dit
provincia => provincie; boeren-; land-; plattelands; gouw
amenazas => bedreigingen
obtuvo => behaalde hij
liza => harder
conducen => leiden
comunistas => communisten
organización => organisatie; beheersing; ordening; organiseren; structuur; organizatie
votación => stemming
de => van; uit; tegen; door; niet-telbaar substantief; niet-telbaar zelfstandig naamwoord; over; sedert; sinds; vanaf
con => met; bij; voor; samen met; aan; binnen; dichtbij; elk; gemarmerde cake; hengelen
a => aan; naar; tegen; op; bij; met; te; tot; om; voor
independencia => onafhankelijkheid; zelfstandigheid
diwaniyah => diwaniyah
llave => sleutel; kraan; Engelse sleutel; accolade; haan; schroefsleutel; dongle; klep; moersleutel; tap
barrio => wijk; buurt; stadswijk; kwartier; Barrio; buurt of wijk; gebied
fuerzas => krachten
oficiales => officieel
parece => zo lijkt het
haider => haider
un => een; één; ene; de; eens; het; ooit; op; je; men
una => een; één; nagel; ene; een paar; enige; enkele; sommige; teennagel; vingernagel
cual => dewelke; hetwelk; welk; hoe; welke; waarom; waarover; waarvan; waarvandaan
presentan => aanwezig
función => functie; ambt; baan; betrekking; plaats; werkkring; dienst; voorstelling; magazijn; provisiekamer
límites => limiet
atacar => aanvallen; aantasten; aangrijpen; aanranden; vergrijpen; attaqueren; overvallen; tackelen; bestormen; aanvreten
decena => tien
cuatro => vier; Cuatro
periodo => periode; tijdvak; menstruatie; maandbloeding; maandstonden; ongesteldheid; regels; tijdperk
región => regio; gebied; streek; gewest; land; landstreek
lucha => gevecht; worstelen; slag; strijd; veldslag; worsteling; vecht; ruzie maken; twist; vechten
dos => twee
tensiones => spanningen
inglés => Engels; Engelsman; Engelse; Engelsen; engels; Brit
unidos => verenigd
violencia => geweld; agressie; gewelddaad; gewelddadigheid; geweldpleging; heftigheid; violentie
supervisar => controleren; surveilleren; waken
común => gemeenschappelijk; algemeen; gewoon; gemeen; gemene; gewone; veelvoorkomend; gezamenlijk; merel; normaal
contrario => tegendeel; tegengestelde; tegengesteld; tegenovergesteld; tegenovergestelde; nadelig; strijdig; tegenpool; tegenwerkend; tegenwerkende
quienes => zij die
yihadistas => jihadisten
inédita => onuitgegeven
debilitados => verzwakte
explica => verklaart
hombres => heren; lieden; lui; mannen
dominó => domino; dominosteen
vio => hij zag
perder => verliezen; missen; mislopen; misgrijpen; zoekmaken; absent zijn; afvallen; afwezig zijn; juffrouw; lekken
grupo => groep; team; verzameling; kring; band; afdeling; detachement; groepering; hoop; cluster
presentaron => ze gepresenteerd
moqtada => moqtada
pensado => gedacht
hora => uur; stonde; duur; tijd; tijdstip; u
sábado => zaterdag; sabbat
altos => hoog
militar => militair; soldaat; militairen; krijgs-; militaire; oorlogs-; oorlogvoeren; strijden
resultados => nasleep
primera => eerste; eerst; eerstgenoemde; deze
figuran => opgesomd
jubilado => gepensioneerd; gepensioneerde; in ruste; pensioentrekker; rustend
ammar => ammar
alterar => veranderen; wijzigen; manipuleren; met; onrechtmatig wijzigen; prutsen; modificeren; afwisselen
equilibrio => evenwicht; balans
elegir => kiezen; verkiezen; uitkiezen; uitlezen; uitpikken; uitzoeken; stemmen; aanduiden; aangeven; aanwijzen
están => zijn
respondan => antwoord
podría => kon
punto => punt; stip; komma; oog; score; Punt; spikkel; breien; point; aanwijzen
mismo => hetzelfde; dezelfde; gelijk; zelf; zelfde; ikzelf; mezelf; mijzelf; zelfs; identiek
bagdad => bagdad
político => politicus; politiek; staatsman; politieker; politica
mosul => mosoel
iraquí => Iraaks; Irakees
influencia => invloed; beïnvloeding; voordeel; gezag; macht; impact; influentie; overhand; overwicht
referéndum => referendum; volksraadpleging
autónoma => autonoom; zelfstandig
contra => tegen; met; contra; nadeel; jegens; tegenaan; gebrek; minpunt; schaduwzijde; tegenover
amiri => amiri
vez => keer; maal; beurt; een keer; eenmaal; eens; file; gelid; reeks; rij
encuentro => ontmoeting; bijeenkomst; vergadering; aanneming; aanvaarding; acceptatie; betrekking; binnengaan; entree; het vinden
alto => hoog; lang; groot; alt; luid; hard; verheven; ongeloofwaardig; rijzig; altviool
pero => maar; echter; doch; hoewel; in tegendeel; perenboom
kurdos => koerden
veteranos => veteranen
norte => noorden; noord
preocupación => zorg; ongerustheid; belangstelling; opwinding; bezorgdheid; tobberij; betreffen; vooringenomenheid; vooroordeel
pese => desalniettemin; desondanks; in weerwil van; niettemin; ofschoon; ondanks; ondanks alles; ondanks dat; ongeacht; spijts
jugó => hij speelde
aéreo => bovengronds; met lucht gevuld; lucht; lucht-; luchtig
abadi => abadi
nivel => niveau; waterpas; hoogte; peil; etage; verdieping; laag; nivo; constant; graad
ninguna => niemand; geen
populista => populistische
fahmi => fahmi
donde => waar; waarvan; waarvandaan; waarheen; bij; waarin
parlamento => parlement; volksvertegenwoordiging
votos => stemmen
civiles => burgers
dinero => geld; poen; zilver
caída => val; vallen; ineenstorting; neerslag; ondergang; daling; stort
tarde => avond; namiddag; laat; middag; avondje; nachtje; valavond; vooravond; avondstond; late
religiosos =>  
incidente => incident; episode; gebeuren; gebeurtenis; onderbreking; ontregeling; voorval
religioso => religieus