corroe => corrodeert
tres => drie
durante => gedurende
millones => miljoenen
febrero => februari
policías => politie
territorios => territoria
mohamed => mohamed
apertura => apertuur
diciembre => december
capital => kapitaal
proporción => proportie
movilización => mobilisatie
sistema => systeem
facto => facto
confesionalismo => confessionalisme
papel => papier
estabilicen => stabiliseren
minoría => minoriteit
confesional => confessioneel
haber => hebben
fronteras => borders
irak => irak
suní => sunni
septiembre => september
principal => primair
activó => geactiveerd
es => is
alianza => alliantie
datos => data
poder => power
nuri => nuri
comunidad => community
antigua => antiek
isis => isis
jaafar => jaafar
ministro => minister
crucial => cruciaal
vida => vida
su => su
posición => positie
irán => iran
del => der
alí => alí
recientemente => recentelijk
sami => Sami
militares => militair
kirkuk => kirkuk
yihadista => jihadist
para => per
proclamada => geproclameerd
ei => ei
han => Han
destrucción => destructie
victoria => victorie
hakim => hakim
maliki => maliki
fragmentación => fragmentatie
reconstrucción => reconstructie
organizados => georganiseerd
policía => politie
familia => familie
omar => omar
iraq => irak
legislatura => legislatuur
rehabilitar => rehabiliteren
estructuras => structuren
último => ultiem
frente => front
parte => part
iraquíes => irakezen
no => no
electoral => electoraal
estados => staten
campaña => campagne
sadam => sadam
provincias => provincies
candidato => kandidaat
hikma => hikma
invasión => invasie
dictadura => dictatuur
seis => zes
regionales => regionaal
organizado => georganiseerd
circulación => circulatie
política => politiek
listas => lijsten
dominante => dominant
la => la
espacio => spatie
contexto => context
husein => husein
presentado => presenteren
kurdistán => koerdistan
y => y
formación => formatie
estado => staat
sadr => sadr
por => per
menos => minus
gobierno => gouvernement
entre => onder
martes => marter
se => ze
economía => economie
marginal => marginaal
islámico => islamitisch
hadi => hadi
padre => vader
candidatos => kandidaten
karrada => karrada
amal => amal
corrupción => corruptie
lista => lijst
tropas => troepen
centro => centrum
dólares => dollars
este => oosten
tenor => tenor
líder => leider
número => nummer
popular => populair
local => lokaal
wadi => wadi
provincia => provincie
comunistas => communisten
organización => organisatie
a => aan
diwaniyah => diwaniyah
barrio => Barrio
oficiales => officieel
haider => haider
función => functie
límites => limiet
cuatro => Cuatro
periodo => periode
región => regio
inglés => Engels
violencia => violentie
común => gemeen
yihadistas => jihadisten
hombres => heren
dominó => domino
grupo => groep
presentaron => ze gepresenteerd
moqtada => moqtada
hora => uur
sábado => sabbat
militar => militair
ammar => ammar
punto => punt
bagdad => bagdad
político => politicus
mosul => mosoel
iraquí => Irakees
influencia => influentie
referéndum => referendum
autónoma => autonoom
contra => contra
amiri => amiri
alto => alt
kurdos => koerden
veteranos => veteranen
norte => noorden
abadi => abadi
nivel => niveau
ninguna => niemand
populista => populistische
fahmi => fahmi
parlamento => parlement
incidente => incident
religioso => religieus