nationalist => Nationalist; nationalistisch; Nationalistin; nationalbewusst
alon => allein
bilingual => bilingual; Bilingue
asphalt => Asphalt; asphaltieren; asphaltiert
arcade => Arkade; Passage
papacy => Papat
reincarnated => reinkarnierte; reinkarniert
abdominal => abdominal; abdominell; Abdominal-
hypoxia => Hypoxie; Anoxia
opus => Opus; opus
cedar => Zeder; zedern
morphine => Morphin; Morphium; morphin
dispersed => dispers; dispergiert
photos => Fotos
illuminati => illuminatenorden
visage => Visage
flank => Flanke; flankieren
excellent => exzellent
russia => russland
tinder => Zunder; Zünder
washboard => Washboard
wh => wh
scooping => schöpfend
temple => Tempel; Tempel -s
indigenous => indigen
kg => kg
barbarian => Barbar; barbarisch; Barbarin
title => betiteln
acrobat => Akrobat; Akrobatin; Akrobatik
susan => susanne
consent => Konsens
campo => campo
woodsman => Forstmann
slugger => Slugger
clowning => Clownerie; Clown
clothesline => Wäscheleine; Wäschestange
sing => singen; besingen; Singen
majority => Majorität
panthers => Panther; Panter
banshee => Banshee
comanche => komantsche; komantschin
lexington => lexington
hawaiian => hawaiisch; Hawaiisch; hawaiianer; hawaiianisch
topless => topless
loyalist => Loyalist; Royalist
fog => Smog
genoa => Genua
guacamole => Guacamole
accessory => Accessoire; akzessorisch
beeping => piepend
cirque => zirkus
luckiest => glücklichste
contraband => Konterbande; Kontrebande
cracking => Cracken; knackend; krachend; Kracken
multimillionaire => Multimillionär; Multimillionärin; Millionär
phlegm => Schleim; Phlegma
streamline => Stromlinie
damascus => damaskus
ornamental => ornamental
hydroelectric => hydroelektrisch
crocs => crocs
havel => havel
enrage => anregen
margin => Marge
bumblebee => bumblebee
extravagance => Extravaganz
execute => exekutieren
kremlin => Kreml
dora => dora
babylonian => babylonisch
sati => Sati; sati
genial => genial
procedural => prozessual
pylon => Pylon; Pylone
nonprofit => non-profit; profit
snoopy => Snoopy
nipples => Nippel; Noppen
tutoring => Tutoring
interned => internierte; interniert
grecian => griechisch
mn => mn
eloquently => eloquent; eloquente
mines => Minen
iceberg => Eisberg
dah => Dah
nutritious => nutritiv
pontiff => Pontifex
aviator => Aviatiker
delegated => delegierte; delegiert
tallinn => tallinn
rh => rh
panicky => panisch
implicate => implizieren; Implikatur
deduction => Deduktion; deduktive Methode
stella => stella
correspondents => Korrespondenten; Korrespondentinnen
facelift => Facelift; facelifting
gertrude => gertrud
plume => Plume
lair => lagern
fundraising => Fundraising
program => Programm; programmieren; Computerprogramm
baloney => Lyoner
absorbing => absorbierender
grisly => grässlich; grausig; grauslich
bohemia => böhmen
arty => hart
bush => Busch; Gebüsch
migraine => Migräne; migräne; Hemikranie
constructive => konstruktiv
gratis => gratis
bravery => Bravour
sensor => Sensor; sensor
piloted => gelotst
exempt => exempt
sumerian => sumerer; sumerisch
alternator => Generator; Alternator
mic => mic
rajah => Raja; rajah
ninja => Ninja; ninja
tiniest => winzigste; winzigsten
colliding => kollidierend
peels => pellt
regatta => Regatta; Ruderregatta
yorkshire => yorkshire
leprechaun => Leprechaun
future => Futur
vega => wega
researcher => Gelehrter; Rechercheur
welcome => willkommen
spitter => Spucker
patriarch => Patriarch
glorify => glorifizieren
translation => Translation; translation
media => Medium; Medien; Media
childish => kindisch
broadband => Breitband; Breitband-
currently => zurzeit
made => machen; machte
unproven => unerprobt
reported => referiert
muse => Muse
pirates => Pirat; Piraten; Piraten...
nominee => Nominierte
blocked => blockiert
pancreatic => pankreatisch; Pankreas-
yiddish => jiddisch
overlook => Überblick
signal => Signal; signalisieren
whisky => Whisky; Whiskey; Whisky -s
apologetic => apologetisch
pager => Pager
veneer => Furnier; Veneer
courageously => couragiert
tactic => Taktik
liniment => Liniment
decor => Dekor
widest => weiteste; am weitesten
insinuate => insinuieren
planning => Planung; Planen; planend
organizer => Organisator; Organizer; Gründer; Organisierer
poaching => Poaching
never => nimmer
sweep => Sweep
decompose => dekomponieren
spritzer => Spritzer
ladyship => Ladyschaft
syrup => Sirup; Syrup
reader => Leser; Reader
sharpie => Scharpie
constitutional => konstitutionell
glass => Glas; glas; Glas -es
undersigned => unterzeichnet; unterschrieben
herald => Herold; Wappenherold
hamsters => Hamster; Goldhamster
aruba => aruba
tropics => Tropen; tropenregion; tropische Zone; tropische zone
pendant => Pendant
ariel => ariel
tinnitus => Tinnitus
shire => Shire
fakir => Fakir
soju => Soju
noble => nobel
ineffectual => ineffektiv
domination => Dominanz
instability => Instabilität; Labilität
distal => distal
hobby => Hobby
clippers => Klipper
anatomically => anatomisch; anatomischen
loudspeaker => Lautsprecher
epic => episch; Epik
angles => angeln; angelt
madeleine => Madeleine
data => daten
vicomte => vicomte
digested => digeriert
clubs => Clubs; Klubs
sandbag => Sandsack
internal => intern; innerlich; inner
infestation => Infestation; Invasion
brokerage => Courtage
caterpillar => Caterpiller; Caterpillar
satire => Satire
coccyx => Coccyx
brunei => Brunei
pedestal => Podest; Piedestal
rudder => Ruder
festivals => Festtag
gnawing => nagend
tartarus => tartaros
chuckling => glucksend; gluckend
sexist => Sexist; sexistisch; Sexistin
priceless => preislos
outpatient => ambulanter Patient
sibyl => Sibylle
consul => Konsul; Consul
hasta => hasta
limes => Limes; Limonen
slipstream => Slipstream
morally => moralisch; verfallen
position => Posten
given => gegeben
unreachable => unerreichbar
intelligentsia => Intelligenz; Intelligenzija; Intelligenzia; Intelligenzschicht
oceans => Ozean; Ozeane
dauphin => Dauphin
quartermaster => Quartiermeister
stinks => stinkt
ecstatic => ekstatisch
multinationals => multinationale Unternehmen
ruining => ruinierend
abacus => Abakus; Abacus; abakus
flippers => Flipper
tosser => Wichser
satchel => Tasche
indifferent => indifferent
unholy => unheilig
jurassic => jura
bethlehem => bethlehem; betlehem
province => Provinz; provinz
substantially => substanziell; substantiell
hardware => Hardware
monstrous => monströs
chloroform => Chloroform; chloroformieren
foster => fördern
evaporating => Evaporieren
overqualified => überqualifiziert
railing => Reling
marauder => Marodeur; räuber
ignorance => Ignoranz
extracts => Extrakt; extrahiert
derivative => Derivat; derivativ; Derivativ; Derivativum; Derivativ-Geschäft
amber => Amber; amber
speeches => Ansprachen; Sprachen
calculation => Kalkulation
kilo => Kilo
zinc => Zink; zink; zinken
pricks => prickelt
healer => Heiler; Heilerin
nai => Nai
taka => Taka
stares => starrt
freak => Freak
milkshake => Milchshake; Milkshake
argentinean => argentinier; argentinierin; argentinisch
comma => Komma; komma; Komma -s
reading => Lesung
glitter => glitzern; glänzen; Glitter; glitzernd
utmost => äußerst
gimp => Gimpe
qualifying => Qualifikation; Qualifying; qualifizierend
recruitment => Rekrutierung
swede => schwede; schwedin
antibiotics => Antibiotikum; Antibiotika
constantine => constantine; konstantin
seventh => siebte; siebente; Siebentel; siebenter; siebentes; sieb(en)te
artichoke => Artischocke
collectors => Kollektoren
radiance => Strahldichte
roughest => rauhste; am rauhesten
sultan => Sultan; Sweet Sultan
feedback => Feedback; Feed-back
correspond => korrespondieren
stone => steinigen; steinern
conceited => eitel
median => Median; Medianwert; median
grip => greifen
rounding => Rundung; Runden; Abrundung; runden; rundend
seventeenth => siebzehnte; siebzehnt
stumble => taumeln
proportion => Proportion
stupendous => stupend
canter => Kanter; Canter
adolescents => Adoleszenten
inoculation => Inokulation; inokulation
melancholic => melancholisch; Melancholiker; Melancholikerin
passkey => Pass; pass
hostesses => Hostessen
watchtower => Watchtower
hurricanes => Hurrikans; Hurrikan; Hurrikane
humanity => Humanität
bosnia => bosnien
muttering => murmelnd
ventilate => ventilieren; Ventilator; entlüften
zigzag => zickzack
communique => Kommunikee; Kommunique; Kommunique -s; Kommuniqué
medal => Medaille
juries => Jurys
trivia => Trivia
castration => Kastration; Kastrierung; kastration; castration
hails => hagelt
chile => Chili; chile
shin => Schin; Schiene
oslo => oslo
prolific => produktiv; erfolgreich
humour => Humor
transcontinental => transkontinental; überkontinental
barracks => Baracke
mumps => Mumps
royally => total
rumba => Rumba
andromeda => andromeda
confiscated => konfisziert; konfiszierte
gleaming => gleißend
clash => Clash
systems => Systeme; System...
compatibility => Kompatibilität
hangs => erhängt; hängt
interaction => Interaktion; Unterhaltung
palaver => Palaver; Theater
solomon => solomon; salomo; salomon
actual => aktuell
perfect => perfekt; Perfekt
jaguar => Jaguar
judea => judäa
unannounced => unangemeldet
premiere => Premiere; Prämie
purification => Raffination
convert => konvertieren; Konvertit; ändern
academia => Akademie; akademia
aristotle => aristoteles
gape => gaffen; gaffe
horizontally => horizontal
bailout => Bail-out; Bailout
evaluated => evaluiert; valutiert
flute => Flöte; Querflöte; Flute
rest => Rest; rasten; Rast
embryos => Embryen; Embryos; Embryoen
interning => internierend
reside => residieren
passages => Passagen
hemorrhagic => hämorrhagisch
compromises => Kompromisse
stations => Stationen
lukewarm => lauwarm; angewärmt; handwarm
aspen => Espe; Aspe; Espenholz; Pappel
registration => Registrierung
chassis => Chassis
decorative => dekorativ
quickie => Quickie
disrespectful => respektlos
monarchy => Monarchie
alumnus => Alumnus
cruel => brutal
mascot => Maskotte
proportional => proportional
unwitting => unwissentlich; unwissend
directory => Directory
bridge => Bridge
squall => Schwall
hosted => gehostet
pupil => Pupille
tee => Tee; tee
totem => Totem
horrific => horrend
resignation => Resignation
recycling => Recycling; Rezyklierung; Recyceln
hasten => hasten
mandolin => Mandoline
apropos => apropos; a propos; à propos
cannibals => Kannibalen; Kannibale
duct => Ductus
virtual => virtuell; Virtualität
gargantuan => gargantuesk
impromptu => Impromptu; improvisiert
asia => asien; asia
gesundheit => Gesundheit
diss => dissen; Diss; Dissen
tricky => verzwickt; trickreich
handcrafted => handgearbeitet
spares => Aufgespartes
civilized => zivilisiert; zivilisierte
privatization => Privatisierung; Privatisation
exact => exakt
odin => odin; wodan
upwards => aufwärts
suffragette => Suffragette; Suffragetten; suffragetten
regrouping => Umgruppierung
battalion => Bataillon
newborn => neugeboren; Neugeborene; Neugeborenes; Neugeborener
discriminating => diskriminierend
fascism => Faschismus; faschismus
entry => Eintrag
prostitution => Prostitution; Prostituition
fields => Feld; felder
bodega => Bodega
labels => Labels
unsaid => ungesagt
overhead => Overhead
atrophy => Atrophie; Athrophie
shampoos => Schampons; Shampoos
identifying => Identifizierung; identifizierend; Identifikation
klingon => Klingone; klingonin; klingonisch
purr => Surren; knurren
referencing => referenzierend
figures => Figuren
manifestation => Manifestation
laxative => Laxativum; Laxativ
zhou => zhou
millimetre => Millimeter
microwave => Mikrowelle; Mikrowellen; mikrowellen
inhibitors => Inhibitoren
petals => Petal
coupling => Kopplung; Kupplung; Einkopplung; Koppelung; Verkupplung
fluorescent => fluoreszierend; fluoreszent
reaper => reaper
girder => Binder
tangent => Tangente; Tangens; Tangenten-; Tangential-
unsettled => unbeständig
conserving => konservierend
bod => Bod; Body; Cod
aerobic => aerob; Ärobic; Aerobic
ottoman => Ottomane; Ottoman
besides => überdies
beware => bewachen
morale => Moral
subjective => subjektiv
deacon => Diakon
sms => sms
ascendant => aszendent; Aszendent
proxy => Proxy
compulsive => kompulsiv
reclaimed => reklamiert; reklamierte
bigamy => Bigamie
mannequins => Mannequins
argon => Argon
basque => baske; baskin
castrate => kastrieren; Kastrat
incoherently => inkohärent
spirals => Spiralen
from => vom
inflame => entflammen; entflamme
fiddler => Fiedler
portals => Portale; Portalseiten
hollander => Holländer
denim => Denim
wanda => wanda
knobby => knorrig
chupacabra => chupacabra
striving => Anstrengung; strebend
hecate => hekate
espresso => Espresso; espresso
got => Got
phosphorous => phosphorig; Phosphor; Phosphor-; phosphor
ultraviolet => ultraviolett; Ultraviolett; Ultraviolettstrahlung; ultraviolett Strahlen; ultraviolette Licht
hereditary => hereditär; Heredität
help => helfen
alligator => Alligator; Echte Alligatoren; Alligatoridae; echte alligatoren
shaver => Bader
charades => Scharade; Scharaden
capacity => Kapazität
potentially => potentiell; potenziell; eventuell
sovereigns => souveräne
dresden => dresden; dresdner
guitar => Gitarre; guitarre
succulent => Sukkulente; sukkulent
funds => Fonds; gefunden
aquarius => aquarius
oldest => älteste; Ältester; ältest; ältester; Älteste
militia => Miliz
bobs => Bobs
korean => koreanisch; Koreaner; Koreanerin
sought => gesucht; suchte
gaia => gaia
subscribe => subskribieren
deport => deportieren; Deport
frequents => frequentiert
solar => solar
coexistence => Koexistenz
patagonia => patagonien
foremost => vorderst; vorderste
provider => Provider
dating => Datierung; datierend
shield => Schild
astrology => Astrologie
vinyl => Vinyl; vinylgruppe
triangle => Triangel
virgil => vergil
livelier => lebendiger
vase => Vase
splicing => Splicing; spleißend
unwittingly => unwissentlich; unwissend
reek => riechen
shadowing => Shadowing
heroic => heroisch; heldisch
dugout => Dugout
senseless => sinnlos
metabolism => Metabolismus; Metabolie
liverpool => liverpool
into => in; ins
roasted => röstete
esoteric => esoterisch
immediate => immediat
dealing => Behandlung
cobra => Kobra
intending => intendierend
lumpy => klumpig
masked => maskiert; maskierte
sanitary => sanitär
replicant => replikant
hindsight => Nachsicht
entertainment => Unterhaltung; Entertainment
delegation => Delegation; Delegierung
picturesque => pittoresk; picturesque
restaurant => Restaurant; Restauration
simulations => Simulationen
rio => rio
galaxy => Galaxie; Galaxis
desert => desertieren
propellers => Propeller
decompression => Dekompression; Dekomprimieren
habitual => habituell
rare => rar; karg
consumers => Konsumenten; Abnehmer
religions => Religionen
tipping => kippend
egomaniac => Egomane; Egomanin
dip => Dip
vacancy => Vakanz
regal => Regal; regal
cults => Kulte
mallorca => mallorca
banking => Bankeinlage
spitz => Spitz; Spitze
gothenburg => göteborg
mutilations => Mutilationen
inclusive => inklusive; inklusiv; inklusive (inkl.)
spinners => Spinner; Spinnerinnen
stony => steinig
barricades => Barrikaden; verbarrikadiert
reflections => Reflexionen
flitting => flatternd; flitzend
romania => rumaenien; rumänien
ache => Schmerz
officially => offiziell; offizielle
hacking => Hacking; hacken; hackend
kilt => Kilt
mandate => Mandat
impertinence => Impertinenz
testimony => Testimonium
pecans => Pekannuss
ceremonial => zeremoniell; Zeremonie; Zeremoniell; feierlich, zeremoniell
polished => poliert
memorised => memoriert
smacked => schmeckte
farm => Farm
torments => triezt
additions => Additionen
weekday => Werktag
partner => Partner; Partnerin; Geschäftspartner; Filmpartner
corruption => Korruption; Korrumpierung
shtick => Stück; Trick
afar => Afar
remarked => bemerkt; bemerkte
transfusion => Transfusion; Bluttransfusion; Infusion
stench => stinkig
interfered => eingegriffen; interferiert
differentiate => differenzieren
clarinet => Klarinette; Bassettklarinette
drunkards => Trunkenbolde
conspiracy => Konspiration
resilience => Resilienz
drastic => drastisch
killer => Killer
negatively => negativ; negative
originals => Originale
beneath => beneath
high => hoch; high
listed => aufgelistet
barbed => beißend
hereabouts => hierorts
genetic => genetisch; gentechnisch; genbedingt
exists => existiert
viscous => viskos; viskose; viskös
normally => normalerweise; normal; im Normalfall
blinded => blendete; blind gemacht; erblindet; geblendet; verblendet
masseur => Masseur; Masseurin; Masseuse; Massage
annexation => Annexion; Annektierung
nonstop => nonstop; Nonstop; Nonstop...
standard => Standard; Standarte
national => national
kath => Kath; Qat
dervish => Derwisch; Derwischin
twigs => Zweige
se => Se
mannequin => Mannequin
farmland => Ackerland
agriculture => Agrikultur
indistinct => unbestimmt
walrus => Walross; Walroß
masher => Grapscher
negotiating => negoziierend
lucid => luzid; leuchtend
hereford => Hereford-Rind; hereford
robot => Roboter; Robot
slight => leicht
controllable => kontrollierbar
springer => Springer
gallery => Galerie
snipped => geschnippelt; schnippelte; geschnipselt
blond => blond; Blond; Blondine; Blonder; blondhaarig; Blonde; Blondin
cola => Cola; kola
denounce => denunzieren
falafel => Falafel
gentile => Heide; Gentile
catalogued => katalogisierte; katalogisiert
pms => pms
volumes => Volumina; Volumen
schoolteacher => Schullehrer
grime => Grime
caprice => Kaprize; Kaprice
lowering => Entwertung; Erniedrigung
doppelganger => Doppelgänger; Doppelgängerin
policewoman => Polizeibeamtin
vermont => vermont
interpreter => Interpret; Interpreter; Übersetzer; interpreter; Interpretator
entranced => entzückt
glamorous => glamourös; glanzvoll
ishtar => ischtar
americas => amerika
unrest => Angst
benny => benny
camel => Kamel; Camelus
zhao => zhao
unspoiled => unverbildet
factor => Faktor
olympian => olympisch; olympiateilnehmerin; olympier
onboard => Bord
quiche => Quiche
league => Leuge
waxing => Waxing
nd => nd
asparagus => Spargel; Asparagus; spargeln
toxicity => Toxizität; Cytotoxizität; Neurotoxizität
pragmatic => pragmatisch; praktisch
ludo => ludo
fuehrer => Führer
migrants => Migranten; Migrantinnen
inverted => invertiert; seitenverkehrt; invers
berkshire => berkshire
unnaturally => unnatürlich; unnatürliche
christendom => christenheit; christentum
dumb => dumm
pinochle => Binokel
polio => Polio
phenomenal => phänomenal
pollen => Pollen; Polle; Pollenkorn
begged => bekniet
lint => Lint
midlife => Midlife-Crisis
homerun => Bogen; Homerun; ein Homerun
natal => natal
trillion => Billion; Trillion
minimal => minimal; minimale; minim; minimal (min.)
ordering => Ordnung; ordernd
footsie => Footsie
libation => Libation
stricken => ergriffen; betroffen
snare => Snare
gourmet => Gourmet
observe => observieren
sympathies => Sympathien
following => folgend
orgies => Orgien
terraces => Terrassen; Terrasse
analogue => analog; Analogon; Analog-; Analog...
repatriation => Repatriierung; Deportation
ballplayer => Ballspieler; Ballspielerin; Baseball-Spieler
duality => Dualität; dualität
headlight => vorderlicht
episodes => Episoden
warmest => wärmste; wärmsten
virginia => Virginia
aurelia => Aurelia aurita
frank => frankieren; frank
crimea => krim
forefather => Vorfahre; Vorfahr; Urvater
baguette => Baguette
estate => Besitztum
lied => Kunstlied; Lied
carpenter => Schreiner; Mary Carpenter
mv => Mv
sanctified => sanktioniert; sanktionierte
palpable => palpabel
robust => robust
revolutionized => revolutioniert
relevance => Relevanz; Belang
graduated => graduiert
taxicab => Taxi; Taxi -s
final => Finale
whiskey => Whisky; Whiskey; Whisky -s
jesus => jesus
guru => Guru; guru
dispenser => Spender; Austeiler
rotated => rotierte; rotierten; rotiert
civil => zivil
lancer => Lanzierer; Lancier
clicking => Klicken; klickend
magnets => Magnete; magnete
magnetism => Magnetismus; magnetische Kraft; netismus
skateboarding => Skateboardfahren; Skateboarden; Skateboard fahren
pepper => Pfeffer; pfeffern
midwest => mittelwesten
reboot => Reboot; Neubooten; neu booten; rebooten
cafe => Café; Cafe; Kaffee
journalists => Journalisten
methodically => methodisch; methodische
passage => Passage; Passus
fairway => Fairway
classmates => Klassenkamerad
curator => Kurator; Kustos; Direktor; Konservator; Kuratorin; Verwalter
accompany => akkompagnieren
landau => Landauer; landaulet
dm => dm
fluent => fließend
anchors => ankert
jezebel => Isebel
verses => Verse; versen
gamer => Gamer
amended => abgeändert
illogical => unlogisch
culmination => Kulmination; Anhäufung Kulmination
fingernails => Fingernägel
stronger => stärker
nightmare => Nachtmahr
redder => röter; roter
luminol => Luminol
arteries => Arterien; Arterie
projector => Projektor; Videoprojektor
bacteria => Bakterien; Bakterie; Bakterium; Bacteria
grounding => Erdung; Grundlage; grundierend; Begründung; Grundierung
contours => Kontur; Konturen
fleet => fleet
choir => Chor; chor
dampening => dämpfend
suggestion => Suggestion; Assoziation
allies => Alliierte
brilliance => Brillanz
manipulator => Manipulator; Manipulant; Manipulantin; Manipulatorin; manipulierer
elephants => Elefant; Elefanten
ballistics => Ballistik
veering => Wendung; Gieren
disloyal => illoyal
schoolhouse => Schulhaus
functioning => funktionsfähig; funktionierend; fungierend; funktionieren; funktionsweise
testes => Testikel; Testes; Testis
cal => cal
pashto => paschtu
articles => Artikel
scenarios => Szenarien; Szenarios
sweeter => süßer
serial => seriell; Serie
fabricating => fabrizierend
steaks => Steak
om => om
sprinkle => spritzen; sprengen
douglas => douglas
eve => eve
nam => vietnam
stamped => abgestempelt; gestempelte; aufgestampft; gestampft; gestempelt; getrampelt
supermarket => Supermarkt; supermarkt
installations => Installationen; Installation
shelly => muschelig
dodgeball => Völkerball; Dodgeball
infiltrated => infiltriert; infiltrierte
irritating => irritierend
uni => Uni
comfort => Komfort
leo => leo
inadequate => inadäquat
babies => Babys
flan => Fladen; Flan
clauses => Klauseln
lutheran => lutheraner
new => neu
caskets => Kassetten
emissions => Emissionen
intrusive => intrusiv
caesar => caesar; cäsar
suggests => suggeriert
contaminate => kontaminieren
shortfall => Ausfall
info => Info
hurray => hurra; Hurra!; hurrah
facilitator => Facilitator
refining => Raffinierung; verfeinernd; Verfeinerung; Reinigung
erected => errichtet; aufgerichtet; errichtete
insurgent => Insurgent
leotard => Leotard
modified => modifizierte; modifiziert
allah => allah
que => que
west => Westen; westlich; West; westwärts
patch => Patch
disputes => Dispute
ess => es
olympiad => Olympiade; olympiade
coveralls => Overall; overall
startup => Starten; Start
sir => Sir
finland => finnland
sarasota => Sarasota
aura => Aura
goalie => Goalie; Goali
murderer => Mörder; Mörderin
fishnet => Fischernetz; Fischnetz
hairpin => Haarpfeil
coding => Codierung; Kodierung; codierend
sedation => sedierung
prosthetics => Prothetik
ciao => Ciao; ciao
falstaff => falstaff
jupiter => jupiter
embryo => Embryo
confrontational => konfrontativ; Konfrontations...
reconfigure => rekonfigurieren; neu konfigurieren
accepting => akzeptierend; akzeptieren
liechtenstein => liechtenstein; liechtensteiner
degenerate => degenerieren; degeneriert; Degenerat
aegis => Ägis; Aigis
gonads => Gonaden
angola => angola
equalizer => Equalizer
grams => Gramm
ruffian => Grobian
minos => minos
formality => Formalität; Formalie
decapitation => Dekapitation
argues => argumentiert
mason => mauern; mason
tarn => Tarn; Tarn-; tarn
gazpacho => Gazpacho
dl => dl
chaperone => Chaperon
alternatives => Alternativen
fullback => Fullback
epsom => epsom
lima => lima
alliances => Allianzen
fitter => Monteur
crunching => krachend
haiti => haiti
electricians => Elektriker; Elektrikerinnen
reflexes => Reflexe
sharpen => schärfen; schleifen; spitzen; scharf machen; verschärfen; scharfzeichnen
electrodes => Elektrode; Elektroden
stables => Ställe; Stall
gateway => Gateway
rat => Ratz
mademoiselle => Mademoiselle
weightlessness => Gewichtslosigkeit
explicitly => explizit; explizite
angel => Engel; Engel -s; Engelchen; angel
hyacinth => Hyazinthe; Hyazinthen; Hyacinth; Hyazinth; hyakinthos
kiwi => Kiwi; kiwis
strasser => Strasser
biochemistry => Biochemie; biochemie
grade => Grad
wanders => wandert
cranium => Cranium; Kranium
charlemagne => Charlemagne
tu => tu
acute => akut
excluding => exklusive
midshipman => Midshipman
enthusiasts => Enthusiasten; Enthusiastinnen
sounder => Rudel
including => inklusive
chicago => chicago; chicagoer
herself => derselbe
puncher => Locher
campus => Campus
mucus => Mucus
lyon => lyon
stacking => Stapelung; stapelnd
real => real; reell; Real
french => französisch
neuroses => Neurosen; Neurose
winery => Winzerei
alarms => Alarme
styrofoam => Styropor
ix => Ix
fibrosis => Fibrose; fibrose
xindi => Xindi
timeout => Timeout
urinating => urinierend
olives => Olive; Oliven
seize => greifen
scary => schaurig
institutional => institutionell; Institutions...
graf => Graf
chopper => Chopper
maki => maki
esther => esther
confiscation => Konfiskation; Konfiszierung
berries => Beeren; Beere; beere
merging => Vereinigung
inscription => Inschrift
legislative => legislativ; Legislative; legislative
stately => stattlich
genuinely => genuin
panini => Panini; Panino
de => De; de
process => Prozess; Prozeß
hyperventilate => hyperventilieren
harmonium => Harmonium; Druckwindharmonium
hat => hut
period => Periode
buttermilk => Buttermilch; buttermilch
sorting => Sortierung; Sortieren; Verteilung; Anordnung; sortierend
sputnik => Sputnik
discrimination => Diskriminierung
paralyzed => paralysiert
solitude => Isolierung
slogan => Slogan
odometer => Hodometer; Wegmesser; Odometer; Oedometer; Tachometer
implement => implementieren
seoul => seoul
polka => Polka
barrack => Baracke
chopped => geschnippelt
mutant => Mutant; Mutante; mutierend; mutiert; Mutantin
reigns => regiert
evangelical => evangelisch; evangelikal; evangelischen; evangelikaler
sings => singt
waistband => Obiband
aborigines => Aborigines
autonomy => Autonomie
specialists => Spezialisten; Spezialistinnen
sociopath => Soziopath; Soziopathin
tao => dao
disassembled => disassembliert
aurora => Aurora; aurora
creating => Anfertigung
citadel => Zitadelle
bordeaux => Bordeauxrot; bordeaux
ocean => Ozean
odor => Odor
shuffled => schlurfte
fairyland => Feenland; Traumland
skinheads => Skinheads; Skins
anthem => Anthem; anthem
kilometer => Kilometer
flocking => Beflockung
niger => niger
conferences => Konferenzen
wichita => wichita
marshland => Sumpfland; marschland; marsch
cassiopeia => cassiopeia
algebra => Algebra
colonized => kolonisierte; kolonisiert
resulted => resultiertem
quarters => Quartier; Quartale
cliques => Cliquen; Clique
mailer => Mailer; Norman Mailer
references => Referenzen
cylinder => Zylinder; Kreiszylinder; zylinder
stimulating => stimulierend
marks => markiert
firecracker => Kracher; Cracker
haitian => haitianer; haitianerin; haitianisch; haitisch
babylon => Babylon
fatal => fatal
eccentricities => Exzentrizitäten
mash => Maische
abc => abc
hurriedly => hurtig
dnc => Dnc; Dnoc
hither => hierher; hierhin; her
uterus => Uterus
teleprompter => Teleprompter
castellan => Kastellan
desire => Begierde
vale => Tal
trademark => Handelsmarke
classified => klassifiziert
tony => tony
copyright => Copyright
wilder => toller; wilder
action => Aktion
dreadnought => Dreadnought
japanese => japanisch; japaner; japanerin
hermaphrodite => Hermaphrodit; hermaphroditisch; Hermaphroditismus; Hermaphroditin
visceral => viszeral
stuntman => Stuntman
kano => kano
sprint => Sprint; spurten; sprinten
psychologists => Psychologen; Psychologinnen
placebo => Placebo; Plazebo
cox => cox
kurds => kurden
calcium => Calcium; Kalzium
segovia => segovia
slacker => Slacker
mentioning => Mention
lute => Laute
abalone => Abalone
warfare => Waffe
forestry => forstbetrieb
parliament => Parlament
excessive => exzessiv
interferon => Interferon; interferone
parasite => Parasit; Parasitentum; Parasitismus
bulimic => bulimisch; Bulimiker
skipping => Seilspringen
stripper => Stripper; Stripperin; striptizerka; Abstreifer
sistine => sixtinisch
rough => rauh; roh
inspire => inspirieren; anspornen
mainstream => Mainstream
ribbing => Rippung
toupee => Toupet
stapler => Tacker
ty => ty
kabuki => Kabuki
machismo => Machismo; Maschismo; Macho; macho
exploratory => explorativ; exploratorisch
enzyme => Enzym; enzyme
bach => Datsche
guillotine => Guillotine; guillotinieren
pornography => Pornografie; Pornographie; pornografisches Buch
electra => elektra
scorching => stechend
capital => Kapital; Kapitell; Kapitale
marine => Marine; Kriegsmarine; Marinesoldat; Matrose
hitchhiker => hitchhiker
drums => Drumlins
crater => Krater; Vulkankrater; Trichter; Mondkrater; Sprengkrater; Vulkakrater
burbank => burbank
rile => reizen
thermite => Thermit; thermite
pesticide => Pestizid
remark => Bemerkung; bemerken
latin => latein; lateinisch; latino
yesterday => gestern; Gestern; gestriger Tag; gestrig
mali => mali
alien => Alien
shine => scheinen; schimmern
obesity => Obesitas
crustaceans => Crustacea; Krustazeen
transplants => transplantiert
vulgar => vulgär
cannabis => Cannabis
leggings => Leggings; Leggins
hotel => Hotel
chartered => charterte; gechartert
aldrin => Aldrin
narcotic => Narkotikum; narkotisch; narkotisierend
pinocchio => pinocchio
magellan => magellan
brno => brünn
benin => benin
voodoo => Voodoo; Voudou
jane => jane; janina; johanna
toreador => Torero; Toreador
fastest => am rasantesten
emphatic => emphatisch
venetian => venezianisch; venezianer
sulfate => Sulfat; sulfate
sakura => Sakura
flies => Fliegen; fliegt; Fliege
skeptical => skeptisch; skeptische
latrine => Latrine
sheer => schier
psychologically => psychologisch; psychologische
false => falsch
importing => Import; importierend
nimrod => Nimrod; nimrod
montgomery => montgomery
hezbollah => hisbollah
adolf => adolf
rumbled => rumort; rumpelte
commanded => kommandierte; kommandiert
barrows => Karren
spewing => speiend
tasmanian => tasmanisch
copenhagen => kopenhagen; kopenhagener
bravo => bravo; Bravo
gorgon => Gorgo; Gorgone; gorgonen
lifespan => Lebensspanne
vocalist => Vokalist; Vokalistin
gaseous => Gasform; gasig
conservatory => Konservatorium; Musikkonservatorium
breaking => Brechung
clinics => Kliniken
reformers => Reformer; Reformerinnen
cornflakes => Cornflakes
photons => Photonen
deodorant => Deodorant; Desodorant; desodorierend; deodorierend
water => Wasser; wässern
dad => dad
programmed => programmiert; programmierte; programmierten
zooms => zoomt
liquor => Liquor
diner => Diner
arras => arras
rustic => rustikal
plexus => Plexus
ro => ro
comedians => Komödianten; Komikerinnen; Komödiantinnen
sonora => sonora
tuba => Tuba; Tube
intent => Intention
siblings => Drilling
chipotle => Chipotle
seraphim => Seraph; Seraphim; Seraphe; serafim
textbook => Textbuch
coincide => koinzidieren
morrow => morgen
intercede => intervenieren; eintreten
uncooperative => unkooperativ
manifesting => Manifestation
mol => Mol
rapier => Rapier
soften => besänftigen
handpicked => handverlesen
garden => Garten; gärtnern; Vorgarten; Hausgarten
mangrove => Mangrove; Mangrovenbaum
restart => Neustart; neustarten; neu starten; neuer Start
production => Produktion; Produktionshöhe
losers => Loser
enriching => anreichernd; bereichernd
pops => Pop
grabbing => grabschend
wight => Wicht; Wichtel
aches => Schmerz
innermost => innerst; innerste; innerster; innerstes
weakest => flaueste
vulcans => vulkanier
manicured => manikürte; manikürt
terraforming => Terraforming
sty => sty
licked => leckte
battalions => Bataillone
babysitter => Babysitter; Babysitterin
ghetto => Getto; Ghetto
casing => Schalung
rigid => rigide
intestines => Eingeweiden
milligrams => Milligramm
byzantium => byzantion; byzanz
heater => Heizer
makes => machen; Marken
selene => selene
walnut => Walnuss; Walnuß
bandaged => bandagiert; bandagierte
extrapolate => extrapolieren
mercantile => merkantil
deductive => deduktiv
viking => Wikinger
abundance => Abundanz
superstars => Superstars
reviewer => Revidierender
signalling => Signalisierung; Signalgebung; Signalisieren; signalisierend
sermon => Sermon
po => po
pucks => Pucks
climax => Klimax
draining => Drainage
brig => Brigg
mildly => mild
quorum => Quorum
tk => tk
weightless => gewichtslos
noblest => am nobelsten
synergy => Synergie; Synergismus; synergie
fertilization => Pollination; fecundation
geometry => Geometrie
statistical => statistisch
grumble => brummen; Gegrummel; Grummeln; grummeln
kind => mild
paradoxical => paradox; paradoxal; Paradox; Paradoxon
pamper => pampern
buzzer => Summer; Buzzer
lineage => Lineage
products => Produkt; Produkte
altitude => Altitude
vulnerabilities => Vulnerabilitäten
holograms => Hologramme
trinity => Trinität; trinity
crass => krass
rainfall => Regenfall
brochures => Broschüren
downtown => Downtown
eloquent => eloquent
minus => Minus; minus
cambridge => cambridge
topography => Topografie; Topographie
snuffed => schnupfte; geschnüffelt; schnüffelte
subliminal => subtil; subliminal; Subliminalität
unexpectedly => unerwartet
telephone => Telefon; telefonieren; telephonieren; Telephon
jacket => Jacke; Jackett; Windjacke
titles => Titel
flagged => beflaggt
triton => Triton
pudding => Pudding
atmosphere => Atmosphäre; Erdatmosphäre
corrections => Korrekturen
crunchy => krosch
massachusetts => massachusetts
quadruple => Quadrupel
ennui => Ennui
confirmation => Konfirmation
acceleration => Akzeleration
myths => Mythen
racking => streckend
archbishop => Erzbischof
khaki => Khaki; khakifarben; Kaki; kaki; khaki
bonbon => Bonbon; Bonbon ''m
taurus => taurus
cues => Queues
silesia => schlesien
reflected => reflektiert; reflektierte
dislocation => Luxation; Dislokation
classically => klassisch; klassisches
brewery => Brennerei
lens => linse; lenteja
cremate => kremieren
codex => Kodex; codex
heller => Heller; heller
cos => cos
pia => Pia
supercomputer => Supercomputer; Superrechner; supercomputer
tends => tendiert
parole => Parole
horizons => Horizonte
earthy => erdartig
stalkers => Stalker
trowel => Traufel
hubris => Hybris
sunni => sunnit; sunniten; sunnitin; sunnitisch
opposition => Opposition
tumors => Tumoren
rheumatism => Rheumatismus; Rheuma; Gelenkrheumatismus
restoring => restaurierend
fingertip => Fingerspitze; Fingerkuppe
jam => jammen
paddles => paddelt; Paddel
navigational => navigatorisch; Navigations-; Navigations...
benign => benigne
maxwell => Maxwell; maxwell
maltese => Malteser; malteser; maltesisch
gender => Gender
deserter => Deserteur
radiation => Radiation; Emission
bounties => Subventionen
strict => streng; strikt; straff; stringent
function => Funktion; funktionieren; fungieren; Funktionalität
modifications => Modifikationen
theoretically => theoretisch; theoretisches
homophobic => homophob
horus => horus
silverware => Silberware; silberwaren
swan => Schwan; schwan
egypt => Ägypten; aegypten
administrative => administrativ
roti => Roti
novice => Novize
stepsister => Stiefschwester
far => fern
blinking => Blinken; aufblinkend; blinkend
commanders => Kommandanten; Kommandeure
poi => poi
mastectomy => Mastektomie; mastektomie
tested => getestet
salve => Salbe; Wundsalbe
doses => Dosen; dosiert
ocd => ocd
oedipus => Ödipus
deliver => abliefern
verbally => verbal
caustic => sarkastisch; kaustisch; Kaustikum; Kaustik
hairball => Haarball
hastened => hastete
cloned => klonte
devastate => devastieren
phrases => Phrasen
salaam => salem; Salam
decoded => decodierte; decodiert; dekodiert; dekodierte
earl => Earl
carnivore => Karnivore; carnivore
shot => Schrot
forward => vorwärts; vorlaut; vorder
fore => vorn; vorder; vor; vordere; vorne
philly => philadelphia
mensch => Mensch
simplicity => Simplizität
ph => Ph
serbian => serbisch; Serbisch; serbe
profit => profitieren; Profit
specifications => Spezifikationen; Spezifikation
commodore => Kommodore; Commodore; kommodore
stalag => stalag
overlapping => Verdoppelung; Überlappung; überlappend; überlappende
lending => leihend
anima => Anima
surcharge => Zuschlag
between => begleitet
palomino => Palomino
philosophically => philosophisch; philosophische
brisbane => brisbane
porter => Portier; Pförtner; porter; Porter
mutters => murmelt
dilation => Dilatation
blackout => Blackout
nymph => Nymphe
distilled => destillierte; destilliert
galactic => galaktisch
situation => Situation
stiffy => Steifer
mathematicians => Mathematiker; Mathematikerinnen
watching => Besichtigung
capsule => Kapsel; Tasche
mark => Marke
capacities => Kapazitäten
sentences => Sentenzen
trumpeting => Trompeten; trompetend
literate => literal
informs => informiert
pumped => gepumpt; pumpte
neuter => Neutrum; neutral
mole => Mole; Mol
baku => baku
leipzig => leipzig
starlet => Starlet
caramelized => karamelisiert; karamellisiert
zygomatic => zygomatisch; zygomaticus
medic => medizinisch
elevation => Elevation
negro => negrid; Negerin
planners => Planer
stretching => Stretching; Streckung
inform => informieren
urdu => urdu
dialect => Dialekt; dialekt
name => Name
cement => Zement; zementieren; zement; zemen
funnier => lustiger
prosper => prosperieren
convergence => Konvergenz
formaldehyde => Formaldehyd; formaldehyd; Formalin
cassini => cassini
favela => Favela
scrawny => schlank
landline => Landkabel
hullo => Hallo; Hallo!
predictive => prädiktiv
nail => nageln; nagel; knallen
lanky => lang; lange
checked => gescheckt
steely => steinern
oregano => Oregano; Origano
billion => Billion; Milliarde; Billionen; Milliarden
communiqué => Kommuniqué; Kommunique; Kommunikee; communiqué
ibuprofen => Ibuprofen
epidemics => Epidemien; Epidemie
korea => korea
urethra => Urethra; Uretra; Ureter
résumé => Resumé
scheme => Schema
goldmine => Goldgrube; Goldmine
mod => Mod; mod; modern
dalton => dalton
uneven => uneben
mile => Meile
clapper => Klöppel; Klapper; Klappe; Klüppel
productive => produktiv; produzierend
moccasins => Mokassins
evocative => evokativ
societal => sozial
stephen => stefan; stephan
nominated => nominierte; nominierten; nominiert
criminally => kriminell
singularly => singularisch
showgirl => Revuegirl; Showgirl
hotdog => Hotdog
congestive => kongestiv
vocalists => Vokalisten; Vokalistinnen
beta => Beta; beta
aspirations => Aspirationen
goldfinger => goldfinger
gong => Gong
chandigarh => chandigarh
colored => Coloured
young => jung
respiratory => respiratorisch
lawnmower => Rasenmäher
stimulate => stimulieren
seismic => seismisch; Seismik
licker => Lecker; Leckerin
tigress => Tiger
commander => Kommandant; Kommandeur
hetty => hetero
insight => Einsicht; Aussicht
carbohydrates => Kohlehydrate; Kohlenhydrate
resuscitated => reanimierte
whistler => Whistler
pasadena => Pasadena
malawi => malawi
glazed => glasierte; glasig; glasiert
debating => debattierend
demolish => demolieren
orchid => Orchidee; Orchide; Orchid; Orchis
indiscretions => Indiskretionen
kneels => kniet
pensions => Pension
boutique => Boutique
incarcerated => inhaftiert
on => an; in
softest => am sanftesten
imposed => imponierte
administrators => Administratoren; Administratorinnen
silvery => silbrig; silbern; silberhell; silberig; silberfarben; silberfarbig; silberweiß
yachts => Jachten; Yachten
gimmick => Trick; Gimmick
reflect => reflektieren
consistently => konsequent
transcription => Transkription
phallus => Phallus
allocated => alloziert; allozierte
debut => Debüt
obstructions => Obstruktionen
boxing => Boxen; Boxing; boxend
blare => plärren
alley => Allee
pacemaker => Pacemaker
faust => fauststoff
test => Test; testen
novelist => Novellist; Novelist
genovese => genueser
vectors => Vektoren; Vektor
crucifixes => Kruzifixe
fervour => Bravour
sniffling => schnüffelnd
reeve => Greve
fad => Fad
slovakia => slowakei
genitalia => Genitalien; Genitalia; Genitalsystem
parable => Parabel
masquerading => Maskerade
satanist => satanistin
shatters => zerschmettert
dynamics => Dynamik
catalonia => katalonien
initiative => Initiative; Eigeninitiative
stenographer => Stenograph; Stenograf; Stenografin; Stenographin
communicates => kommuniziert
narcotics => Narkotikum
undermine => unterminieren; untergraben; unterhöhlen
cameroon => kamerun
insisting => insistierend
electronic => elektronisch; Elektron; elektrisch; Elektro...; Elektronen; Elektronik
cardiologist => Kardiologe; Kardiologin
rip => rippen
undisciplined => undiszipliniert
dereliction => Dereliktion
dames => Damen
dito => dito
dialogues => Dialoge
toasts => Toasts; toastet
bonito => Bonito
phoenix => Phönix; phönix; phoenix
tandem => Tandem; Tandembauart
methane => Methan; methan
zoos => Zoo; Zoos
harmony => Harmonie; Harmonik
billing => Billing
fences => fechtet
drying => Curing
charleston => Charleston; charleston
grins => grinst; grinst an; grient
thinker => Denker; denker
exactly => exakt
numerals => Numerale
stereotypes => stereotypiert; Stereotypen
nestor => nestor; Nestor
front => Front; Wetterfront; Frontmann
abruptly => abrupt
rather => eher
table => Tabelle
cleaner => cleaner
procedure => Prozedur; Prozedere
visiting => besichtigend
baroness => Baroness; Baronin; Baronesse
badass => krass
appropriation => Appropriation
colonize => kolonisieren
pirate => Pirat; Piraten...
inwards => einwärts
rocked => gerockt
sighted => gesichtet; sehend; sichtete
jacuzzi => Jacuzzi
manchu => mandschu
marked => markiert; markant; markierte
buttercup => Butterblume
tanna => tanna
peninsula => Peninsula
stinger => Seitengewehr
insists => insistiert
northwest => Nordwesten; Nordwest; nordwestlich; Nordwest-
bruno => bruno
photographers => Fotografen; Photographen; Photographinnen
do => do
udon => Udon
monthly => monatlich
crier => Schreier
christopher => christoph
dozens => dutzende; Dutzend
mechanical => mechanisch; mechanischer; technisch
answered => beantwortet; geantwortet; beantwortete
stepmother => Stiefmutter
hijacker => Hijacker; Skyjacker
paranormal => paranormal; Paranormal
plastic => Plastik; plastisch; Plastikgeld; künstlich; Plast; Plaste
ii => ii
bandit => Bandit; Banditin
zone => Zone
clicked => klickte
punjabi => pandschabi
portable => portabel; Portable; transportabel; portierbar
substantiate => substantiieren
turkish => türkisch; türken
oxfordshire => oxfordshire
marlin => Marlin
specimen => Spezimen
coded => codiert; codierte; kodiert
insertion => Inserat
establish => etablieren
untested => ungetestet
stave => Stange
bending => Beugung; Windung; beugend
netherworld => Unterwelt
circulated => zirkulierte
snob => Snob
e => e
sudoku => Sudoku
woodman => Forstmann
line => Bahnlinie
lynx => Lynx lynx
plymouth => plymouth
in => in; an; im; rein
antennae => Antennen
eroticism => Erotik; Erotizismus
haven => Hafen
eccentric => exzentrisch; Exzentriker; eigenartig
dribbling => Dribbeln; Dribbling; dribbeln
milliseconds => Millisekunden
acoustic => akustisch; Akustik
lotte => Lotte
trusted => treu
billboard => Billboard
yalta => jalta
coordinated => koordinierte; koordiniert
elegantly => elegant
rampaging => randalierend
bikini => Bikini
silicone => Silikon; Silicon; Silikone; silikone
bulldogs => Bulldoggen
openers => Öffner
mahabharata => mahabharata
bollywood => bollywood
hairless => haarlos
union => Union
butane => Butan; n-Butan; n-butan
freeze => frieren; gefrieren; erfrieren; zufrieren
busier => emsiger; emsigere
souffle => Soufflé; Souffle
odessa => odessa
trendy => trendy; trendig
protected => protektiert
premium => Prämie
adelaide => adelaide
putter => Putter
alms => Almosen
significant => signifikant
torpedoed => torpedierte; torpedierten; torpediert
prejudicial => präjudiziell
explodes => explodiert
visionary => Visionär; visionär; Visionärin
manipulate => manipulieren; Manipulation
relativity => Relativität; relativität
clod => Kloß
glitch => Glitch
hackers => Hacker
aram => aram
tomahawk => Tomahawk; tomahawk
joker => Joker
june => Juni
stamper => Stampfen; Stampfer; Ramme; Stempel; stempel
sequences => Sequenzen
suspension => Suspension; Suspendierung
escalates => eskaliert
roller => Rolle; Roller; Rollertaube; Tümmler
punctuality => pünktlich
nim => Nim
backwards => rückwärts
duped => düpiert
oklahoma => oklahoma
stillness => Stille
inmate => Insasse
aboriginal => Aborigine
calibrate => kalibrieren
nor => noch
biryani => Biryani
mary => maria; marie; mary
hypotheses => Hypothesen
chutzpah => Chuzpe
softie => softie
wakes => wachten
applications => Applikationen
woodwork => Holzwerk
gargling => gurgelnd
elegant => elegant; Eleganz
extensions => Extensionen
protocols => Protokolle
partnership => Partnerschaft
underdogs => Underdogs
tomorrow => tomorrow
deciphering => Dechiffrierung; Entzifferung; dechiffrierend
presidency => Präsidentschaft
bomb => Bombe; bomben; Sexbombe
guerrillas => Guerilla; Guerillas
dictation => Diktat
prognosis => Prognose
specter => Monster
koala => Koala; Koalabär; Koala -s; Koala-Bär
poseidon => poseidon
anchovy => Anchovis; Anschovis; Anschove
recluse => Inkluse
catwalk => Catwalk
quoting => quotierend
equally => ebenfalls
thermostat => Thermostat
sectors => Sektoren
antagonism => Antagonismus
heinrich => heinrich
authorised => autorisiert; autorisierte
putties => kittet
embolism => Embolie; Embolismus; embolie
pontus => pontos
fact => Fakt
matter => Materie
jumping => Bungee-Jumping
verifying => verifizierend
titanium => Titan; Titanium
finders => Finder; Finderinnen
mammals => Mammalia; Mammalier
poles => Pole; polen
proclaimed => proklamierte; proklamierten; proklamiert
pas => Pas
calculate => kalkulieren
pneumothorax => Pneumothorax; Pneumonie; Pneumonitis; Pneumothoraxbehandlung
booted => gebootet
prosthetic => prothetisch
hittites => hethiter
gate => Gatter; Gate
dividing => Division; dividierend
colostomy => Kolostomie; Kolostoma
radius => Radius; Aktionsradius; radius; Atomradius; Carpus
beluga => Beluga; Belugastör; Beluga-Wal
fruit => Frucht; Produkt
trotting => trottend
euros => Euro
trawler => Trawler; Fischtrawler
strays => streunt
taskmaster => Zuchtmeister; Lehrmeister
magnetized => magnetisiert; Magnet...; magnetisierte
tempo => Tempo
loose => lose; locker; lockern; loslassen
titties => Titten
defamation => Diffamation
correlation => Korrelation
dibble => dibbeln
jambalaya => Jambalaya
hansa => hansa; hanse
sink => sinken; senken; versinken; einsinken
quotes => quotiert
strands => Strände; Stränge; strandet
yak => Yak; Jak
fibers => Fiber; faser
statesmen => Staatsmänner
clattering => Klappern; klappernd; ratternde; Rattern; ratternd
cocktails => Cocktails
carina => Carina
weasels => Wiesel
yeshiva => Jeschiwa
spastic => Spastiker; spastisch; Spastikerin; spasmatisch
licence => Lizenz; lizenzieren
nonce => Nonce
flighty => flüchtig; flippig
favorites => Favoriten; Favorites
ordinary => ordinär
industries => Industrien
statute => Statut
workman => Handwerksmann
decomposition => Dekomposition
conjunction => Konjunktion
stature => Statur
airing => Spaziergang
example => Exempel; Exemplar
misunderstand => missverstehen; missdeuten
criminal => kriminell; Krimineller; Kriminelle
hooligans => Hooligans
texture => Textur
greenwich => greenwich
lasagne => Lasagne
fish => Fisch; fischen; Fische
deposited => deponierte; deponiert
publications => Publikationen; Publikation
wrecks => Wracks
sprinklers => Sprinkleranlage
pesticides => Pestizide
separatist => Separatist; separatistisch; Separatistin
longtime => lange
superheated => überheizte
calisthenics => Kallisthenie; Calisthenics
heathen => Heiden
web => Gewebe; Web
leased => geleast
hooking => hakend
cranial => kranial
athens => athen; athener
creations => Kreationen
pleiades => plejaden
packet => Paket; Packung; Packen
fibula => Fibel; Fibula
door => Tor
propaganda => Propaganda; propagandistisch
flounder => Flunder
professional => professionell; Professioneller; Professionelle; Professional
necrosis => Nekrose; nekrose
overdressed => overdressed
croat => kroatisch; kroate
caribbean => karibik; karibisch
header => Header
twig => Zweig
exposition => Exposition
excessively => exzessiv
carbonara => Spaghetti Carbonara
marshes => Marsch; Marschen
macon => macon
pile => Pfeiler
qualified => qualifiziert; Qualifikation
pathetic => pathetisch
benefiting => begünstigend
sparring => Sparring
pestle => Pistill
proportions => Proportionen
robots => Roboter
pompous => pompös
climber => Streber
niagara => niagara
taffeta => Taft; Taffet
criminality => Kriminalität
masturbated => masturbierte; masturbiert
flotilla => Flottille
pint => Pint; Pinte
sensational => sensationell
wherein => worin
fortuna => fortuna
whaling => Walfang; hauend; walfang
pheromones => Pheromon; Pheromone
rai => Rai
badlands => Ödland; Brachland
galleria => Galerie; Galleria
primary => primär
hamlet => Hamlet
redoing => Wiederholung
adjectives => Adjektive
professionally => professionell; profihaft
tyrannosaurus => Tyrannosaurus
maximum => Maximum; maximal
publication => Publikation; Edition
caracas => caracas
intensifies => intensiviert
mediums => Medien
mhm => hm
pisa => pisa
gardener => Gärtner
freeing => Freisetzung; befreiend; Befreiung; freigebend
abstraction => Abstraktion; Abstrahieren; Abstraction; Abstraktum
paragraphs => Paragraphen; Paragrafen
hurdles => Hürden
rates => Raten
bunt => Bunt
commas => Kommas; Kommata
frak => fracken
canadian => Kanadier; kanadierin; kanadisch
polishing => Polieren; polierend; polieren
propeller => Propeller
interrupted => unterbrochen
wolfram => Wolfram; Wolframit
philharmonic => Philharmonie; Philharmoniker; philharmonisch
sentimentality => Sentimentalität
otto => otto
quota => Quote
swatting => Swatting
touring => Tourismus
components => Komponente; Komponenten
burned => brennen
represent => repräsentieren; vertreten; spielen
rebellion => Rebellion
salsa => Salsa
japan => Japanlack; japan
kosovo => kosovo
newsstand => Zeitungsstand
telekinetic => telekinetisch
synthetics => synthetische Stoffe
authors => Autoren
decidedly => dezidiert
democracy => Demokratie; Demoktratie; demokratie; Demokrati
eventuality => Eventualität
collie => Collie; collie
rodeo => Rodeo
contemplation => Kontemplation; Meditation
clink => klingen; “Pling”
church => kirchlich
photojournalist => Fotojournalist
standards => Standards
laos => laos
pedal => Pedal; pedalieren; Pedale; Klavierpedal
hefty => deftig; heftig
harlequin => Harlekin
hostel => Hotel
banjo => Banjo
acidic => Acidität
tomatoes => Tomaten; Tomate
treading => tretend
auctioneer => Auktionator
von => von
acapulco => acapulco
ambivalence => Ambivalenz
ceramic => Keramik; keramisch
heighten => vermehren
venous => venös
decimated => dezimierte; dezimiert
detachment => Detachement; Abmachen
symbolically => symbolisch; symbolische
cluster => Cluster
iguanas => Iguana; Leguane
donor => Donator
fracking => Fracking
lister => Auflister
shame => Schande; beschämen; schämen; Blamage
subscriptions => Subskriptionen
string => String; Strippe
stabbed => stach nieder
oldies => Oldies
daiquiri => Daiquiri
appendicitis => Appendizitis; Appendicitis
troubadour => Troubadour; Trobador; Troubadourin; Troubairitz; Troubador
aftershave => Aftershave; Aftershavelotion
intercostal => interkostal
commentators => Kommentatoren
resided => angesiedelt; residiert; residierte
romany => roma; romani
consonants => Konsonanten
vampirism => Vampirismus
pellets => Pellet
flamboyant => flamboyant
effects => Effekte; Effekt; Effekten
tumbling => Tumbling
leto => leto
bacardi => bacardi
banister => Baluster
hepatic => hepatisch
fete => feiern; Fete
marsh => Marsch
pronouns => Pronomen; Pronomina
distinguished => distinguiert
nose => Nase
pricing => Preisbildung; Preisfindung; preisbildung; Auspreisung
marauders => Marodeure
sprinkled => gesprenkelt; besprinkelt
omelets => Omeletten
legionnaire => Legionär
maelstrom => Mahlstrom; Malstrom; moskenstraumen
campuses => Campus
dams => Damm
stung => stank
arboretum => Arboretum
humanities => Humanities; humanities
crab => Krabbe
interfere => intervenieren
regulation => Regulierung; Regulativ
puffs => pafft
operatic => opernhaft
transfusions => Transfusionen
centered => zentriert; zentrierte
cost => kosten; Kosten
brutally => brutal
total => total
fixes => fixiert
fibrillation => fibrillation
earnest => ernst; Ernst
commute => kommutativ
globe => Globus; Erdglobus
older => älter; Älterer; ältere; oller; Ältere
spiky => spitz; spitzig
unwell => unwohl
tuscan => toskaner
stoplight => Stopplicht
airline => Fluglinie; Airline; Luftlinie; airline
emmy => emmy
kinetic => kinetisch; Kinetik
bouillabaisse => Bouillabaisse
fragmentation => Fragmentierung; fragmentierung
ventricle => Ventrikel; Herzventrikel
mantua => Manteau; mantua
instigator => Anstifter; Anstifterin
coexist => koexistieren
cider => Zider
rendezvous => Rendezvous; geheimes Rendezvous
rationale => Rationale; Ratio; rational; rationale Erklärung
dysfunctional => dysfunktional; dysfunktionelle; dysfunktionell
viral => viral
spontaneously => spontan
dopey => deppert
limbo => Limbo; Limbus
eruptions => Eruptionen
fraternize => fraternisieren
shrines => Schreine
calendars => Kalender; Kalendarien
juno => juno
irritation => Irritation; Inflammation
wilds => Wildnis
hash => Hasch; Haschee; Hash
gypsy => Gypsy
levi => levi
jackpot => Jackpot
bestiality => Bestialität
pundit => Pandit
insect => Insekt; Insekten
dominant => dominant; Dominante; dominierend
zambia => sambia
recent => neueste; rezent
crystallized => kristallisiert
stockings => Socken
timers => Timer
peeking => kiekend
raja => Raja
torso => Torso
proverb => Proverbium; Proverb
boring => Bohrung; Abarbeitung
rosa => Rosa; Rose; rose
drink => trinken; Getränk; Drink; Trunk; Trank
bigfoot => bigfoot
brittany => bretagne
puree => Püree; pürieren; Puree
spotlight => Spotlight; Rampenlicht
modelling => Modellieren; Modellierung; Modellbau; Modellbildung; Modeln
underpaid => unterbezahlt
bankrupt => bankrott; Bankrotteur
inferno => Inferno
combines => kombiniert
morgan => morgan
singsong => Singsang
compensate => kompensieren
marking => Markierung; Marke; markierend
syria => syrien
duplicates => Duplikate; dupliziert
hair => Haar
veto => Veto
kaleidoscope => Kaleidoskop; kaleidoskop
insider => Insider; Eingeweihter; feines Gehör
skyscraper => Skyscraper
cortex => Cortex; Kortex
continuing => Kontinuität
disorientation => Desorientiertheit; Desorientierung
inhale => inhalieren
manicures => manikürt
lemon => Limone
mime => Pantomime; Mime; mimen
pumps => Pumps; Pumpe; Pumpen; pumpt
downfall => Verfall
peeper => Spanner
suspect => suspekt
radio => Radio
tingle => klingen
judas => judas
nuremberg => nürnberg
candy => Kandis
bong => Bong
burning => brand
wing => Schwinge
jujitsu => Jiu-Jitsu; Jûjutsu; Jiu Jitsu; Jūjutsu
hare => Hase; hase
bronchial => bronchial; Bronchial-; Bronchial...
cursor => Cursor; Kursor; mauscursor
unearthed => ungeerdet
tame => fade
dinar => Dinar
thunder => Donner; Schindel
fever => Fieber; fieber
stagnant => stagnierend
bowman => bowman
merlin => Merlin; merlin; Merlinfalke
warmer => wärmer
index => Index; Hinweis
checkmate => Schachmatt; schachmatt; schachmatt setzen; Schaakmat
consuming => konsumierend; konsumieren
singularity => Singularität
saracen => sarazene; sarazenen
substitution => Substitution; Substituierung
generated => generiert; geniert
encrusted => überkrustete; überkrustet
washed => gewaschen; ausgewaschen
fissures => Risse
chrysanthemums => Chrysantheme; Chrysanthemen
harper => Harfner
vigil => Vigil; vigil
seated => sitzend
partners => Partner
rustle => rauschen; säuseln
synthesis => Synthese; Einheit
stick => Stock; stechen; stecken; stocken; Stecken
harvester => Erntearbeiter; Mähdrescher; Ernter
fest => festival
pakistan => pakistan
valid => valid
disarming => charmant
float => Float
swims => schwimmt
hertfordshire => hertfordshire
peugeot => peugeot
charter => Charta; chartern; Charter; Chartervertrag
nipple => Nippel
conga => Conga
parka => Parka; Parker
li => Li; Ri
glaucoma => Glaukom; Glaucoma; glaukom
delinquency => Delinquenz
flutter => flattern; Flattern; flatternd
czech => tscheche; tschechin
coordinator => Koordinator; Koordinatorin; Organisator
presidents => Präsidenten
london => london; londoner
central => zentral; Zentral; Zentrale; Zentrum
spider => Spider
bookmaker => Bookie; Bookmaker
visas => Visa
parameter => Parameter; Parameter [math.]
diarrhea => Diarrhö; Diarrhoe; Diarrhöe; Diarrhoe Diarrhö
burka => Burka; Burke
lockout => Lockout
philistine => Philister; philisterhaft; philiströs
mothership => Mutterschiff
fett => feist
suede => Rauleder
fetishes => Fetische
rota => rota
bus => Bus; Omnibus; Autobus
transponder => Transponder; Transpondercode
financing => Finanzierung; finanzierend
banded => gebändert; verbunden
chase => nachjagen
kidnapping => Kidnapping
shorter => kürzer
satyr => Satyr
spinach => Spinat; spinat
rapport => Rapport
enthusiasm => Enthusiasmus
sticks => Stöcke
vegetarians => Vegetarier; Vegetarierinnen
effectiveness => Effektivität
charitable => karitativ
display => Display
researching => recherchierend
salty => salzig; salzartig
technique => Technik; Technologie; technisch
macedonia => makedonien; mazedonien
woolly => wollen; wollig; Woll-
cuckoo => Kuckuck; kuckuck
rayon => Rayon; Reyon
receiver => Receiver
minster => Münster
milling => mahlend
accuser => accuser
flirt => flirten; Flirt; flirtend
atoms => Atome
forwards => vorwärts; Vorwärts...
absurdly => absurd; absurderweise
parker => Parkaufseher
pauline => paulinisch
finite => finit
shading => Schattierung; schattierend; Abschattung
nastier => garstiger
caricature => Karikatur
sprayed => sprühte
hungary => ungarn
krishna => krishna
la => La; la
inconsistency => Inkonsistenz
gangster => Gangster
sucked => genuckelt
agoraphobia => Agoraphobie
circulating => zirkulierend
ohio => ohio
hopper => Heuhüpfer
interpretation => Interpretation; Interpretierung
smugglers => Schmuggler; Schmugglerinnen
rainstorm => Regensturm
submerge => Submersion
hawker => Falkner
adoptive => adoptiv; Adoptiv-
villas => Villen
platforms => Plattformen
kamp => kamp
ara => Ara
ironies => Ironien
charlatan => Scharlatan; scharlatan
catastrophic => katastrophal; Katastrophen-; katastrophisch; Katastrophal
falsifying => falsifizierend
britannia => britannien
blaze => Flamme; flammen
intercepted => unterbrochen
releasing => Freisetzung
dipstick => Peilstock
chamois => Gams
rattling => Rattern
culturally => kulturell
sioux => Sioux
bedding => Bettung; bettend
prevailed => prävaliert
centrifuge => Zentrifuge; Zentrifugal; zentrifugieren; Zentrifugalkraft; etwas Zentrifugales; Zentrifugation
crispy => frisch
anathema => Anathema; Anathem
explosive => explosiv; explosionsartig; Explosivstoff; explosionsfähig
maya => maya
casting => Casting; Besetzung
auntie => Tante
barriers => Barrieren
medulla => Medulla
fiddle => Fidel
jason => iason; jason
slumped => plumpste; geplumpst
bern => bern
creamy => cremig
egotistical => egoistisch
intend => intendieren
forearm => Unterarm; Vorderarm; Vorarm
supporter => Befürworter
shawl => Shawl; schal
gardenia => Gardenie; Gardenia; gardenien
malware => Malware
committees => Komitees
jd => jd
iq => iq
knapsack => Rucksack; Knappsack
gallon => Gallone
stutters => stottert
neanderthal => Neandertaler
raining => regnend; regnen
crew => Crew
celibacy => Zölibat
fable => fabulieren
goatee => Goatee
under => unter; unterhalb; darunter; unten; weniger; Inneres
father => Vater; Pater; Pate; Pfarrer; Väter
aka => Aka
siphon => Siphon; Sipho; Siphon m
stride => schreiten; Stride-Piano
hymen => Hymen; Hymenaios; Hymenäus
femininity => Feminität; femininität
gargoyle => gargoyle
leonard => leonard
altruistic => altruistisch; Altruismus
email => E-Mail; mailen; Email; Mail; emailen; e-mailen
houses => Häuser
panther => Panther; Panter; panther
neurological => neurologisch; neurologische
keen => kühn; beißend
apostrophe => Apostroph; Apostrophe
georgetown => georgetown
krypton => Krypton; krypton; Krypton-
hypnotic => hypnotisch; hypnotisierend; Hypnotikum
pathos => Pathos
misery => Misere
ci => ci
interactive => interaktiv; Interaktivität; Unterhaltung; interactiv
fascists => Faschisten
fez => Fez; fez
nuance => Nuance
typing => Typisierung; tippend
squeeze => ausquetschen
divisions => Divisionen
bigamist => Bigamist
lipsticks => Lippenstifte
allergy => Allergie
relay => Relais
corporate => korporativ
fancier => Kenner
plane => Platane
angst => Angst
fabian => fabian
tennessee => tennessee
borneo => borneo
steward => Steward
psychiatrist => Psychiater; Psychiaterin; Psychiater ''m'' -s; Psychiater -s; Psychiat
olympics => olympiade
galleon => Galeone
turnpike => Turnpike
cells => Zellen; Zelle
holler => brüllen
moderation => Moderation
yard => Yard
firm => Farm
aloha => Aloha
wheeling => wheeling
kirk => kirche
carbon => Karbon; Carbon
rodent => Rodentia
reservoir => Reservoir
intermission => Unterlass; Intermission
ulster => Ulster
dundee => dundee
blues => Blues; Blaumiese
vietnamese => vietnamese; vietnamesisch
alligators => Alligatoren; Alligator; Alligatoridae
attraction => Attraktion; Attraktivität
diction => Diktion
rams => rammt
regale => regale
joyce => joyce
tolerant => tolerant; fehlertolerant; tolerante; tolerant, duldsam
ringer => Klingeln
tactical => taktisch
magnus => magnus
baptism => Baptismus
ducked => geduckt
drinks => Trünke
provisional => provisorisch
ponies => Ponys
animator => Animator; Animatorin; Animateur
triage => Triage; triagieren
til => Til
erectile => erektil
humanism => Humanismus; Humanität
artillery => Artillerie; Artillerist; Artilleriewesen; Artillerietruppe
vomiting => Vomitus
attaching => festmachend
camped => kampierte; kampiert
hopi => hopi
roosevelt => roosevelt
symmetrical => symmetrisch
potty => Pott
syntax => Syntax
infection => Infektion; Infekt; infektion
bos => Bos
robbers => Räuber
workstation => Workstation; Arbeitsstation
snatching => haschend
fraternity => Fraternität
shikoku => Shikoku
dated => datiert
humid => humid
research => Recherche
tucking => steckend
denser => dichter
peeler => Schäler
canaan => kanaan
corky => korkig
eureka => Heureka
lightheaded => leichtfertig
effusion => Effusion
cellulite => Cellulite; Cellulitis; Zellulite; Zellulitis
anthropologists => Anthropologen; Anthropologinnen
billy => Billy
canton => Kanton
cargo => cargo; Kargo
traded => trieb Handel
taiji => Taiji
tequila => Tequila
sapper => Sappeur
congeniality => Kongenialität
synthetic => synthetisch; Synthese; einheitlich
philanthropic => philanthropisch
flew => flog; flogen
irritates => irritiert
lax => lax
registrations => Registrationen; Registrierungen
prudish => prüde
signet => Signet
moderates => mildert
jewellery => Juwelen
monetary => monetär
crustacean => Krustentiere; Krustazeen
batch => Batch
ambassador => Ambassadeur
birdie => Birdie
canals => Kanäle; Kanal
turbine => Turbine; turbine
adrienne => Adriane
nadir => Nadir
monger => Händler
capitalists => Kapitalisten; Kapitalistinnen
socrates => sokrates
frontiers => Frontiers
streams => strömt; Strom; Ströme
rally => Rallye
windsor => windsor
hypertensive => hypertoniker
frack => fracken
outlander => Ausländer; ausländer
athena => athene
barbados => barbados
furious => furios
chief => Chef
dyke => dyke
candida => Candida
sand => Sand; sanden; versanden
define => definieren
picnic => Picknick; picknicken
afloat => flott
gorilla => Gorilla; Gorilla gorilla; gorillas
chisel => Meißel; meißeln; Beitel; Stechbeitel; schummeln
classical => klassisch; Klassiker
nessie => nessie
polling => Polling
stammering => Stammeln; stammelnd; stotternd
enos => enosch
autobahn => Autobahn; Bundesautobahn; Autobahn (A)
gastritis => Gastritis
wisconsin => wisconsin
alcmene => alkmene
repaired => repariert
command => Kommando; kommandieren
thar => Thar
inflamed => entflammte; entflammt; infiziert
falling => Fall; fallend
morgen => Morgen
hornet => Hornissen; F-18 Hornet; hornissen
hummel => Hummel
services => Verdienst; Service-Industrie
telegraphed => telegraphierte; telegraphierten; telegrafiert; telegraphiert
wisely => weise
offline => offline; off; Offline
hemorrhoid => Hämorrhoide; Hämorrhoiden; hämorride
vehicle => Vehikel
sprout => Spross
bosses => Bosse
criticising => kritisierend
keel => Kiel
excellently => exzellent
salient => markant
cardamom => Kardamom; Kardamomen; grüner kardamom
leon => leon
equipment => Equipment
terrorizing => terrorisierend
hanging => hängend; Hängen; Erhängung; Hängung
scuff => schlurfen
venezuela => venezuela
methodology => Methodologie; Methodik; Methodenlehre; methodologie; Methode
walker => Alice Walker; walker
benefited => begünstigte
wept => geweint; weinte; beweint
caliber => Kaliber
bootleg => Bootleg
somalia => somalia
helios => helios
genre => Genre
aachen => aachen
scrambling => Scrambling; scrambling
unpublished => Unpubliziertheit
colonialism => Kolonialismus; kolonialismus; Imperialismus
clang => klingen
tiberius => tiberius
attache => Attache; Attaché
fleck => Fleck; Flecken
kwan => Kwan
pusher => Pusher
partition => Partition
schizophrenic => schizophren; Schizophrene; Schizophrener
warmed => erwärmten; warm geworden
transcribe => transkribieren; abschreiben; überschreiben; genau beschreiben
unruly => unruhig
rolling => Rollen; wellig; rollend; rollierend
idealist => Idealist; Idealistin; idealistisch
ingested => eingenommen
animosity => Animosität
burgundy => burgund; Burgunderwein; burgunder
norway => norwegen
who => wo; who
hasty => hastig; Hast
franc => Franc; Franken
lambert => Lambert
amnesia => Amnesie
par => Par; Pari; pari
cynic => Zyniker; zynisch; Kyniker; kynisch
holier => heiliger
melancholy => Melancholie; melancholisch
liberal => liberal; Liberaler
auburn => auburn
jaeger => Jäger
operations => Operationen
unpopular => unpopulär; unpopulär sein; Unpopularität
location => Position; Location
lotion => Lotion
fruity => fruchtig
anticipating => Antizipieren; antizipierend
euthanasia => Euthanasie; Sterbehilfe Euthanasie
presbyterian => Presbyterianer
hand => Hand
screech => schreien
doctoral => Doktor; Doktor...
scraper => Schaber; Kratzer; Schabe; Schrapper
tester => Tester
acetone => Azeton; Aceton; aceton
vane => Fahne
eliminates => eliminiert
simmer => sieden; simmern
explosions => Explosion; Explosionen
liquidate => liquidieren
sol => Sol; Sole; sol; so
tutankhamun => tutanchamun
render => rendern; präsentieren
blabbermouth => Plappermaul
imitations => Imitation; Replikation; Imitationen
lichen => Flechte; Flechten; Lichen; flechten
breakout => Breakout
generators => Generatoren
kilometres => Kilometer
shipping => Verschiffung
piranha => Piranha; Piranhas; piranhas
harmonics => Harmonielehre; Harmonik; Harmonischen
strenuous => anstrengend
lines => Linien
intercom => Intercom
ken => kennen; Ken
pathology => Pathologie; pathologie; Humanpathologie; Tierpathologie
round => rund; runden
exile => Exil; Exilant; exilieren
moor => Moor; Mohr; Hochmoor
toilets => Toiletten
epsilon => Epsilon
processors => Prozessoren
fusion => Fusion
vandals => Vandalen
restrictions => Restriktionen
bruges => brügge
tattle => tratschen
academics => Akademiker; akademische
sunblock => Sunblocker; sonnenblocker
spiked => spitz; beißend; bespickte
substances => Substanzen; Substanz
krakow => krakau
grouping => Gruppierung; Eingruppierung
orally => oral
meetings => Meetings
protons => Protonen
confrontation => Konfrontation
detector => Detektor
perjury => Perjuration
pollux => pollux
cabin => Kabine
lodgings => Logis
bug => Bug
ou => Ou
urinate => urinieren
yips => Yips
schemer => Verschwörer
rationed => rationierten; rationiert; rationierte
shrapnel => Schrapnell
shorten => kürzen; stutzen
requiem => Requiem
stringy => strähnig; steif
distanced => distanzierte
curriculum => Curriculum
hallo => Hallo; hallo
coochie => muschi
cleaning => Reinigung
sides => seiten
scanning => Scanning
respectable => respektabel
sitter => Babysitter; Sitzender
rounded => gerundet; rund
okey => ok; okay
scroll => Schriftrolle; scrollen
exclusivity => Exklusivität
fix => fixen
basset => basset
podium => Podium; Podien; podest
kuru => Kuru
kernel => Kern; Kernel; kernel
shanghai => schanghaien; schanghai; shanghai; shanghaien
persistence => Persistenz
debuted => debütiert
compatible => kompatibel; Kompatibilität
granada => granada
fatter => fetter
landed => gelandet; landete
emigrant => Emigrant; Emigrantin; Arbeitsmigrant
hockey => Hockey; Eishockey; Feldhockey; Hockeysport; Landhockey
anaconda => Anakonda; Anaconda; Große Anakonda; anaconda
assistance => Beistand
darkly => dunkle
ovaries => Ovarium; Ovariole
drainage => Drainage; Dränage
lust => Wollust; Lust
bigoted => bigott
stiles => Steigen
reaches => reicht
capture => kapern
celluloid => Zelluloid; Celluloid; Cellulosenitrat; Nitrocellulose
compromise => Kompromiss; kompromittieren; Kompromiß
yahtzee => Yahtzee
sicken => aneklen; anekeln
smuggler => Schmuggler; Schmugglerin
earlier => früher; eher; vorher
raki => Raki
insights => Einsichten
migration => Migration
dinner => Diner; Dinner
legacy => Legat
detainees => Arrestantinnen
scrubbed => geschrubbt
résistance => Resistance; Résistance
ganja => Ganja
negativity => Negativität
spontaneity => Spontaneität; Spontanität
absolute => absolut
coconut => Kokosnuss; Kokosnuß; Cocos; Kokonuss
equinox => Äquinoktium; Äquinoktikum
diorama => Diorama
kama => Kama
civilisations => Zivilisationen
firmament => Firmament; Himmel; Firmament -s
whoever => jeder
provocation => Provokation
via => via
russ => russisch
chameleon => Chamäleon; chamäleons
beanstalk => bohnenstange
raven => Raben
paradise => Paradies; paradies
dos => dos
refrigerator => Gefrierfach
denies => dementiert
grounded => grundierte; begründet; gegründet; grundiert
conceptual => konzeptionell; konzeptuell
authentication => Authentifizierung; Authentifikation; Authentisierung; Legitimation
boiler => Boiler; Kocher
acme => Akme; acme
galileo => galilei
foghorn => Nebelhorn
dose => dosieren; dosis
harsher => rauher; rauer
taylor => taylor
gloss => Glosse; glossieren
capitalistic => kapitalistisch
hyena => hyänen
tenerife => teneriffa
nazism => Nazismus; nazismus
pointer => Zeiger; Pointer; Laserpointer
academically => akademisch
curate => Kurat; kuratieren
abort => Abort; abortieren
portray => porträtieren
pet => Pet
formidable => formidabel
lorelei => Loreley
gaga => gaga
pluck => pflücken
derogatory => derogatorisch; derogativ
snacks => Snacks
barrel => Barrel
curvy => kurvig
telegram => Telegramm; Telegrammtext; telegrafieren; telegraphieren
meditative => meditativ
moderator => Moderator; Moderatorin
eradicate => vernichten
humanoid => humanoid; Humanoide; Humanoid; humanoider Roboter
junta => Junta; Militärjunta
astronomer => Astronom; Astronomin; Astronomus
theses => Thesen
probation => Probation
manchester => manchester
intracranial => intrakraniell; intrakranial
acrobatic => akrobatisch; Akrobat...; Akrobaten-
bombing => Bombardierung; bombardierend; bomben
olympic => olympisch; olympic
female => feminin
stimulant => Stimulans; stimulierend
epitome => Epitome; Epitom
inception => Anbeginn; inception
singular => Singular; singulär
apparatus => Apparat; Apparatur
fewer => weniger
specialized => spezialisiert; Spezial-; sich spezialisiert; speziell
tattletale => Tratschtante
talentless => talentlos
moped => Moped
bloodlust => Mordlust
musician => Musikant; Musikerin
puppet => Puppe; Handpuppe; Holzpuppe
amir => Emir; emir
roman => römerin
mem => mem
rehabilitated => rehabilitierte
shalt => sollst
grandmaster => Großmeister
beemer => Brenner
berber => Berber; berber; berberisch
blabber => plappern
sharpshooter => scharfscütze
flees => flieht
rifle => Pistole
representative => Repräsentant; repräsentativ
relatively => relativ
clearer => heller
tolerate => tolerieren
indian => indisch; inder; inderin; indianer; indianerin; indianisch; indio
middling => leidlig
instructs => instruiert
jos => jos
philosophical => philosophisch; philosophischen
breached => gebrochen
rotterdam => rotterdam; rotterdamer
verger => Mesner
finder => Finder; Finderin
symptomatic => symptomatisch; symptomatische
drilling => Training; drillend
sudo => Sudo
zachariah => zacharias
november => November
whiter => weißer
saddle => satteln
storey => stock
sambo => Sambo; Zambo
centers => Zentren; zentriert
catechism => Katechismus
servers => Server; Servierer
nitrogen => Nitrogen; Nitrogenium
aussie => australien
dir => Dir
falconer => Falkner; Falkenjäger; Falknerin
wallpaper => Wallpaper
sonogram => Sonogramm; Sonografie
whitehall => whitehall
curve => Kurve
concussion => Konkussion
notoriously => notorisch
mustang => Mustang
religious => religiös
shalom => Schalom; Shalom
motor => Motor; motorisch
engineer => Ingenieur; Ingenieurin
exotic => exotisch; exot
oxide => Oxid; Oxide; Oxid...
blockage => Blockade; Straßenblockade
answer => antworten; Antwort
pine => Pinie
drapes => drapiert
pasta => Pasta; Paste
mogul => Mogul
chips => Chips
validated => validiert
lava => Lava; Lave
forefront => Vordergrund; vorderste Front
organise => organisieren; Organisation; Organisieren; Organisator
lethargic => lethargisch
freeman => freier Mann
triangulated => trianguliert
optometrist => Optometrist; Optometer; Optikerin
certificate => Zertifikat
composing => Komposition; komponierend; komposition
risking => riskierend
polygamy => Polygamie; Polygynie
musketeer => Musketier; Musketier der Garde
endures => erduldet
commerce => Kommerz
surf => surfen; surf; Surfen
enlightening => erleuchtend
inspecting => Inspektion; inspizierend
parked => geparkt; parkte; parkten
extractor => Entsafter; Separator
denise => Denise
hermetically => hermetisch
typically => typisch
waterfalls => Wasserfall; Wasserfälle
alcoholics => Alkoholiker
reproductive => reproduktiv
designate => designieren
determination => Determination
nona => nona
charismatic => charismatisch; Charismatiker; Charismatikerin
pierced => gepierct
handmade => handgemacht; handgearbeitet
knots => Knoten; knotet; verknotet
quantum => Quant; Quantum; Quanten; Quanten-
noting => notierend
siberian => sibirisch
win => Gewinn
erect => errichten; aufrecht; erigiert
hospitalised => hospitalisiert; hospitalisierte
icon => Icon; Ikon; Zeichen
crash => Krach; krachen; Crash; Krachen
intensely => intensiv
templar => Templer; Templer -s; tempelritter
dart => Dart
vitamin => Vitamin; Niacin
entering => Unterbringung
curiosities => Kuriositäten
classics => Klassik; Klassiker; klassische Musik; klassisches Werk
androids => Androiden
answering => antwortend; antworten; beantwortend
terrorists => Terroristen; Terrorist; Terroristin
commie => Kommi; Kommunist
scene => Szene
bring => bringen; mitbringen; herbringen; erbringen; überbringen; hinbringen; anbringen
octagon => Oktogon; Oktagon
islamic => islamisch
pelvis => Pelvis
liaison => Liaison
record => Rekord
standoff => Abstandsbolzen
rom => rom
design => Design; designen
should => soll
monotone => monoton; monton; Monotonie; monotones Geräusch
reigning => regierend
ent => Ent
kappa => Kappa
honduras => honduras; republik honduras
dispensary => Dispensaire
diplomatic => diplomatisch
odour => Odor
evaluation => Evaluation; Evaluierung
neuroscience => Neurowissenschaften; Neurowissenschaft
green => grün; grünen
minivan => Minivan
beakers => Becher
nano => Nano
restructuring => Umstrukturierung; Restrukturierung; Neustrukturierung
analysis => Analyse; Analysis
teleportation => Teleportation
compilation => Kompilation; Compilierung; Kompilierung
dorsal => dorsal; dorsale
prince => Prinz
bands => Bands
oracle => orakeln
colic => Kolik; kolik
communicator => Kommunikator; kommunikativer Mensch
synopsis => Synopse; Synopsis
western => westlich; Western; West; western; West-
symphonic => symphonisch
mulberry => Maulbeere; Maulbeerbaum
keeper => Keeper
sown => säen
tiptop => tipptopp
iranian => iranisch; iraner; iranerin
neck => Genick
ran => rannte
persuasive => persuasiv
acreage => Areal
sailboat => Segelboot
priesthood => Priestertum; Priesterschaft; priesterwürde
madras => Madras
unforeseen => unvorhergesehen; unvorgesehen
unofficially => inoffiziell; inoffizielle
meant => gemeint; meinen
pelvic => pelvin
statuette => Statuette
tunnel => Tunnel; Folientunnel
monaco => monaco
hadji => Hadschi; haji
cinematography => Kinematographie; Kinematografie; Cinematografie; cinematographie
neo => neo
expertise => Expertise
buggy => Buggy
inhalation => Inhalation; Inspiration; Aspiration
manor => Manor
block => Block; blockieren; Häuserblock; abblocken
ido => ido
sash => Fatsche
indiscretion => Indiskretion
document => Dokument; dokumentieren
individual => Individuum; individuell
bassist => Bassist; Bassistin; Kontrabassist; Kontrabassistin
mystical => mystisch; mystische
flyer => Flieger; Flyer
warrant => Garantie
mentors => Mentoren; Mentorinnen
fettuccine => Fettuccine
criterion => Kriterium
bulgarian => bulgarisch; bulgare; bulgarin
ainu => ainu
website => Website; Webseite
confirm => konfirmieren
prom => Prom
inch => Inch
subatomic => subatomar
sweatshop => Sweatshop
hardball => Baseball; baseball
rescuing => Rettung
yodeling => Jodeln; jodelnd
forests => Forste
mentality => Mentalität; Denkart
al => Al
simulation => Simulation; Simulieren; Simulierung; Imitation
grille => Grill; grill
soba => Soba
castile => kastilien
ranching => Ranching
combination => Kombination
beehive => Beehive-Frisur
photogenic => fotogen; photogen; Fotogenität
gardner => Gärtner; Gärtnerin
zest => Lust
machiavellian => machiavellistisch
kursk => kursk
person => Person; Wesen
junior => jünger; Junior; junior
caddy => Caddie; Caddy
georgia => georgien; georgia
atomic => atomar; Atom; atomisch; Atom-; Atom...
informing => informierend
understandable => verständlich
aga => aga
getty => getty
aberration => Aberration; Aberratio
offshore => offshore; Off-Shore-
livy => livius
omelette => Omelett; Omelette
shunt => Shunt; shunt
squeaks => quiekt
array => Array
moustache => Moustache
curt => kurz
reactive => reaktiv
caviar => Kaviar; kaviar
philippine => philippinisch
hydroxide => Hydroxid; Hydroxyd; Hydroxide
diploma => Diplom
tentative => tentativ
bunches => Bunde
turtle => Turteltaube
dubious => dubios
byline => Nebenlinie
lorazepam => Lorazepam
jig => Jig
janus => janus
mandates => Mandate
trickling => sickernd; triefend
radiator => Radiator; radiator
nest => Nest; nisten; Vogelnest
systematic => systematisch; System
swing => schwingen; Swing; Schwingen
mangled => gemangelt
bastards => Bastarde
bundles => Bündel
bolsheviks => Bolschewiken; Bolschewiki
broccoli => Brokkoli; Broccoli; Broccolisprossen
rapidly => rapide; rapid
hierarchy => Hierarchie
simpleton => Simpel
retrieving => rettend
clara => klara
manipulating => manipulierend
whisker => Whisker
erratic => erratisch; irrig
ideal => ideal; Ideal; ideell
platform => Plattform
mayo => Majo; Mayo
clammy => klamm
gallantry => Galanterie
valkyrie => Walküre
fecal => fäkal
elevators => Becherelevator
java => Java; java
fraternizing => fraternisierend
replay => replay
mulch => Mulch; mulchen; Mulchen
guatemala => guatemala; republik guatemala
presses => Presse; Pressen
sensei => Sensei
wording => Formulierung
fucking => ficken; Ficken
plum => Pflaume
shearer => Schafscherer; scherer
tracer => Tracer
reminiscent => reminiszent
uproot => ausrotten
byproduct => Nebenprodukt
stradivarius => stradivari
extravaganza => Extravaganza
karachi => karatschi
mare => Mare
fleming => flame
mage => Magier
cult => Kult; Kultus; Kult-; kultig
stimulated => stimulierte
gestapo => Gestapo
vishnu => vishnu
impartial => unparteiisch; unparteilich
kissed => küsste
mongolia => mongolei
men => man
sanitizer => Reiniger
colony => Kolonie
smelting => Abschmelzung; schmelzend
boor => Tor
ai => Ai
paradigm => Paradigma; Flexionsparadigma
folding => faltend; Faltung
crashing => krachend
enthusiastically => enthusiastisch
directional => direktional; bidirektional
latch => Latch
southwest => Südwest
motherland => Vaterland; Mutterland
offer => Offerte; offerieren; opfern
ate => aßen; at
bluish => bläulich; Bleiche; blaustichig
mobilize => mobilisieren; mobil machen
additional => additiv; additional
angela => angela
diabetes => Diabetes; Diabetes mellitus; diabetes Mellitus
twisted => Twist
sapphire => Saphir; saphiren; saphir; saphirblau; Sapphire; Saphir -s
basra => basra
handstand => Handstand
latter => letztere; letzter; letzterer; zweiter; letzte; Letztere; letzteres
hardens => härtet
forensics => Forensik
neolithic => neolithisch; Neolithikum; nölitisch; neolitisch
pliny => plinius
martyrs => martert
overdose => Überdosis; überdosieren; ueberdosis; Überdosierung
qualify => qualifizieren
million => Million; million; Millionen; eine Million
respect => Respekt; respektieren
toughen => eintauchen; tauchen
macintosh => apple macintosh
send => senden; versenden; entsenden; zusenden
gold => Gold; golden; gülden; Geld; gold; goldig
private => privat
influx => Zufluss; Einfluss; Einfuhr; Zufluß
rotisserie => rotisserie
jab => Jab
jarl => Jarl
adequate => adäquat
biker => Biker; Rocker; Bikerin
friend => Freund
coronary => koronar
wealthier => reicher; Reicher
id => Id; ide
finesse => Finesse; Raffinesse
confluence => Konfluenz
lustful => lüstern
decree => Dekret; dekretieren
sporadic => sporadisch
onyx => Onyx
immovable => Immobilie
substandard => Substandard
sexual => sexuell; sexual; Sexual; Sexual...
bronco => bronco
skepticism => Skeptizismus; Skepsis
elm => Ulme
fen => Fenn
unmade => ungemacht
chaff => Kaff; Schale
cellulose => Zellulose; Cellulose; Zellstoff
swahili => Swahili; Suaheli
mask => Maske; maskieren; Mundmaske
angiogram => Angiogramm
smuggled => geschmuggelt; schmuggelte
election => Elektion; Election
ammunition => Munition
transmutation => Transmutation
rhetorical => rhetorisch; rhethorisch
compensated => kompensiert
hangers => Aufhänger; Anhänger
herbal => Herbarium; herbarium
wal => wal
marshall => Marschall; marshall
partisan => Partisan; Partisane; parteiisch; Partisanin; Parteigänger
teaching => Unterweisung; Unterrichtung; Belehrung
robes => Roben
dialog => Dialog; Dialogfeld
fax => Fax; faxen; Telefax
consolidate => konsolidieren
crucifix => Kruzifix
caregiver => Pfleger
swim => schwimmen
cantor => Kantor
construct => konstruieren; Konstrukt
frugal => frugal
online => online; Online; Online...
macao => macao
weekend => Weekend
marimo => Marimo
sonar => Sonar
genome => Genom
omaha => omaha
half => halb; Halfte
cw => cw
puma => Puma
demos => Demos
disillusionment => Desillusionierung; Desillusion
weights => Gewichte
portraying => porträtierend
knockouts => Knockouts
semen => Samen
buddhism => buddhismus
tang => Seetang
sicilian => sizilianer; sizilianisch
intensive => intensiv; intensive
prospecting => Prospektion; Prospektierung
mandatory => mandatorisch
corrupts => korrumpiert
papua => papua
amphibians => Amphibie; Amphibien; Amphibia
perugia => perugia
imaginary => imaginär
grenade => Granate; Handgranate; Wurfgranate
prove => prüfen; erproben
continents => Kontinente
asgard => asgard
police => Polizei; polizeilich; polizei; Polizei-
cerebral => zerebral; Zerebral-; cerebral; Cerebro-
gynecologist => Gynäkologe; Gynäkologin
reviewing => rezensierend
liposuction => Liposuktion
juggler => Jongleur; Gaukler; Magier
couplet => Couplet
spaniards => spanier
absolution => Absolution
thread => Thread
kyu => Kyu
mingle => mischen; mengen
cameras => Kameras
duelling => duellierend
reflects => reflektiert
obstetrics => Obstetrik
rosé => Rosé
steer => steuern; Stier
smith => smith
bushes => Buschwerk; Buchsen
i => i
whacked => haute
sexting => Sexting; sexting
worried => Sorge
bora => bora; Bora
element => Element; Bauelement; Moment
copywriter => Copywriter
fingerprints => Fingerabdrücke
corresponds => korrespondiert
configuration => Konfiguration
lump => Klumpen
pester => piesacken
prefect => Präfekt; Präfektin
respectful => respektvoll
hemisphere => Hemisphäre; Hemisphere
symptom => Symptom; Krankheitssymptom; krankheitssymptom
edinburgh => edinburg; edinburgh
hip => hip
modernize => modernisieren; Modernisieren; Modernisierung
tormented => triezte
transferred => transferierte; transferiert
depressing => deprimierend
taro => Taro
applause => Applaus
downtime => Downtime
claustrophobic => klaustrophobisch
maritime => maritim; marin
reduction => Reduktion
anastasia => anastasia
amputee => Amputierte; Amputierter; amputierte
aberrant => aberrant; aberrante
sympathizers => Sympathisanten; Sympathisantinnen
breathed => geatmet
ambiance => Ambiente; Ambiance
qualifications => Qualifikation
graduation => Graduierung; Gradeinteilung; Promotion
tolerated => toleriert; tolerierte
anthrax => Anthrax; Anthraknose
instruction => Instruktion
trauma => Trauma; trauma
whistleblower => Whistleblower
cooperates => kooperiert
femur => Femur
humming => summend; Summen; Brummen; brummend
prescriptions => Präskriptionen
combo => Combo; kombi
scotch => schottisch; Scotch
inference => Inferenz
toner => Toner
intervene => intervenieren; eintreten
robotic => roboterhaft
hypnotised => gehypnotisiert
answers => antwortet
palate => Palatum
corrosive => korrosiv; korrodierend
gratin => Gratin; Gratinieren; gratinieren
napoleon => Napoleondor
hernia => Hernie; Hernia; hernie
assembled => assemblierte; assembliert
spatter => spritzen; Spritzer; schwatzen
revised => revidierte; revidiert
greenback => Greenback
unkempt => ungekämmt
visions => Visionen; Vision
alarmed => alarmiert
boxes => Boxen; boxt
seminary => Seminar
revolutions => Revolutionen
oaks => Oaks
ideally => idealerweise; ideell; ideal
creek => Creek
instant => instant
banker => Bankier; Banker; Bankdirektor; Bankhalter; Bank; Bankchef; Bankbeamter
filmmakers => Filmemacher; Filmemacherinnen
jazz => Jazz; jazzen; jazzmusik
motivations => Motivationen
run => Run
democrat => Demokrat; Demokratin; demokratisch
monseigneur => monseigneur
cardiovascular => kardiovaskulär; kardiovaskular
dinghy => Dingi; Dinghi; Dinghy
ruthless => ruchlos
equator => Äquator
ulna => Ulna; ulna
mutiny => meutern
shamelessly => schamlos; schamlose
pope => Pope
baggage => Bagage
storming => erstürmend; stürmend
comic => komisch; Comic; Komiker; Comicheft
urgency => Urgenz
servitude => Servitut
hints => Winks
curves => Kurven
shite => Scheiße
hamper => hindern
waters => wässert
dopamine => Dopamin
steep => steil
flashlights => Blitzlichter
optic => optisch
disorganized => desorganisierte; desorganisiert
demonstrating => demonstrierend
tau => Tau
intact => intakt
israelite => israelit
jukebox => Jukebox; Musikbox; Musicbox
sportsman => Sportler; Sportsmann; Sportlerin
contrasts => Kontraste
aortic => Aorten-; aortal; aortisch; Aorta-
flatulence => Flatulenz
zion => zion
wisteria => Wisteria; Wistarie
articulate => artikulieren; artikuliere
malta => malta
mammal => Mammalia; Mammalier
visually => visuell
inhales => inhaliert
fund => Fundus
experiences => Experimente; empfindet
baggy => Buggy
gangway => Gangway; Gang
paneling => Wandbekleidung; Täfelung; paneelierend
antidepressant => Antidepressivum; antidepressiv
implication => Implikation
stigma => Stigma
promiscuity => Promiskuität; promisker Sex
either => entweder
upgrade => Upgrade; upgraden
beeps => beept
themes => Themen; Themata
implode => implodieren
kickboxing => Kickboxen; Kickboxing
raging => rasend
amoral => amoralisch; amoral; unmoralisch
analysing => analysierend
undocumented => undokumentiert
generate => generieren
papa => Papa; Papi
documentaries => Dokumentarfilme
aggro => aggressiv
barmaid => Bardame; barfrau
velvet => Velvet
mosque => Moschee
yankee => Yankee; yankee
sapphires => Saphire
paired => paarig; paarweise
genes => Gene
persia => persien
rebelling => rebellierend; revoltierend
cabinets => Kabinette
por => por
overwhelming => überwiegend
arbitrarily => arbiträr
lurk => lauern
bullshitter => Dummschwätzer
exterminator => Exterminator
spared => erspart; gespart
hang => hängen
horoscopes => Horoskope
peer => Peer
filet => Filet
tend => tendieren
guaranteed => Garantie; garantiert; garantierte; mit Garantie
san => San; san
mended => genesen
melodic => melodisch
bahia => Bahia
splutters => stottert
praises => preist an
untrained => unerfahren
max => max
grills => grillt; Grillen
binds => bindet
bouillon => Bouillon
satan => Satan
imagined => imaginär
enter => eintreten; eintragen
snickers => kichert
thickness => Dicke
music => Musik
cabaret => Kabarett; Cabaret; Kabaret
guerilla => Guerilla; Guerillakämpfer; Guerillero
strategically => strategisch; strategischer; strategisches
pleading => Verteidigung
proton => Proton
shh => sch
graviton => Graviton
spike => Spitze; Spike
humbug => Humbug
entrusted => vertraute an
bursts => berstet
concede => konzedieren
latex => Latex
output => Output
undisputed => unbestritten; unumstritten
correct => korrekt; recht
intense => intensiv
manuscript => Manuskript; Handschrift; Handscrift; handschriftlich; Manuscript
rumbling => rumpelnd
beater => Treiber
lusty => lüstern
cambodian => kambodschaner; kambodschanisch
violet => violett; Violett; Violet
prism => Prisma; prisma; Winkelprisma
emotionless => emotionslos
lymphoma => Lymphom
shinto => Shinto; shintō
numbered => numeriert; nummeriert; numerieren
presence => Anwesenheit; Präsenz
compress => komprimieren; Kompresse
superheroes => Superhelden
portsmouth => portsmouth
evident => evident
oratory => Oratorium
premieres => Premieren
mosquitoes => Moskito; Moskitos
melodious => melodiös; melodisch
carotid => Carotis; Karotis
beginnings => Beginn
thunk => Thunk
mecca => mekka
basal => basal
dubrovnik => dubrovnik
spear => Speer
portions => Portionen
resume => Resümee
posts => Pfosten; Posten
chica => chica
tonnage => Tonnage; Tonnengehalt
corrupt => korrupt; korrumpieren
crepe => Krepp; Crêpe; Crepe
perception => Perzeption; Rezeption
munich => münchen
predisposition => physische Konstitution
swastika => Swastika
breadwinner => Brotverdiener
hustled => stieß
zaire => Zaire
substitute => substituieren
nicest => netteste; nettesten
secondary => sekundär
illinois => illinois
paranoia => Paranoia
classmate => Klassenkamerad
militarily => militärisch
loyalty => Loyalität
hilton => hilton
lobbying => Lobbying; Lobbyismus
samoan => samoaner
tantalizing => langweilig
partnerships => Partnerschaft; Partnerschaften
originally => originell
endings => Endungen
tenor => Tenor
gymnasium => Gymnasium; Gymnastikraum; gymnasium
unwashed => ungewaschen
myanmar => myanmar
untalented => talentlos; untalentiert
shimizu => shimizu
punctured => punktiert
armenians => armenier
enclose => einschließen
slung => geschlungen
rebelled => rebellierte; rebelliert
seasonal => saisonal
moussaka => Moussaka; Mousakas
twelfth => zwölfte; Zwölftel; Zwölfte; zwölfter; Zwölfter
bonded => gebunden; verbunden
generously => generös
rudy => rudi
convalescence => Rekonvaleszenz; Rekonvaleszenzzeit
du => du
motto => Motto
nicknames => Spitznamen
unrestricted => unbefristet
opportunistic => opportunistisch
prediction => Projektion; Präkognition
shots => Geschoss
escalator => Eskalation
elasticity => Elastizität; elastizität
expansion => Expansion
dwarves => dwarves
welder => Schweißer; schweißer
fresh => frisch; frech; Frische
insightful => einsichtig; einsichtsvoll
pyramids => Pyramiden
tradesman => Handelsmann
sufficient => ausreichend; suffizient; zureichend
capitulate => kapitulieren
picks => pflückt; pickt; Pickel; Picken
stifle => ersticken
predictable => prädiktabel
organism => Organismus; Organismen
constituent => Konstituente
charger => charger
molars => Molar
barricade => Barrikade; verbarrikadieren
koran => koran
rectum => Rektum; Rectum; Cäcum
sam => sam
sadists => Sadisten; Sadistinnen
outsource => outsourcen
hungrier => hungriger
anesthetic => Anästhetikum; anästhetisch
ouija => Ouija
handing => einhändigend
vigilance => Vigilanz
unpacked => ungepackt; entpackt; unverpackt
ville => ville
fit => fit
manaus => manaus
thermonuclear => thermokernförmig; thermonuklear
respective => respektive
interview => Interview; interviewen
ese => ese
lili => lili
pershing => pershing
reprogram => umprogrammieren; neu programmieren
commando => Kommando; Kommandotruppe; Kommandosoldat; kommando
incubator => Inkubator
macabre => makaber
stood => stand
grandson => Grosssohn
adoration => Adoration; Faszination
zodiac => Zodiak; Zodiakus; Zodiac
acquisitions => Akquisen; Akquisitionen
zealand => seeland
psychiatry => Psychiatrie
hearts => hearts
ganymede => Ganymed; ganymed
medina => Medina; medina
columbia => columbia
therapies => Therapien
sarcastic => sarkastisch
conflicts => Konflikte
overall => Overall
cracks => knackt; kracht
soles => Sohlen
jingo => jingo
isabel => isabella
leonardo => leonardo
sacking => Sackleinen
chemo => Chemo
stewardesses => Stewardessen
worthless => wertlos
defensive => defensiv; Defensive
bannister => Baluster
rougher => rauher; rauer; roher
pattern => Muster
sinner => Sünder
zealots => Zeloten
idolatry => Idolatrie
month => monat
constant => Konstante; konstant
impulsive => impulsiv; impulsförmig; impulsgebend; impulsiv, treibend
apricot => Aprikose; apricot
firms => Firmen; Firma
f => f.
moniker => Moniker
network => Netzwerk
damn => verdammen
especial => speziell; spezial-
forsaken => verlassen
casablanca => casablanca
marbles => Marbeln
notary => Notar; Notarin; Notare
synthesize => synthetisieren
posting => Notiz
everyone => jedermann
schilling => Schilling; Shilling
benzene => Benzol; Benzen; benzol
shudder => Schauder; schaudern
inhuman => inhuman
tunisian => tunesier; tunesisch
sole => Sohle; Fußsohle; besohlen
shard => Shard
significance => Signifikanz
wondrous => wundersam; wunderbar
redwood => redwood
planets => Planeten
traumatised => traumatisiert; traumatisierte
choreographer => Choreograph; Choreograf; Choreographin; Choreografin
exponentially => exponentiell; exponenziell
obligatory => obligatorisch; obligat
archeologist => Archäologe; Archäologin
cruises => Seereisen
log => Log
toxin => Toxin
pertinent => geeignet
croutons => Croutons; Croûtons
hose => Hose
weighty => gewichtig; wichtig
spasms => Spasmus
is => ist; Kies
scalpels => Skalpelle
sommelier => Sommelier; Sommelière
sceptre => Zepter; Szepter
authoritarian => autoritär; autoritativ
ethiopia => aethiopien; äthiopien
ethereal => ätherisch; etherisch
demolishing => demolierend
aversion => Aversion
samaritan => samariter
pizza => Pizza; Pizzas; Pizzen
slaughtered => schlachtete; schlachtete ab
graduates => Graduierte; Graduierten
paternity => Paternität; Vater; Vatertier; paternitaet
materialize => materialisieren
endorphins => Endorphin; Endorphine
unbecoming => ungehörig
cube => Cube
collided => kollidierte; kollidiert
dorado => Dorade
bankruptcy => Bankrott; bankrott
restored => restauriert; restaurierte
neutralise => neutralisieren; Neutralisation
diazepam => Diazepam
unfair => unfair; unlauter; Unfairness
motherly => mütterlich
exhumed => exhumiert; exhumierte
scrubbing => schruppend
jacob => jakob
spectacularly => spektakulär
pressure => Pressen
momentary => momentan
happening => Happening
biohazard => Biohazard
identified => identifiziert; identifizierte
spray => Spray; sprühen
respects => respektiert
dilated => dehnte
yucatan => yucatán; yukatan
yugoslav => jugoslawe; jugoslawisch
varying => variiert; variierend
fissure => Riss
abandonment => Abandon
arms => Arme
task => Task
russell => russell
blinker => Blinker
mustered => gemustert
electrocute => elektrokutieren
scare => Schreck
trampled => getrampelt; trampelte; zertrampelt; zertrampelte
elizabeth => elisabeth; elizabeth
metz => metz
modify => modifizieren
psychotherapy => Psychotherapie
decimate => dezimieren; dezimiere
taff => taff
legitimize => legitimieren
routing => Routing; Sortierung
incontinence => Inkontinenz
keystone => keystone
oral => oral
verbal => verbal
brunch => Brunch; brunchen
halle => halle
prepare => präparieren
convertible => konvertierbar
larissa => larisa
neutron => Neutron; neutron; Neutron -s
pissing => pieselnd; pissend
dram => Dram; Drachme; Drum; Durham
watt => Watt; watt
complicated => kompliziert; komplex; Kompliziertheit
habitats => Habitat
kid => Kind
cla => cla
partial => parteiisch; partiell
casket => Kassette
standardized => standardisiert; standardisierte; Standard
curveball => Curveball
circulation => Zirkulation; Rotation
rites => Riten
plutonium => Plutonium
april => april
elysium => elysion; elysium
landless => landlos; landlose
patriot => Patriot; Patriotin
romanian => rumänisch
boss => Boss
acceptance => Akzeptanz
continental => kontinental; continental; kontinentaleuropäer
deposit => deponieren
alerting => Alarmierung; alarmierend
perennial => perennierend
irrigation => Irrigation
puritan => puritanisch; Puritaner; Puritanismus
ermine => Hermelin; Hermelinfell; Hermelinpelz
princes => Prinzen
gerry => gerry
pizzeria => Pizzeria
kitchens => Küchen
vincent => vinzenz
westbound => westwärts
narcissist => Narzisst; Narziss; Narzisstin
transmitters => Übermittler
seizing => Zeising
dots => Dots
confession => Konfession
millimeter => Millimeter
exclusive => exklusiv; Exklusivmodus; exklusive
nitroglycerin => Nitroglyzerin; Nitroglycerin; Trinitroglycerol
scandinavia => skandinavien
greet => grüßen
toxic => toxisch; Toxikum
tinfoil => Zinnfolie
kalashnikov => kalaschnikow
peroxide => Peroxid; Superoxyd; Peroxide; Peroxyd; peroxide
idols => Idole; Idols
abnormally => abnorm; unnormal; anomal; abnormal; anormal
forearms => Unterarme; Vorderarme
ha => ha
thicker => dicker
stinking => stinkend; stinkig; Stinker
warm => warm; wärmen
boston => boston; bostoner
institute => Institut; instituieren; initiieren; Anstalt
authorisation => Autorisierung; Autorisation
bengali => bengale; bengali; bengalisch
hooliganism => Hooliganismus; hooligan
pump => Pumpe; pumpen; aufpumpen; Pumps; Luftpumpe; Pump
unattractive => unattraktiv
regiments => Regimente; reglementiert
dionysus => dionysos
pharmaceutical => pharmazeutisch; pharmazeutischen
hospitalization => Hospitalisierung; Hospitalisieren; Hospitalisiertwerden
abysmal => Abyssal
tamper => Stampfer
absurdity => Absurdität
ale => Ale
linguist => Linguist; Linguistin
odysseus => odysseus
hallucinations => Halluzinationen
argentinian => argentinier; argentinierin
uncertain => unbeständig; ungewiß
ratchet => Ratsche
rationalize => rationalisieren; Rationalisierung
shampoo => Shampoo; schamponieren; Schampon; Schampu; Schampus; shampoonieren; Schampun
gave => gab
pollock => Pollack
moira => moira
catheter => Katheter
unsympathetic => unsympathisch
stereotypical => stereotyp; stereotypisch
reversible => reversibel; reversierbar
mush => Mus
magistrate => Magistrat; Magistrate
rolf => rolf
brushes => bürstet
ordeal => Ordal
penguins => Pinguin; Pinguine
coquette => Kokette; kokett
propofol => Propofol
plot => Komplott; Plot; plotten
lynch => lynchen; lynch
plagiarism => Plagiat
orpheus => orpheus
spaniard => spanier; spanierin
leaks => Lecks; leckt
tightness => Dichtheit; Dichte
nymphomaniac => Nymphomanin; nymphoman; nymphomanisch
nanjing => nanking
kurdish => kurdisch
chorus => Chor; Chorus
hugh => hugo
retrograde => retrograd
brew => brauen
peering => Peering
positions => Positionen; positionen; positioniert
airport => Airport
citations => Zitate
sentimental => sentimental; emotional
argued => argumentiert; dargelegt
barricaded => verbarrikadierte; verbarrikadiert
owen => owen
settler => Siedler; Ansiedler
thanksgiving => Danksagung; thanksgiving
trent => trient
hebrew => hebräer; hebräisch
disciplinary => disziplinarisch; disziplinär; Disziplinar-
seeding => Seeding; säend
tig => tig
endorsing => Indossierung; indossierend
divas => Divas
agnes => agnes
favoured => favorisiert
diagnostics => Diagnostik; Diagnose; diagnostisch
imagine => meinen
wei => wei
emphasis => Emphase
profiling => Profilierung; profilierend; Profiler; Profilerstellung
segment => Segment; segmentieren
willingly => willig
yeti => Yeti
lighten => erleichtern; erleuchten; leichtern; blitzen; Leichterung; bleichen
amateurs => Amateure; Amateurinnen
triggering => Triggern
creditor => Kreditor; Kreditgeber; Kredit
texan => texaner; texanerin
paralytic => paralytisch; paralysieren; Paralytiker
odyssey => Odyssee
terracotta => Terrakotta; Terracotta; Terrakottafigur
domicile => Domizil
explosion => Explosion
wins => gewinnt
fled => floh; fliehen
disintegrate => desintegrieren; disintegrieren
threaten => vorwerfen
clubhouse => Klubhaus; Clubhaus
underdog => Underdog
pistols => Pistolen
basel => basel
psychopaths => Psychopathen; Psychopathinnen
flaccid => lasch
buttery => butterweich; butterartig
bondage => Bondage
neonatal => neonatal
manticore => Mantikor; Manticor
chillies => Chilly
resistance => Resistenz
manipulates => manipuliert
celebrating => zelebrierend
impotent => impotent; Impotenter; impotente
dunkirk => dunkerque; dünkirchen
hey => he; ey
reborn => wiedergeboren
clumps => Klumpen
ghoulish => greulich; gräulich
islamabad => islamabad
chimpanzee => Schimpanse; Schimpansen
paraguayan => paraguayisch
evermore => immerfort
confetti => Konfetti; Konfekt
routes => Routen; Fahrtrouten; Marschrouten
pervasive => pervasiv
erin => erin
putt => putten; Putt
kgb => kgb
spoke => Sprosse
tourism => Tourismus; Touristik; tourismus
handy => handlich; handsam
pram => Prahm; Pram
nicholas => nikolaus
liven => beleben
backgammon => Backgammon; backgammon; Backgammon ''n'' -s
badminton => Badminton
incorrect => inkorrekt
polygraph => Polygraph
freakish => freakig
striker => Stürmer; Streikende; Streikender; Angreifer
formula => Formel; Formalitat; Formular
photographic => fotografisch; photographisch; photografisch
wahoo => wahoo; Wahoo
handwriting => Handlinien
speciality => Spezialität; Spezialfach; Spezialgebiet
humorous => humorvoll; humoristisch; humorig
arctic => arktisch; arktis; Arktis; arctisch
headstrong => halsstarrig
degrading => degradierend
megalomaniac => megaloman; Megalomane
roderick => roderick
cirrhosis => Zirrhose
riga => riga; rigaer
paralysed => paralysiert
tranquilizers => Tranquilizer
tangier => tanger
bigger => wichtiger
nymphs => Nymphe; Nymphen
oncologist => Onkologe; Onkologin
tipped => kippte
filipino => filipino; philippiner; philippinisch
pumping => Pumpen; pumpend; Abpumpen
subtract => subtrahieren
weber => Weber
yardstick => Zollstock
veracity => Geradheit
immunity => Immunität; immunität; Autoimmunität; Immunsystem
smutty => schmutzig
precaution => Prävention
complicates => kompliziert
mimes => mimt
prioritize => priorisieren; prioritisieren
chute => Schurre; Schuss; Schütte
checks => Schecks
pseudo => Pseudo...
informed => informiert; informierte
demonstrates => demonstriert; demostrieren
single => Single; einzeln; single
armada => Armada
norse => nordisch
auld => alt
shelf => Schelf
jung => young
haemorrhage => Hämorrhagie
seed => säen; setzen
oligarchs => Oligarchen
proved => erproben; prüfen
snobs => Snobs
cherub => Cherub; Kerub; Cherubim
galley => Galeere; Galley
shaman => Schamane; Schamanin
manifests => manifestiert
cacophony => Kakophonie; kakophonie
secular => säkular
canon => Kanon; Kanoniker; Canon
te => te
incarnation => Inkarnation
bangladesh => bangladesch; bangladesh
hygienic => hygienisch
brigade => Brigade
ding => Ding
pancreas => Pankreas
signpost => Signalposten
zephyr => Zephir; Zephyr
clerics => Kleriker
penny => Penny; Pfennig
electromagnetism => Elektromagnetismus; elektrodynamik
hyperventilating => hyperventilierend
transmissions => Transmissionen
mystique => Mystik
sikh => sikh
utah => utah
luau => Luau
landscaper => Landschaftsgärtner
bengal => Bengal-Katze; bengalisch; bengalen
trimming => Trimmen; Trimmung
refrain => Refrain; refrain
wildcat => Wildkatze; wild
recites => rezitiert
bachelor => Bachelor
bulb => Bulbus
lick => lecken
synchronization => Synchronisierung; Synchronisation; synchronisation; Prozesssynchronisation; Synchronismus
fifth => fünfte; fünfter; fünftel; fünftes
chihuahua => Chihuahua
lucrative => lukrativ
suites => Suiten
cascade => Kaskade; kaskadieren
scratched => kratzte
magically => magisch
delicacies => Delikatessen; Zierlichkeiten
stamping => Stampfen; einstampfend
monorail => Monorail
zoo => Zoo
phallic => phallisch
explain => explizieren
euphoric => euphorisch; Euphorie
amphitheater => Amphitheater
motorcycle => Motorroller
precision => Präzision
scariest => erschreckenste
bottle => Bouteille
perfidious => perfide; perfid
etiquette => Etikette
orchestrating => orchestrierend
corresponded => korrespondiert; korrespondierte
windward => windwärts
catalyst => Katalysator; catalyst
magnet => Magnet
uzbekistan => usbekistan; republik usbekistan
partially => partiell
mascara => Mascara; Maskara
palladium => Palladium
scenario => Szenario; Szenarium
women => Damen
intelligence => Intelligenz; intelligentes Leben
ocular => Okular; okular
irrational => irrational; Irrationalität
decorations => Dekorationen
snowflake => Schneeflocke
quotient => Quotient; Quotient [math.]
militant => militant; militärisch
catharsis => Katharsis
veterinarian => Veterinär; Veterinärin
judaism => judaismus
disproportionate => überproportional
problematic => problematisch; Problematik; problematic; problembehaftet
browsing => Browsen
slavs => slawen
moderate => moderat; moderieren
milkman => Milchmann
nerve => Nerv
conglomerate => Konglomerat; konglomerat; Agglomerat
gallstones => Gallensteine; Gallensteinleiden
escapade => Eskapade
neutrino => Neutrino; neutrino
camellia => Kamelie; Camellia japonica; kamelien
tranquilizer => Tranquilizer; Tranquiliser
cobras => Kobra; Kobras
aladdin => aladdin; aladin
framework => Fachwerk; Rahmenwerk
legion => Legion
tractors => Traktoren
deposits => Depositen; Depots
jumbo => Jumbo; Jumbo-Jet
cocoons => Kokon
santorini => santorin
meaner => gemeiner
uranus => Uranus; uranos
aquitaine => aquitanien
rusty => rostig
implications => Implikationen; Denotation
photograph => Fotografie; Fotographie; Photographie; photographieren
continual => kontinuierlich
speedometer => Tachometer
midterm => Mitte
matthew => matthäus; matthias
stimulants => Stimulans; Stimulantia; Stimulanzien
leda => leda
groups => gruppen
pajamas => Pyjama; Pyjamas
perspective => Perspektive; perspektivisch
saboteurs => Saboteure; Saboteurinnen
service => Service
predisposed => prädisponiert; prädisponierte; prädisponierten
articulated => artikulierte; artikulierten; artikuliert
ricotta => Ricotta
macaroni => Makkaroni; Makaroni; makkaroni
england => England; england
boomerang => Bumerang; Bumärang; boomerang
analyzed => analysiert; analysierte
cultivated => kultiviert; kultivierte
banger => Knaller; Kracher
migrated => migriert
nastiness => Garstigkeit
milwaukee => milwaukee
winnipeg => winnipeg
tobacco => tabak
petition => Petition
lz => lz
motorbike => Motorrad
files => Files; Feilen
reputable => reputabel; reputierlich
souvenir => Souvenir; lokales Souvenir
leathery => ledern
boyfriend => Boyfriend
strangler => Würger
slick => Slick; geleckt