nationalist => Nationalist; nationalistisch; Nationalistin; nationalbewusst; Nationalist; nationalistisch; Nationalistin; nationalbewusst
alon => allein
bilingual => bilingual; Bilingue; bilingual; Bilingue
asphalt => Asphalt; asphaltieren; asphaltiert; Asphalt; asphaltiert
arcade => Arkade; Passage; Arkade
papacy => Papat
reincarnated => reinkarnierte; reinkarniert; reinkarnierte; reinkarniert
abdominal => abdominal; abdominell; Abdominal-; abdominal; abdominell; Abdominal-
hypoxia => Hypoxie; Anoxia; Hypoxie; Anoxia
opus => Opus; opus; Opus; opus
cedar => Zeder; zedern; zedern
morphine => Morphin; Morphium; morphin; Morphin; Morphium; morphin
dispersed => dispers; dispergiert; dispers; dispergiert
photos => Fotos; Fotos
illuminati => illuminatenorden
visage => Visage; Visage
flank => Flanke; flankieren; Flanke
excellent => exzellent; exzellent
russia => russland; russland
tinder => Zunder; Zünder; Zunder; Zünder
washboard => Washboard; Washboard
wh => wh; wh
scooping => schöpfend
temple => Tempel; Tempel -s; Tempel
indigenous => indigen; indigen
kg => kg; kg
barbarian => Barbar; barbarisch; Barbarin; barbarisch; Barbarin
title => betiteln
acrobat => Akrobat; Akrobatin; Akrobatik; Akrobat; Akrobatin; Akrobatik
susan => susanne; susanne
consent => Konsens; Konsens
campo => campo; campo
woodsman => Forstmann; Forstmann
slugger => Slugger; Slugger
clowning => Clownerie; Clown
clothesline => Wäscheleine; Wäschestange
sing => singen; besingen; Singen; singen
majority => Majorität; Majorität
panthers => Panther; Panter; Panther; Panter
banshee => Banshee; Banshee
comanche => komantsche; komantschin; komantsche; komantschin
lexington => lexington; lexington
hawaiian => hawaiisch; Hawaiisch; hawaiianer; hawaiianisch; hawaiisch; hawaiianer; hawaiianisch
topless => topless; topless
loyalist => Loyalist; Royalist; Loyalist; Royalist
fog => Smog; Smog
genoa => Genua; Genua
guacamole => Guacamole; Guacamole
accessory => Accessoire; akzessorisch; Accessoire; akzessorisch
beeping => piepend
cirque => zirkus; zirkus
luckiest => glücklichste
contraband => Konterbande; Kontrebande; Konterbande; Kontrebande
cracking => Cracken; knackend; krachend; Kracken; Cracken; knackend; krachend; Kracken
multimillionaire => Multimillionär; Multimillionärin; Millionär; Multimillionär; Multimillionärin
phlegm => Schleim; Phlegma; Schleim; Phlegma
streamline => Stromlinie; Stromlinie
damascus => damaskus; damaskus
ornamental => ornamental; ornamental
hydroelectric => hydroelektrisch; hydroelektrisch
crocs => crocs; crocs
havel => havel; havel
enrage => anregen; anregen
margin => Marge; Marge
bumblebee => bumblebee; bumblebee
extravagance => Extravaganz; Extravaganz
execute => exekutieren; exekutieren
kremlin => Kreml
dora => dora; dora
babylonian => babylonisch; babylonisch
sati => Sati; sati; Sati; sati
genial => genial; genial
procedural => prozessual; prozessual
pylon => Pylon; Pylone; Pylon; Pylone
nonprofit => non-profit; profit; non-profit; profit
snoopy => Snoopy; Snoopy
nipples => Nippel; Noppen
tutoring => Tutoring; Tutoring
interned => internierte; interniert; internierte; interniert
grecian => griechisch
mn => mn; mn
eloquently => eloquent; eloquente; eloquent; eloquente
mines => Minen
iceberg => Eisberg
dah => Dah; Dah
nutritious => nutritiv; nutritiv
pontiff => Pontifex; Pontifex
aviator => Aviatiker
delegated => delegierte; delegiert
tallinn => tallinn; tallinn
rh => rh; rh
panicky => panisch
implicate => implizieren; Implikatur; Implikatur
deduction => Deduktion; deduktive Methode; Deduktion
stella => stella; stella
correspondents => Korrespondenten; Korrespondentinnen; Korrespondenten; Korrespondentinnen
facelift => Facelift; facelifting; Facelift; facelifting
gertrude => gertrud; gertrud
plume => Plume; Plume
lair => lagern; lagern
fundraising => Fundraising; Fundraising
program => Programm; programmieren; Computerprogramm; Programm
baloney => Lyoner
absorbing => absorbierender
grisly => grässlich; grausig; grauslich
bohemia => böhmen
arty => hart
bush => Busch; Gebüsch
migraine => Migräne; migräne; Hemikranie; Migräne; migräne
constructive => konstruktiv; konstruktiv
gratis => gratis; gratis
bravery => Bravour
sensor => Sensor; sensor; Sensor; sensor
piloted => gelotst
exempt => exempt; exempt
sumerian => sumerer; sumerisch; sumerer; sumerisch
alternator => Generator; Alternator; Alternator
mic => mic; mic
rajah => Raja; rajah; rajah
ninja => Ninja; ninja; Ninja; ninja
tiniest => winzigste; winzigsten
colliding => kollidierend; kollidierend
peels => pellt
regatta => Regatta; Ruderregatta; Regatta
yorkshire => yorkshire; yorkshire
leprechaun => Leprechaun; Leprechaun
future => Futur; Futur
vega => wega; wega
researcher => Gelehrter; Rechercheur
welcome => willkommen
spitter => Spucker
patriarch => Patriarch; Patriarch
glorify => glorifizieren
translation => Translation; translation; Translation; translation
media => Medium; Medien; Media; Media
childish => kindisch; kindisch
broadband => Breitband; Breitband-; Breitband; Breitband-
currently => zurzeit
made => machen; machte
unproven => unerprobt
reported => referiert
muse => Muse; Muse
pirates => Pirat; Piraten; Piraten...; Piraten
nominee => Nominierte
blocked => blockiert; blockiert
pancreatic => pankreatisch; Pankreas-; pankreatisch
yiddish => jiddisch; jiddisch
overlook => Überblick
signal => Signal; signalisieren; Signal
whisky => Whisky; Whiskey; Whisky -s; Whisky; Whiskey
apologetic => apologetisch; apologetisch
pager => Pager; Pager
veneer => Furnier; Veneer; Veneer
courageously => couragiert
tactic => Taktik; Taktik
liniment => Liniment; Liniment
decor => Dekor; Dekor
widest => weiteste; am weitesten; weiteste
insinuate => insinuieren; insinuieren
planning => Planung; Planen; planend; Planung; Planen; planend
organizer => Organisator; Organizer; Gründer; Organisierer; Organizer
poaching => Poaching; Poaching
never => nimmer
sweep => Sweep; Sweep
decompose => dekomponieren; dekomponieren
spritzer => Spritzer; Spritzer
ladyship => Ladyschaft
syrup => Sirup; Syrup; Sirup; Syrup
reader => Leser; Reader; Reader
sharpie => Scharpie; Scharpie
constitutional => konstitutionell; konstitutionell
glass => Glas; glas; Glas -es; glas
undersigned => unterzeichnet; unterschrieben
herald => Herold; Wappenherold; Herold
hamsters => Hamster; Goldhamster; Hamster
aruba => aruba; aruba
tropics => Tropen; tropenregion; tropische Zone; tropische zone
pendant => Pendant; Pendant
ariel => ariel; ariel
tinnitus => Tinnitus; Tinnitus
shire => Shire; Shire
fakir => Fakir; Fakir
soju => Soju; Soju
noble => nobel
ineffectual => ineffektiv; ineffektiv
domination => Dominanz
instability => Instabilität; Labilität; Instabilität; Labilität
distal => distal; distal
hobby => Hobby; Hobby
clippers => Klipper; Klipper
anatomically => anatomisch; anatomischen
loudspeaker => Lautsprecher
epic => episch; Epik; episch
angles => angeln; angelt
madeleine => Madeleine; Madeleine
data => daten
vicomte => vicomte; vicomte
digested => digeriert
clubs => Clubs; Klubs; Clubs; Klubs
sandbag => Sandsack
internal => intern; innerlich; inner; intern
infestation => Infestation; Invasion; Infestation
brokerage => Courtage
caterpillar => Caterpiller; Caterpillar; Caterpiller; Caterpillar
satire => Satire; Satire
coccyx => Coccyx; Coccyx
brunei => Brunei; Brunei
pedestal => Podest; Piedestal; Piedestal
rudder => Ruder; Ruder
festivals => Festtag
gnawing => nagend
tartarus => tartaros; tartaros
chuckling => glucksend; gluckend
sexist => Sexist; sexistisch; Sexistin; Sexist; Sexistin
priceless => preislos
outpatient => ambulanter Patient
sibyl => Sibylle
consul => Konsul; Consul; Konsul; Consul
hasta => hasta; hasta
limes => Limes; Limonen; Limes
slipstream => Slipstream; Slipstream
morally => moralisch; verfallen
position => Posten
given => gegeben
unreachable => unerreichbar
intelligentsia => Intelligenz; Intelligenzija; Intelligenzia; Intelligenzschicht; Intelligenz; Intelligenzija; Intelligenzia; Intelligenzschicht
oceans => Ozean; Ozeane; Ozean; Ozeane
dauphin => Dauphin; Dauphin
quartermaster => Quartiermeister; Quartiermeister
stinks => stinkt; stinkt
ecstatic => ekstatisch; ekstatisch
multinationals => multinationale Unternehmen
ruining => ruinierend
abacus => Abakus; Abacus; abakus; Abakus; Abacus; abakus
flippers => Flipper; Flipper
tosser => Wichser
satchel => Tasche
indifferent => indifferent; indifferent
unholy => unheilig
jurassic => jura
bethlehem => bethlehem; betlehem; bethlehem; betlehem
province => Provinz; provinz; Provinz; provinz
substantially => substanziell; substantiell; substanziell; substantiell
hardware => Hardware; Hardware
monstrous => monströs; monströs
chloroform => Chloroform; chloroformieren; Chloroform; chloroformieren
foster => fördern; fördern
evaporating => Evaporieren
overqualified => überqualifiziert; überqualifiziert
railing => Reling
marauder => Marodeur; räuber
ignorance => Ignoranz; Ignoranz
extracts => Extrakt; extrahiert; Extrakt
derivative => Derivat; derivativ; Derivativ; Derivativum; Derivativ-Geschäft; Derivat; derivativ; Derivativ; Derivativum
amber => Amber; amber; Amber; amber
speeches => Ansprachen; Sprachen
calculation => Kalkulation; Kalkulation
kilo => Kilo; Kilo
zinc => Zink; zink; zinken; Zink; zink; zinken
pricks => prickelt; prickelt
healer => Heiler; Heilerin; Heiler
nai => Nai; Nai
taka => Taka; Taka
stares => starrt; starrt
freak => Freak; Freak
milkshake => Milchshake; Milkshake; Milchshake; Milkshake
argentinean => argentinier; argentinierin; argentinisch; argentinier; argentinierin; argentinisch
comma => Komma; komma; Komma -s; Komma; komma
reading => Lesung
glitter => glitzern; glänzen; Glitter; glitzernd; glitzern; Glitter; glitzernd
utmost => äußerst; äußerst; äußerste
gimp => Gimpe
qualifying => Qualifikation; Qualifying; qualifizierend; Qualifying
recruitment => Rekrutierung
swede => schwede; schwedin; schwede
antibiotics => Antibiotikum; Antibiotika; Antibiotikum; Antibiotika
constantine => constantine; konstantin; constantine; konstantin
seventh => siebte; siebente; Siebentel; siebenter; siebentes; sieb(en)te; siebente
artichoke => Artischocke; Artischocke
collectors => Kollektoren; Kollektoren
radiance => Strahldichte
roughest => rauhste; am rauhesten
sultan => Sultan; Sweet Sultan; Sultan
feedback => Feedback; Feed-back; Feedback; Feed-back
correspond => korrespondieren; korrespondieren
stone => steinigen; steinern
conceited => eitel
median => Median; Medianwert; median; Median; median
grip => greifen
rounding => Rundung; Runden; Abrundung; runden; rundend; Rundung; runden; rundend
seventeenth => siebzehnte; siebzehnt
stumble => taumeln
proportion => Proportion; Proportion
stupendous => stupend; stupend
canter => Kanter; Canter; Kanter; Canter
adolescents => Adoleszenten; Adoleszenten
inoculation => Inokulation; inokulation; Inokulation; inokulation
melancholic => melancholisch; Melancholiker; Melancholikerin; melancholisch; Melancholiker; Melancholikerin
passkey => Pass; pass
hostesses => Hostessen; Hostessen
watchtower => Watchtower; Watchtower
hurricanes => Hurrikans; Hurrikan; Hurrikane; Hurrikans; Hurrikan; Hurrikane
humanity => Humanität; Humanität
bosnia => bosnien; bosnien
muttering => murmelnd
ventilate => ventilieren; Ventilator; entlüften; ventilieren; Ventilator
zigzag => zickzack; Zickzack; zickzack
communique => Kommunikee; Kommunique; Kommunique -s; Kommuniqué; Kommunikee; Kommunique; Kommunique -s; Kommuniqué
medal => Medaille
juries => Jurys
trivia => Trivia; Trivia
castration => Kastration; Kastrierung; kastration; castration; Kastration; kastration; castration
hails => hagelt
chile => Chili; chile; chile
shin => Schin; Schiene
oslo => oslo; oslo
prolific => produktiv; erfolgreich
humour => Humor; Humor
transcontinental => transkontinental; überkontinental; transkontinental; überkontinental
barracks => Baracke; Baracke
mumps => Mumps; Mumps
royally => total; total
rumba => Rumba; Rumba
andromeda => andromeda; andromeda
confiscated => konfisziert; konfiszierte; konfisziert; konfiszierte
gleaming => gleißend
clash => Clash; Clash
systems => Systeme; System...; Systeme
compatibility => Kompatibilität; Kompatibilität
hangs => erhängt; hängt
interaction => Interaktion; Unterhaltung; Interaktion
palaver => Palaver; Theater; Palaver
solomon => solomon; salomo; salomon; solomon; salomo; salomon
actual => aktuell; aktuell
perfect => perfekt; Perfekt; perfekt; Perfekt
jaguar => Jaguar; Jaguar
judea => judäa; judäa
unannounced => unangemeldet
premiere => Premiere; Prämie; Premiere; Prämie
purification => Raffination
convert => konvertieren; Konvertit; ändern; Konvertit
academia => Akademie; akademia; Akademie; akademia
aristotle => aristoteles; aristoteles
gape => gaffen; gaffe
horizontally => horizontal; horizontal
bailout => Bail-out; Bailout; Bail-out; Bailout
evaluated => evaluiert; valutiert; evaluiert
flute => Flöte; Querflöte; Flute; Flute
rest => Rest; rasten; Rast; Rest
embryos => Embryen; Embryos; Embryoen; Embryen; Embryos; Embryoen
interning => internierend; internierend
reside => residieren
passages => Passagen; Passagen
hemorrhagic => hämorrhagisch; hämorrhagisch
compromises => Kompromisse; Kompromisse
stations => Stationen; Stationen
lukewarm => lauwarm; angewärmt; handwarm; lauwarm
aspen => Espe; Aspe; Espenholz; Pappel
registration => Registrierung
chassis => Chassis; Chassis
decorative => dekorativ; dekorativ
quickie => Quickie; Quickie
disrespectful => respektlos
monarchy => Monarchie; Monarchie
alumnus => Alumnus; Alumnus
cruel => brutal
mascot => Maskotte; Maskotte
proportional => proportional; proportional
unwitting => unwissentlich; unwissend
directory => Directory; Directory
bridge => Bridge; Bridge
squall => Schwall
hosted => gehostet; gehostet
pupil => Pupille
tee => Tee; tee; Tee; tee
totem => Totem; Totem
horrific => horrend
resignation => Resignation; Resignation
recycling => Recycling; Rezyklierung; Recyceln; Recycling; Rezyklierung
hasten => hasten; hasten
mandolin => Mandoline; Mandoline
apropos => apropos; a propos; à propos; apropos; a propos; à propos
cannibals => Kannibalen; Kannibale; Kannibalen; Kannibale
duct => Ductus
virtual => virtuell; Virtualität; virtuell
gargantuan => gargantuesk; gargantuesk
impromptu => Impromptu; improvisiert; Impromptu
asia => asien; asia; asia
gesundheit => Gesundheit; Gesundheit
diss => dissen; Diss; Dissen; dissen; Diss
tricky => verzwickt; trickreich
handcrafted => handgearbeitet
spares => Aufgespartes
civilized => zivilisiert; zivilisierte; zivilisiert
privatization => Privatisierung; Privatisation; Privatisation
exact => exakt; exakt
odin => odin; wodan; odin
upwards => aufwärts; aufwärts
suffragette => Suffragette; Suffragetten; suffragetten; Suffragette; Suffragetten; suffragetten
regrouping => Umgruppierung
battalion => Bataillon
newborn => neugeboren; Neugeborene; Neugeborenes; Neugeborener
discriminating => diskriminierend; diskriminierend
fascism => Faschismus; faschismus; faschismus
entry => Eintrag
prostitution => Prostitution; Prostituition; Prostitution; Prostituition
fields => Feld; felder
bodega => Bodega; Bodega
labels => Labels; Labels
unsaid => ungesagt
overhead => Overhead; Overhead
atrophy => Atrophie; Athrophie; Atrophie; Athrophie
shampoos => Schampons; Shampoos; Schampons; Shampoos
identifying => Identifizierung; identifizierend; Identifikation
klingon => Klingone; klingonin; klingonisch; Klingone; klingonin; klingonisch
purr => Surren; knurren
referencing => referenzierend; referenzierend
figures => Figuren; Figuren
manifestation => Manifestation; Manifestation
laxative => Laxativum; Laxativ; Laxativum; Laxativ
zhou => zhou; zhou
millimetre => Millimeter; Millimeter
microwave => Mikrowelle; Mikrowellen; mikrowellen; mikrowellen
inhibitors => Inhibitoren; Inhibitoren
petals => Petal; Petal
coupling => Kopplung; Kupplung; Einkopplung; Koppelung; Verkupplung; Kopplung
fluorescent => fluoreszierend; fluoreszent; fluoreszierend; fluoreszent
reaper => reaper; reaper
girder => Binder; Binder
tangent => Tangente; Tangens; Tangenten-; Tangential-; Tangente; Tangens
unsettled => unbeständig
conserving => konservierend; konservierend
bod => Bod; Body; Cod; Bod; Cod
aerobic => aerob; Ärobic; Aerobic; aerob; Ärobic; Aerobic
ottoman => Ottomane; Ottoman; Ottomane; Ottoman
besides => überdies
beware => bewachen; bewachen
morale => Moral; Moral
subjective => subjektiv; subjektiv
deacon => Diakon; Diakon
sms => sms; sms
ascendant => aszendent; Aszendent; aszendent; Aszendent
proxy => Proxy; Proxy
compulsive => kompulsiv; kompulsiv
reclaimed => reklamiert; reklamierte
bigamy => Bigamie
mannequins => Mannequins; Mannequins
argon => Argon; Argon
basque => baske; baskin; baske
castrate => kastrieren; Kastrat; Kastrat
incoherently => inkohärent; inkohärent
spirals => Spiralen; Spiralen
from => vom
inflame => entflammen; entflamme; entflamme
fiddler => Fiedler; Fiedler
portals => Portale; Portalseiten; Portale
hollander => Holländer; Holländer
denim => Denim; Denim
wanda => wanda; wanda
knobby => knorrig
chupacabra => chupacabra; chupacabra
striving => Anstrengung; strebend
hecate => hekate; hekate
espresso => Espresso; espresso; Espresso; espresso
got => Got; Got
phosphorous => phosphorig; Phosphor; Phosphor-; phosphor; phosphorig; Phosphor; Phosphor-; phosphor
ultraviolet => ultraviolett; Ultraviolett; Ultraviolettstrahlung; ultraviolett Strahlen; ultraviolette Licht; ultraviolett; Ultraviolett
hereditary => hereditär; Heredität; hereditär
help => helfen; helfen
alligator => Alligator; Echte Alligatoren; Alligatoridae; echte alligatoren; Alligator; Alligatoridae
shaver => Bader
charades => Scharade; Scharaden; Scharade; Scharaden
capacity => Kapazität; Kapazität
potentially => potentiell; potenziell; eventuell; potentiell; potenziell
sovereigns => souveräne
dresden => dresden; dresdner; dresden; dresdner
guitar => Gitarre; guitarre; guitarre
succulent => Sukkulente; sukkulent; Sukkulente; sukkulent
funds => Fonds; gefunden
aquarius => aquarius; aquarius
oldest => älteste; Ältester; ältest; ältester; Älteste; älteste; Ältester; ältest; ältester; Älteste
militia => Miliz
bobs => Bobs; Bobs
korean => koreanisch; Koreaner; Koreanerin; Koreaner
sought => gesucht; suchte; suchte
gaia => gaia; gaia
subscribe => subskribieren; subskribieren
deport => deportieren; Deport; Deport
frequents => frequentiert; frequentiert
solar => solar; solar
coexistence => Koexistenz; Koexistenz
patagonia => patagonien; patagonien
foremost => vorderst; vorderste; vorderst
provider => Provider; Provider
dating => Datierung; datierend
shield => Schild
astrology => Astrologie; Astrologie
vinyl => Vinyl; vinylgruppe; Vinyl
triangle => Triangel; Triangel
virgil => vergil; vergil
livelier => lebendiger
vase => Vase; Vase
splicing => Splicing; spleißend; Splicing
unwittingly => unwissentlich; unwissend
reek => riechen
shadowing => Shadowing; Shadowing
heroic => heroisch; heldisch; heroisch
dugout => Dugout; Dugout
senseless => sinnlos
metabolism => Metabolismus; Metabolie; Metabolismus; Metabolie
liverpool => liverpool; liverpool
into => in; ins
roasted => röstete; geröstet; röstete
esoteric => esoterisch; esoterisch
immediate => immediat; immediat
dealing => Behandlung
cobra => Kobra; Kobra
intending => intendierend; intendierend
lumpy => klumpig
masked => maskiert; maskierte; maskiert
sanitary => sanitär; sanitär
replicant => replikant; replikant
hindsight => Nachsicht; Nachsicht
entertainment => Unterhaltung; Entertainment; Entertainment
delegation => Delegation; Delegierung; Delegation
picturesque => pittoresk; picturesque; picturesque
restaurant => Restaurant; Restauration; Restaurant
simulations => Simulationen; Simulationen
rio => rio; rio
galaxy => Galaxie; Galaxis; Galaxie; Galaxis
desert => desertieren
propellers => Propeller; Propeller
decompression => Dekompression; Dekomprimieren; Dekompression
habitual => habituell; habituell
rare => rar; karg; rar
consumers => Konsumenten; Abnehmer; Konsumenten
religions => Religionen; Religionen
tipping => kippend; kippend
egomaniac => Egomane; Egomanin; Egomanin
dip => Dip; Dip
vacancy => Vakanz
regal => Regal; regal; Regal; regal
cults => Kulte
mallorca => mallorca; mallorca
banking => Bankeinlage
spitz => Spitz; Spitze; Spitz; Spitze
gothenburg => göteborg; göteborg
mutilations => Mutilationen; Mutilationen
inclusive => inklusive; inklusiv; inklusive (inkl.); inklusive; inklusiv
spinners => Spinner; Spinnerinnen; Spinner
stony => steinig
barricades => Barrikaden; verbarrikadiert; Barrikaden
reflections => Reflexionen
flitting => flatternd; flitzend; flitzend
romania => rumaenien; rumänien
ache => Schmerz
officially => offiziell; offizielle; offiziell; offizielle
hacking => Hacking; hacken; hackend; Hacking; hacken; hackend
kilt => Kilt; Kilt
mandate => Mandat; Mandat
impertinence => Impertinenz; Impertinenz
testimony => Testimonium; Testimonium
pecans => Pekannuss
ceremonial => zeremoniell; Zeremonie; Zeremoniell; feierlich, zeremoniell; zeremoniell; Zeremonie; Zeremoniell
polished => poliert
memorised => memoriert; memoriert
smacked => schmeckte
farm => Farm; Farm
torments => triezt
additions => Additionen; Additionen
weekday => Werktag
partner => Partner; Partnerin; Geschäftspartner; Filmpartner; Partner; Partnerin; Filmpartner
corruption => Korruption; Korrumpierung; Korruption
shtick => Stück; Trick
afar => Afar; Afar
remarked => bemerkt; bemerkte; bemerkt; bemerkte
transfusion => Transfusion; Bluttransfusion; Infusion; Transfusion; Bluttransfusion; Infusion
stench => stinkig
interfered => eingegriffen; interferiert; interferiert
differentiate => differenzieren; differenzieren
clarinet => Klarinette; Bassettklarinette; Klarinette
drunkards => Trunkenbolde
conspiracy => Konspiration
resilience => Resilienz; Resilienz
drastic => drastisch; drastisch
killer => Killer; Killer
negatively => negativ; negative; negativ; negative
originals => Originale; Originale
beneath => beneath; beneath
high => hoch; high; high
listed => aufgelistet
barbed => beißend
hereabouts => hierorts
genetic => genetisch; gentechnisch; genbedingt; genetisch
exists => existiert
viscous => viskos; viskose; viskös; viskos; viskose; viskös
normally => normalerweise; normal; im Normalfall; normal
blinded => blendete; blind gemacht; erblindet; geblendet; verblendet; blendete; erblindet
masseur => Masseur; Masseurin; Masseuse; Massage; Masseur; Masseurin; Masseuse
annexation => Annexion; Annektierung; Annexion
nonstop => nonstop; Nonstop; Nonstop...; nonstop; Nonstop
standard => Standard; Standarte; Standard; Standarte
national => national; national
kath => Kath; Qat; Kath
dervish => Derwisch; Derwischin; Derwisch
twigs => Zweige; Zweige
se => Se
mannequin => Mannequin; Mannequin
farmland => Ackerland
agriculture => Agrikultur; Agrikultur
indistinct => unbestimmt
walrus => Walross; Walroß; Walross; Walroß
masher => Grapscher
negotiating => negoziierend
lucid => luzid; leuchtend; luzid
hereford => Hereford-Rind; hereford; hereford
robot => Roboter; Robot; Robot
slight => leicht; leicht
controllable => kontrollierbar; kontrollierbar
springer => Springer; Springer
gallery => Galerie
snipped => geschnippelt; schnippelte; geschnipselt
blond => blond; Blond; Blondine; Blonder; blondhaarig; Blonde; Blondin; blond; Blond; Blonde
cola => Cola; kola; Cola; kola
denounce => denunzieren
falafel => Falafel; Falafel
gentile => Heide; Gentile; Gentile
catalogued => katalogisierte; katalogisiert; katalogisiert
pms => pms; pms
volumes => Volumina; Volumen; Volumen
schoolteacher => Schullehrer
grime => Grime; Grime
caprice => Kaprize; Kaprice; Kaprize; Kaprice
lowering => Entwertung; Erniedrigung
doppelganger => Doppelgänger; Doppelgängerin; Doppelgänger; Doppelgängerin
policewoman => Polizeibeamtin
vermont => vermont; vermont
interpreter => Interpret; Interpreter; Übersetzer; interpreter; Interpretator; Interpret; Interpreter; interpreter; Interpretator
entranced => entzückt
glamorous => glamourös; glanzvoll; glamourös
ishtar => ischtar; ischtar
americas => amerika; amerika
unrest => Angst
benny => benny; benny
camel => Kamel; Camelus; Kamel
zhao => zhao; zhao
unspoiled => unverbildet
factor => Faktor; Faktor
olympian => olympisch; olympiateilnehmerin; olympier; olympisch; olympier
onboard => Bord
quiche => Quiche; Quiche
league => Leuge
waxing => Waxing; Waxing
nd => nd; nd
asparagus => Spargel; Asparagus; spargeln; Asparagus
toxicity => Toxizität; Cytotoxizität; Neurotoxizität; Toxizität; Cytotoxizität; Neurotoxizität
pragmatic => pragmatisch; praktisch; pragmatisch
ludo => ludo; ludo
fuehrer => Führer; Führer
migrants => Migranten; Migrantinnen; Migranten
inverted => invertiert; seitenverkehrt; invers; invertiert; invers
berkshire => berkshire; berkshire
unnaturally => unnatürlich; unnatürliche
christendom => christenheit; christentum; christenheit; christentum
dumb => dumm; dumm
pinochle => Binokel; Binokel
polio => Polio; Polio
phenomenal => phänomenal; phänomenal
pollen => Pollen; Polle; Pollenkorn; Pollen; Polle
begged => bekniet; bekniet
lint => Lint; Lint
midlife => Midlife-Crisis
homerun => Bogen; Homerun; ein Homerun; Homerun
natal => natal; natal
trillion => Billion; Trillion; Billion; Trillion
minimal => minimal; minimale; minim; minimal (min.); minimal; minimale; minim
ordering => Ordnung; ordernd; ordernd
footsie => Footsie; Footsie
libation => Libation; Libation
stricken => ergriffen; betroffen
snare => Snare; Snare
gourmet => Gourmet; Gourmet
observe => observieren; observieren
sympathies => Sympathien; Sympathien
following => folgend
orgies => Orgien; Orgien
terraces => Terrassen; Terrasse
analogue => analog; Analogon; Analog-; Analog...; analog; Analogon; Analog-
repatriation => Repatriierung; Deportation; Deportation
ballplayer => Ballspieler; Ballspielerin; Baseball-Spieler; Ballspieler
duality => Dualität; dualität; Dualität; dualität
headlight => vorderlicht
episodes => Episoden; Episoden
warmest => wärmste; wärmsten; wärmste; wärmsten
virginia => Virginia; Virginia
aurelia => Aurelia aurita
frank => frankieren; frank; frank
crimea => krim; krim
forefather => Vorfahre; Vorfahr; Urvater
baguette => Baguette; Baguette
estate => Besitztum
lied => Kunstlied; Lied; Lied
carpenter => Schreiner; Mary Carpenter
mv => Mv
sanctified => sanktioniert; sanktionierte; sanktioniert; sanktionierte
palpable => palpabel; palpabel
robust => robust; robust
revolutionized => revolutioniert; revolutioniert
relevance => Relevanz; Belang; Relevanz
graduated => graduiert; graduiert
taxicab => Taxi; Taxi -s
final => Finale; Finale
whiskey => Whisky; Whiskey; Whisky -s; Whisky; Whiskey
jesus => jesus; jesus
guru => Guru; guru; Guru; guru
dispenser => Spender; Austeiler
rotated => rotierte; rotierten; rotiert
civil => zivil; zivil
lancer => Lanzierer; Lancier; Lancier
clicking => Klicken; klickend; Klicken; klickend
magnets => Magnete; magnete; Magnete; magnete
magnetism => Magnetismus; magnetische Kraft; netismus; Magnetismus
skateboarding => Skateboardfahren; Skateboarden; Skateboard fahren; Skateboardfahren; Skateboarden
pepper => Pfeffer; pfeffern
midwest => mittelwesten
reboot => Reboot; Neubooten; neu booten; rebooten; Reboot; rebooten
cafe => Café; Cafe; Kaffee; Café; Cafe
journalists => Journalisten; Journalisten
methodically => methodisch; methodische
passage => Passage; Passus; Passage
fairway => Fairway; Fairway
classmates => Klassenkamerad
curator => Kurator; Kustos; Direktor; Konservator; Kuratorin; Verwalter; Kurator; Kuratorin
accompany => akkompagnieren
landau => Landauer; landaulet; Landauer; landaulet
dm => dm; dm
fluent => fließend
anchors => ankert
jezebel => Isebel
verses => Verse; versen; Verse; versen
gamer => Gamer; Gamer
amended => abgeändert
illogical => unlogisch
culmination => Kulmination; Anhäufung Kulmination; Kulmination
fingernails => Fingernägel
stronger => stärker
nightmare => Nachtmahr
redder => röter; roter
luminol => Luminol; Luminol
arteries => Arterien; Arterie; Arterien; Arterie
projector => Projektor; Videoprojektor; Projektor; Videoprojektor
bacteria => Bakterien; Bakterie; Bakterium; Bacteria; Bakterien; Bakterie; Bakterium; Bacteria
grounding => Erdung; Grundlage; grundierend; Begründung; Grundierung
contours => Kontur; Konturen; Kontur
fleet => fleet; fleet
choir => Chor; chor; chor
dampening => dämpfend
suggestion => Suggestion; Assoziation; Suggestion
allies => Alliierte
brilliance => Brillanz; Brillanz
manipulator => Manipulator; Manipulant; Manipulantin; Manipulatorin; manipulierer; Manipulator; Manipulant; Manipulantin; Manipulatorin; manipulierer
elephants => Elefant; Elefanten; Elefant
ballistics => Ballistik; Ballistik
veering => Wendung; Gieren
disloyal => illoyal; illoyal
schoolhouse => Schulhaus
functioning => funktionsfähig; funktionierend; fungierend; funktionieren; funktionsweise; funktionsfähig; funktionierend; funktionieren; funktionsweise
testes => Testikel; Testes; Testis; Testes; Testis
cal => cal; cal
pashto => paschtu; paschtu
articles => Artikel; Artikel
scenarios => Szenarien; Szenarios; Szenarien; Szenarios
sweeter => süßer
serial => seriell; Serie; seriell
fabricating => fabrizierend
steaks => Steak; Steak
om => om; om
sprinkle => spritzen; sprengen
douglas => douglas; douglas
eve => eve; eve
nam => vietnam
stamped => abgestempelt; gestempelte; aufgestampft; gestampft; gestempelt; getrampelt
supermarket => Supermarkt; supermarkt; Supermarkt; supermarkt
installations => Installationen; Installation; Installationen; Installation
shelly => muschelig
dodgeball => Völkerball; Dodgeball; Völkerball; Dodgeball
infiltrated => infiltriert; infiltrierte; infiltriert; infiltrierte
irritating => irritierend
uni => Uni; Uni
comfort => Komfort; Komfort
leo => leo; leo
inadequate => inadäquat; inadäquat
babies => Babys
flan => Fladen; Flan; Flan
clauses => Klauseln; Klauseln
lutheran => lutheraner; lutheraner
new => neu; neu
caskets => Kassetten
emissions => Emissionen; Emissionen
intrusive => intrusiv; intrusiv
caesar => caesar; cäsar; caesar; cäsar
suggests => suggeriert
contaminate => kontaminieren; kontaminieren
shortfall => Ausfall; Ausfall
info => Info; Info
hurray => hurra; Hurra!; hurrah; hurra; Hurra!; hurrah
facilitator => Facilitator; Facilitator
refining => Raffinierung; verfeinernd; Verfeinerung; Reinigung
erected => errichtet; aufgerichtet; errichtete; errichtet
insurgent => Insurgent; Insurgent
leotard => Leotard; Leotard
modified => modifizierte; modifiziert; modifiziert
allah => allah; allah
que => que; que
west => Westen; westlich; West; westwärts; West
patch => Patch; Patch
disputes => Dispute; Dispute
ess => es; es
olympiad => Olympiade; olympiade; Olympiade; olympiade
coveralls => Overall; overall; Overall; overall
startup => Starten; Start
sir => Sir; Sir; Sie
finland => finnland; finnland
sarasota => Sarasota; Sarasota
aura => Aura; Aura
goalie => Goalie; Goali; Goalie; Goali
murderer => Mörder; Mörderin; Mörder; Mörderin
fishnet => Fischernetz; Fischnetz; Fischnetz
hairpin => Haarpfeil
coding => Codierung; Kodierung; codierend
sedation => sedierung
prosthetics => Prothetik; Prothetik
ciao => Ciao; ciao; Ciao; ciao
falstaff => falstaff; falstaff
jupiter => jupiter; jupiter
embryo => Embryo; Embryo
confrontational => konfrontativ; Konfrontations...; konfrontativ; Konfrontations...
reconfigure => rekonfigurieren; neu konfigurieren; rekonfigurieren
accepting => akzeptierend; akzeptieren; akzeptierend; akzeptieren
liechtenstein => liechtenstein; liechtensteiner; liechtenstein; liechtensteiner
degenerate => degenerieren; degeneriert; Degenerat; degenerieren; degeneriert; Degenerat
aegis => Ägis; Aigis; Aigis
gonads => Gonaden
angola => angola; angola
equalizer => Equalizer; Equalizer
grams => Gramm
ruffian => Grobian
minos => minos; minos
formality => Formalität; Formalie; Formalität; Formalie
decapitation => Dekapitation; Dekapitation
argues => argumentiert
mason => mauern; mason; mason
tarn => Tarn; Tarn-; tarn; Tarn; tarn
gazpacho => Gazpacho; Gazpacho
dl => dl; dl
chaperone => Chaperon; Chaperon
alternatives => Alternativen; Alternativen
fullback => Fullback; Fullback
epsom => epsom; epsom
lima => lima; lima
alliances => Allianzen; Allianzen
fitter => Monteur
crunching => krachend
haiti => haiti; haiti
electricians => Elektriker; Elektrikerinnen; Elektriker
reflexes => Reflexe; Reflexe
sharpen => schärfen; schleifen; spitzen; scharf machen; verschärfen; scharfzeichnen; schärfen
electrodes => Elektrode; Elektroden; Elektrode; Elektroden
stables => Ställe; Stall
gateway => Gateway; Gateway
rat => Ratz
mademoiselle => Mademoiselle; Mademoiselle
weightlessness => Gewichtslosigkeit
explicitly => explizit; explizite; explizit; explizite
angel => Engel; Engel -s; Engelchen; angel; Engel; angel
hyacinth => Hyazinthe; Hyazinthen; Hyacinth; Hyazinth; hyakinthos; Hyazinthe; Hyazinthen; Hyacinth; Hyazinth; hyakinthos
kiwi => Kiwi; kiwis; Kiwi; kiwis
strasser => Strasser; Strasser
biochemistry => Biochemie; biochemie; Biochemie; biochemie
grade => Grad
wanders => wandert; wandert
cranium => Cranium; Kranium; Cranium; Kranium
charlemagne => Charlemagne; Charlemagne
tu => tu; tu
acute => akut; akut
excluding => exklusive; exklusive
midshipman => Midshipman; Midshipman
enthusiasts => Enthusiasten; Enthusiastinnen; Enthusiasten
sounder => Rudel
including => inklusive; inklusive
chicago => chicago; chicagoer; chicago; chicagoer
herself => derselbe; derselbe
puncher => Locher
campus => Campus; Campus
mucus => Mucus; Mucus
lyon => lyon; lyon
stacking => Stapelung; stapelnd
real => real; reell; Real; real; Real
french => französisch
neuroses => Neurosen; Neurose; Neurosen; Neurose
winery => Winzerei
alarms => Alarme; Alarme
styrofoam => Styropor
ix => Ix
fibrosis => Fibrose; fibrose; Fibrose; fibrose
xindi => Xindi; Xindi
timeout => Timeout; Timeout
urinating => urinierend
olives => Olive; Oliven; Olive; Oliven
seize => greifen
scary => schaurig
institutional => institutionell; Institutions...; institutionell; Institutions...
graf => Graf; Graf
chopper => Chopper; Chopper
maki => maki; maki
esther => esther; esther
confiscation => Konfiskation; Konfiszierung; Konfiskation
berries => Beeren; Beere; beere; beere
merging => Vereinigung
inscription => Inschrift
legislative => legislativ; Legislative; legislative; legislativ; Legislative; legislative
stately => stattlich
genuinely => genuin; genuin
panini => Panini; Panino; Panini; Panino
de => De; de; de
process => Prozess; Prozeß; Prozess
hyperventilate => hyperventilieren; hyperventilieren
harmonium => Harmonium; Druckwindharmonium; Harmonium
hat => hut; Hut; hut
period => Periode; Periode
buttermilk => Buttermilch; buttermilch; Buttermilch; buttermilch
sorting => Sortierung; Sortieren; Verteilung; Anordnung; sortierend
sputnik => Sputnik; Sputnik
discrimination => Diskriminierung
paralyzed => paralysiert; paralysiert
solitude => Isolierung
slogan => Slogan; Slogan
odometer => Hodometer; Wegmesser; Odometer; Oedometer; Tachometer; Hodometer; Odometer; Oedometer
implement => implementieren; implementieren
seoul => seoul; seoul
polka => Polka; Polka
barrack => Baracke
chopped => geschnippelt
mutant => Mutant; Mutante; mutierend; mutiert; Mutantin; Mutant; Mutante; mutiert; Mutantin
reigns => regiert
evangelical => evangelisch; evangelikal; evangelischen; evangelikaler; evangelisch; evangelikal; evangelischen; evangelikaler
sings => singt; singt
waistband => Obiband; Obiband
aborigines => Aborigines; Aborigines
autonomy => Autonomie; Autonomie
specialists => Spezialisten; Spezialistinnen; Spezialisten
sociopath => Soziopath; Soziopathin; Soziopath; Soziopathin
tao => dao; dao
disassembled => disassembliert; disassembliert
aurora => Aurora; aurora; Aurora; aurora
creating => Anfertigung
citadel => Zitadelle; Zitadelle
bordeaux => Bordeauxrot; bordeaux; Bordeauxrot; bordeaux
ocean => Ozean; Ozean
odor => Odor; Odor
shuffled => schlurfte
fairyland => Feenland; Traumland
skinheads => Skinheads; Skins; Skinheads
anthem => Anthem; anthem; Anthem; anthem
kilometer => Kilometer; Kilometer
flocking => Beflockung; Beflockung
niger => niger; niger
conferences => Konferenzen; Konferenzen
wichita => wichita; wichita
marshland => Sumpfland; marschland; marsch; marschland
cassiopeia => cassiopeia; cassiopeia
algebra => Algebra; Algebra
colonized => kolonisierte; kolonisiert; kolonisiert
resulted => resultiertem
quarters => Quartier; Quartale; Quartier
cliques => Cliquen; Clique; Cliquen; Clique
mailer => Mailer; Norman Mailer; Mailer
references => Referenzen; Referenzen
cylinder => Zylinder; Kreiszylinder; zylinder; Zylinder; Kreiszylinder; zylinder
stimulating => stimulierend
marks => markiert
firecracker => Kracher; Cracker
haitian => haitianer; haitianerin; haitianisch; haitisch; haitianer; haitianerin; haitianisch; haitisch
babylon => Babylon; Babylon
fatal => fatal; fatal
eccentricities => Exzentrizitäten; Exzentrizitäten
mash => Maische
abc => abc; abc
hurriedly => hurtig
dnc => Dnc; Dnoc; Dnc; Dnoc
hither => hierher; hierhin; her; hierher
uterus => Uterus; Uterus
teleprompter => Teleprompter; Teleprompter
castellan => Kastellan; Kastellan
desire => Begierde
vale => Tal
trademark => Handelsmarke
classified => klassifiziert; klassifiziert
tony => tony; tony
copyright => Copyright; Copyright
wilder => toller; wilder; wilder
action => Aktion; Aktion
dreadnought => Dreadnought; Dreadnought
japanese => japanisch; japaner; japanerin; japanisch; japaner; japanerin
hermaphrodite => Hermaphrodit; hermaphroditisch; Hermaphroditismus; Hermaphroditin; Hermaphrodit; hermaphroditisch; Hermaphroditismus; Hermaphroditin
visceral => viszeral; viszeral
stuntman => Stuntman; Stuntman
kano => kano; kano
sprint => Sprint; spurten; sprinten; Sprint; sprinten
psychologists => Psychologen; Psychologinnen; Psychologen; Psychologinnen
placebo => Placebo; Plazebo; Placebo; Plazebo
cox => cox; cox
kurds => kurden; kurden
calcium => Calcium; Kalzium; Calcium; Kalzium
segovia => segovia; segovia
slacker => Slacker; Slacker
mentioning => Mention
lute => Laute
abalone => Abalone; Abalone
warfare => Waffe
forestry => forstbetrieb
parliament => Parlament; Parlament
excessive => exzessiv; exzessiv
interferon => Interferon; interferone; Interferon; interferone
parasite => Parasit; Parasitentum; Parasitismus; Parasit
bulimic => bulimisch; Bulimiker; bulimisch
skipping => Seilspringen
stripper => Stripper; Stripperin; striptizerka; Abstreifer; Stripper; Stripperin
sistine => sixtinisch
rough => rauh; roh
inspire => inspirieren; anspornen; inspirieren
mainstream => Mainstream; Mainstream
ribbing => Rippung
toupee => Toupet; Toupet
stapler => Tacker
ty => ty; ty
kabuki => Kabuki; Kabuki
machismo => Machismo; Maschismo; Macho; macho; Machismo; Maschismo; macho
exploratory => explorativ; exploratorisch; explorativ; exploratorisch
enzyme => Enzym; enzyme; Enzym; enzyme
bach => Datsche
guillotine => Guillotine; guillotinieren; Guillotine; guillotinieren
pornography => Pornografie; Pornographie; pornografisches Buch; Pornografie; Pornographie
electra => elektra; elektra
scorching => stechend
capital => Kapital; Kapitell; Kapitale; Kapital; Kapitell; Kapitale
marine => Marine; Kriegsmarine; Marinesoldat; Matrose; Marine
hitchhiker => hitchhiker; hitchhiker
drums => Drumlins
crater => Krater; Vulkankrater; Trichter; Mondkrater; Sprengkrater; Vulkakrater; Krater
burbank => burbank; burbank
rile => reizen
thermite => Thermit; thermite; Thermit; thermite
pesticide => Pestizid; Pestizid
remark => Bemerkung; bemerken; bemerken
latin => latein; lateinisch; latino; latein; latino
yesterday => gestern; Gestern; gestriger Tag; gestrig
mali => mali; mali
alien => Alien; Alien
shine => scheinen; schimmern; scheinen
obesity => Obesitas; Obesitas
crustaceans => Crustacea; Krustazeen; Crustacea; Krustazeen
transplants => transplantiert; transplantiert
vulgar => vulgär; vulgär
cannabis => Cannabis; Cannabis
leggings => Leggings; Leggins; Leggings; Leggins
hotel => Hotel; Hotel
chartered => charterte; gechartert; charterte
aldrin => Aldrin; Aldrin
narcotic => Narkotikum; narkotisch; narkotisierend; narkotisch
pinocchio => pinocchio; pinocchio
magellan => magellan; magellan
brno => brünn
benin => benin; benin
voodoo => Voodoo; Voudou; Voodoo; Voudou
jane => jane; janina; johanna; jane
toreador => Torero; Toreador; Toreador
fastest => am rasantesten
emphatic => emphatisch; emphatisch
venetian => venezianisch; venezianer; venezianer
sulfate => Sulfat; sulfate; Sulfat; sulfate
sakura => Sakura; Sakura
flies => Fliegen; fliegt; Fliege; fliegt
skeptical => skeptisch; skeptische; skeptisch; skeptische
latrine => Latrine; Latrine
sheer => schier; schier
psychologically => psychologisch; psychologische; psychologisch; psychologische
false => falsch; falsch
importing => Import; importierend; importierend
nimrod => Nimrod; nimrod; Nimrod; nimrod
montgomery => montgomery; montgomery
hezbollah => hisbollah; hisbollah
adolf => adolf; adolf
rumbled => rumort; rumpelte
commanded => kommandierte; kommandiert; kommandierte; kommandiert
barrows => Karren
spewing => speiend; speiend
tasmanian => tasmanisch; tasmanisch
copenhagen => kopenhagen; kopenhagener; kopenhagen; kopenhagener
bravo => bravo; Bravo; bravo; Bravo
gorgon => Gorgo; Gorgone; gorgonen; Gorgo; Gorgone; gorgonen
lifespan => Lebensspanne
vocalist => Vokalist; Vokalistin; Vokalist; Vokalistin
gaseous => Gasform; gasig
conservatory => Konservatorium; Musikkonservatorium; Konservatorium
breaking => Brechung
clinics => Kliniken
reformers => Reformer; Reformerinnen; Reformer
cornflakes => Cornflakes; Cornflakes
photons => Photonen; Photonen
deodorant => Deodorant; Desodorant; desodorierend; deodorierend; Deodorant; Desodorant
water => Wasser; wässern
dad => dad; dad
programmed => programmiert; programmierte; programmierten; programmiert; programmierte; programmierten
zooms => zoomt; zoomt
liquor => Liquor; Liquor
diner => Diner; Diner
arras => arras; arras
rustic => rustikal; rustikal
plexus => Plexus; Plexus
ro => ro; ro
comedians => Komödianten; Komikerinnen; Komödiantinnen
sonora => sonora; sonora
tuba => Tuba; Tube; Tuba
intent => Intention
siblings => Drilling
chipotle => Chipotle; Chipotle
seraphim => Seraph; Seraphim; Seraphe; serafim; Seraph; Seraphim; Seraphe; serafim
textbook => Textbuch; Lehrbuch; Textbuch
coincide => koinzidieren; koinzidieren
morrow => morgen
intercede => intervenieren; eintreten
uncooperative => unkooperativ; unkooperativ
manifesting => Manifestation; Manifestation
mol => Mol; Mol
rapier => Rapier; Rapier
soften => besänftigen
handpicked => handverlesen
garden => Garten; gärtnern; Vorgarten; Hausgarten; Garten
mangrove => Mangrove; Mangrovenbaum; Mangrove
restart => Neustart; neustarten; neu starten; neuer Start; Neustart
production => Produktion; Produktionshöhe; Produktion
losers => Loser; Loser
enriching => anreichernd; bereichernd; anreichernd
pops => Pop
grabbing => grabschend
wight => Wicht; Wichtel; Wicht
aches => Schmerz
innermost => innerst; innerste; innerster; innerstes; innerst; innerste
weakest => flaueste
vulcans => vulkanier; vulkanier
manicured => manikürte; manikürt; manikürte; manikürt
terraforming => Terraforming; Terraforming
sty => sty; sty
licked => leckte
battalions => Bataillone
babysitter => Babysitter; Babysitterin; Babysitter; Babysitterin
ghetto => Getto; Ghetto; Getto; Ghetto
casing => Schalung
rigid => rigide; rigide
intestines => Eingeweiden
milligrams => Milligramm; Milligramm
byzantium => byzantion; byzanz; byzantion
heater => Heizer
makes => machen; Marken
selene => selene; selene
walnut => Walnuss; Walnuß; Walnuß
bandaged => bandagiert; bandagierte; bandagiert; bandagierte
extrapolate => extrapolieren; extrapolieren
mercantile => merkantil; merkantil
deductive => deduktiv; deduktiv
viking => Wikinger; Wikinger
abundance => Abundanz; Abundanz
superstars => Superstars; Superstars
reviewer => Revidierender
signalling => Signalisierung; Signalgebung; Signalisieren; signalisierend
sermon => Sermon; Sermon
po => po; po
pucks => Pucks; Pucks
climax => Klimax; Klimax
draining => Drainage
brig => Brigg
mildly => mild; mild
quorum => Quorum; Quorum
tk => tk; tk
weightless => gewichtslos
noblest => am nobelsten
synergy => Synergie; Synergismus; synergie; Synergie; synergie
fertilization => Pollination; fecundation
geometry => Geometrie; Geometrie
statistical => statistisch; statistisch
grumble => brummen; Gegrummel; Grummeln; grummeln; grummeln
kind => mild
paradoxical => paradox; paradoxal; Paradox; Paradoxon; paradox; paradoxal
pamper => pampern; pampern
buzzer => Summer; Buzzer; Buzzer
lineage => Lineage; Lineage
products => Produkt; Produkte; Produkt; Produkte
altitude => Altitude; Altitude
vulnerabilities => Vulnerabilitäten; Vulnerabilitäten
holograms => Hologramme; Hologramme
trinity => Trinität; trinity; Trinität; trinity
crass => krass; krass
rainfall => Regenfall; Regenfall
brochures => Broschüren
downtown => Downtown; Downtown
eloquent => eloquent; eloquent
minus => Minus; minus; Minus; minus
cambridge => cambridge; cambridge
topography => Topografie; Topographie; Topografie; Topographie
snuffed => schnupfte; geschnüffelt; schnüffelte
subliminal => subtil; subliminal; Subliminalität; subliminal; Subliminalität
unexpectedly => unerwartet
telephone => Telefon; telefonieren; telephonieren; Telephon; Telefon; telephonieren; Telephon
jacket => Jacke; Jackett; Windjacke; Jacke; Jackett
titles => Titel
flagged => beflaggt
triton => Triton; Triton
pudding => Pudding; Pudding
atmosphere => Atmosphäre; Erdatmosphäre; Atmosphäre; Erdatmosphäre
corrections => Korrekturen; Korrekturen
crunchy => krosch
massachusetts => massachusetts; massachusetts
quadruple => Quadrupel; Quadrupel
ennui => Ennui; Ennui
confirmation => Konfirmation; Konfirmation
acceleration => Akzeleration; Akzeleration
myths => Mythen
racking => streckend
archbishop => Erzbischof; Erzbischof
khaki => Khaki; khakifarben; Kaki; kaki; khaki; Khaki; kaki; khaki
bonbon => Bonbon; Bonbon ''m; Bonbon
taurus => taurus; taurus
cues => Queues; Queues
silesia => schlesien
reflected => reflektiert; reflektierte; reflektiert; reflektierte
dislocation => Luxation; Dislokation; Dislokation
classically => klassisch; klassisches
brewery => Brennerei
lens => linse; lenteja
cremate => kremieren
codex => Kodex; codex; Kodex; codex
heller => Heller; heller; Heller; heller
cos => cos; cos
pia => Pia; Pia
supercomputer => Supercomputer; Superrechner; supercomputer; Supercomputer; supercomputer
tends => tendiert
parole => Parole; Parole
horizons => Horizonte; Horizonte
earthy => erdartig
stalkers => Stalker; Stalker
trowel => Traufel
hubris => Hybris; Hybris
sunni => sunnit; sunniten; sunnitin; sunnitisch; sunnit; sunniten; sunnitin
opposition => Opposition; Opposition
tumors => Tumoren
rheumatism => Rheumatismus; Rheuma; Gelenkrheumatismus; Rheumatismus
restoring => restaurierend
fingertip => Fingerspitze; Fingerkuppe; Fingerkuppe
jam => jammen
paddles => paddelt; Paddel
navigational => navigatorisch; Navigations-; Navigations...; Navigations-; Navigations...
benign => benigne; benigne
maxwell => Maxwell; maxwell; Maxwell; maxwell
maltese => Malteser; malteser; maltesisch; Malteser; malteser
gender => Gender; Gender
deserter => Deserteur; Deserteur
radiation => Radiation; Emission; Radiation
bounties => Subventionen
strict => streng; strikt; straff; stringent; strikt
function => Funktion; funktionieren; fungieren; Funktionalität; Funktion; funktionieren
modifications => Modifikationen; Modifikationen
theoretically => theoretisch; theoretisches; theoretisch; theoretisches
homophobic => homophob; homophob
horus => horus; horus
silverware => Silberware; silberwaren; Silberware; silberwaren
swan => Schwan; schwan; schwan
egypt => Ägypten; aegypten; aegypten
administrative => administrativ; administrativ
roti => Roti; Roti
novice => Novize; Novize
stepsister => Stiefschwester
far => fern; fern
blinking => Blinken; aufblinkend; blinkend; Blinken; blinkend
commanders => Kommandanten; Kommandeure; Kommandeure
poi => poi; poi
mastectomy => Mastektomie; mastektomie; Mastektomie; mastektomie
tested => getestet; getestet
salve => Salbe; Wundsalbe; Salbe
doses => Dosen; dosiert
ocd => ocd; ocd
oedipus => Ödipus; Ödipus
deliver => abliefern
verbally => verbal; verbal
caustic => sarkastisch; kaustisch; Kaustikum; Kaustik; kaustisch; Kaustik
hairball => Haarball; Haarball
hastened => hastete; hastete
cloned => klonte; klonte
devastate => devastieren; devastieren
phrases => Phrasen; Phrasen
salaam => salem; Salam; salem; Salam
decoded => decodierte; decodiert; dekodiert; dekodierte; decodiert; dekodiert
earl => Earl; Earl
carnivore => Karnivore; carnivore; Karnivore; carnivore
shot => Schrot
forward => vorwärts; vorlaut; vorder; vorwärts
fore => vorn; vorder; vor; vordere; vorne; vorn; vorder; vor; vorne
philly => philadelphia
mensch => Mensch; Mensch
simplicity => Simplizität; Simplizität
ph => Ph
serbian => serbisch; Serbisch; serbe; serbisch; serbe
profit => profitieren; Profit; Profit
specifications => Spezifikationen; Spezifikation; Spezifikationen; Spezifikation
commodore => Kommodore; Commodore; kommodore; Kommodore; Commodore; kommodore
stalag => stalag; stalag
overlapping => Verdoppelung; Überlappung; überlappend; überlappende; Überlappung; überlappend
lending => leihend
anima => Anima; Anima
surcharge => Zuschlag
between => begleitet
palomino => Palomino; Palomino
philosophically => philosophisch; philosophische; philosophisch; philosophische
brisbane => brisbane; brisbane
porter => Portier; Pförtner; porter; Porter; Portier; porter; Porter
mutters => murmelt
dilation => Dilatation; Dilatation
blackout => Blackout; Blackout
nymph => Nymphe; Nymphe
distilled => destillierte; destilliert; destilliert
galactic => galaktisch; galaktisch
situation => Situation; Situation
stiffy => Steifer
mathematicians => Mathematiker; Mathematikerinnen; Mathematiker
watching => Besichtigung
capsule => Kapsel; Tasche
mark => Marke
capacities => Kapazitäten; Kapazitäten
sentences => Sentenzen; Sentenzen
trumpeting => Trompeten; trompetend; trompetend
literate => literal; literal
informs => informiert; informiert
pumped => gepumpt; pumpte; pumpte
neuter => Neutrum; neutral
mole => Mole; Mol; Mole
baku => baku; baku
leipzig => leipzig; leipzig
starlet => Starlet; Starlet
caramelized => karamelisiert; karamellisiert; karamelisiert; karamellisiert
zygomatic => zygomatisch; zygomaticus; zygomatisch; zygomaticus
medic => medizinisch
elevation => Elevation; Elevation
negro => negrid; Negerin; negrid
planners => Planer; Planer
stretching => Stretching; Streckung; Stretching
inform => informieren
urdu => urdu; urdu
dialect => Dialekt; dialekt; Dialekt; dialekt
name => Name; Name
cement => Zement; zementieren; zement; zemen; Zement; zement; zemen
funnier => lustiger
prosper => prosperieren
convergence => Konvergenz; Konvergenz
formaldehyde => Formaldehyd; formaldehyd; Formalin; Formaldehyd; formaldehyd
cassini => cassini; cassini
favela => Favela; Favela
scrawny => schlank
landline => Landkabel
hullo => Hallo; Hallo!
predictive => prädiktiv; prädiktiv
nail => nageln; nagel; knallen
lanky => lang; lange
checked => gescheckt
steely => steinern
oregano => Oregano; Origano; Oregano; Origano
billion => Billion; Milliarde; Billionen; Milliarden; Billion; Billionen
communiqué => Kommuniqué; Kommunique; Kommunikee; communiqué; Kommuniqué; Kommunique; communiqué
ibuprofen => Ibuprofen; Ibuprofen
epidemics => Epidemien; Epidemie; Epidemien; Epidemie
korea => korea; korea
urethra => Urethra; Uretra; Ureter; Urethra; Uretra
résumé => Resumé; Resumé
scheme => Schema; Schema
goldmine => Goldgrube; Goldmine; Goldmine
mod => Mod; mod; modern; Mod; mod
dalton => dalton; dalton
uneven => uneben; uneben
mile => Meile
clapper => Klöppel; Klapper; Klappe; Klüppel; Klapper; Klappe
productive => produktiv; produzierend; produktiv
moccasins => Mokassins; Mokassins
evocative => evokativ; evokativ
societal => sozial; sozial
stephen => stefan; stephan; stephan
nominated => nominierte; nominierten; nominiert; nominierten
criminally => kriminell; kriminell
singularly => singularisch; singularisch
showgirl => Revuegirl; Showgirl; Revuegirl; Showgirl
hotdog => Hotdog; Hotdog
congestive => kongestiv; kongestiv
vocalists => Vokalisten; Vokalistinnen; Vokalisten
beta => Beta; beta; Beta; beta
aspirations => Aspirationen; Aspirationen
goldfinger => goldfinger; goldfinger
gong => Gong; Gong
chandigarh => chandigarh; chandigarh
colored => Coloured; Coloured
young => jung
respiratory => respiratorisch; respiratorisch
lawnmower => Rasenmäher; Rasenmäher
stimulate => stimulieren; stimulieren
seismic => seismisch; Seismik; seismisch; Seismik
licker => Lecker; Leckerin; Lecker
tigress => Tiger
commander => Kommandant; Kommandeur; Kommandeur
hetty => hetero
insight => Einsicht; Aussicht; Einsicht; Aussicht
carbohydrates => Kohlehydrate; Kohlenhydrate
resuscitated => reanimierte
whistler => Whistler; Whistler
pasadena => Pasadena; Pasadena
malawi => malawi; malawi
glazed => glasierte; glasig; glasiert
debating => debattierend
demolish => demolieren
orchid => Orchidee; Orchide; Orchid; Orchis; Orchidee; Orchide; Orchid; Orchis
indiscretions => Indiskretionen; Indiskretionen
kneels => kniet; kniet
pensions => Pension; Pension
boutique => Boutique; Boutique
incarcerated => inhaftiert
on => an; in
softest => am sanftesten
imposed => imponierte
administrators => Administratoren; Administratorinnen; Administratoren; Administratorinnen
silvery => silbrig; silbern; silberhell; silberig; silberfarben; silberfarbig; silberweiß; silbern; silberig
yachts => Jachten; Yachten
gimmick => Trick; Gimmick; Gimmick
reflect => reflektieren
consistently => konsequent
transcription => Transkription; Transkription
phallus => Phallus; Phallus
allocated => alloziert; allozierte
debut => Debüt; Debüt
obstructions => Obstruktionen; Obstruktionen
boxing => Boxen; Boxing; boxend; Boxing; boxend
blare => plärren
alley => Allee; Allee
pacemaker => Pacemaker; Pacemaker
faust => fauststoff
test => Test; testen; Test; testen
novelist => Novellist; Novelist; Novellist; Novelist
genovese => genueser; genueser
vectors => Vektoren; Vektor; Vektoren; Vektor
crucifixes => Kruzifixe; Kruzifixe
fervour => Bravour
sniffling => schnüffelnd
reeve => Greve
fad => Fad; Fad
slovakia => slowakei; slowakei
genitalia => Genitalien; Genitalia; Genitalsystem; Genitalien; Genitalia
parable => Parabel
masquerading => Maskerade
satanist => satanistin; satanistin
shatters => zerschmettert
dynamics => Dynamik; Dynamik
catalonia => katalonien; katalonien
initiative => Initiative; Eigeninitiative; Initiative; Eigeninitiative
stenographer => Stenograph; Stenograf; Stenografin; Stenographin; Stenograph; Stenographin
communicates => kommuniziert
narcotics => Narkotikum
undermine => unterminieren; untergraben; unterhöhlen; unterminieren
cameroon => kamerun; kamerun
insisting => insistierend; insistierend
electronic => elektronisch; Elektron; elektrisch; Elektro...; Elektronen; Elektronik; elektronisch; Elektron; Elektronen; Elektronik
cardiologist => Kardiologe; Kardiologin; Kardiologe; Kardiologin
rip => rippen
undisciplined => undiszipliniert; undiszipliniert
dereliction => Dereliktion; Dereliktion
dames => Damen
dito => dito; dito
dialogues => Dialoge; Dialoge
toasts => Toasts; toastet; Toasts; toastet
bonito => Bonito; Bonito
phoenix => Phönix; phönix; phoenix; Phönix; phönix; phoenix
tandem => Tandem; Tandembauart; Tandem
methane => Methan; methan; Methan; methan
zoos => Zoo; Zoos; Zoos
harmony => Harmonie; Harmonik; Harmonie; Harmonik
billing => Billing; Billing
fences => fechtet
drying => Curing
charleston => Charleston; charleston; Charleston; charleston
grins => grinst; grinst an; grient; grinst; grient
thinker => Denker; denker
exactly => exakt; exakt
numerals => Numerale; Numerale
stereotypes => stereotypiert; Stereotypen; stereotypiert; Stereotypen
nestor => nestor; Nestor; nestor; Nestor
front => Front; Wetterfront; Frontmann; Front
abruptly => abrupt; abrupt
rather => eher; eher
table => Tabelle
cleaner => cleaner; cleaner
procedure => Prozedur; Prozedere; Prozedur; Prozedere
visiting => besichtigend
baroness => Baroness; Baronin; Baronesse; Baroness; Baronesse
badass => krass
appropriation => Appropriation; Appropriation
colonize => kolonisieren
pirate => Pirat; Piraten...; Pirat
inwards => einwärts; einwärts
rocked => gerockt
sighted => gesichtet; sehend; sichtete; gesichtet; sichtete
jacuzzi => Jacuzzi; Jacuzzi
manchu => mandschu; mandschu
marked => markiert; markant; markierte; markiert
buttercup => Butterblume
tanna => tanna; tanna
peninsula => Peninsula; Peninsula
stinger => Seitengewehr
insists => insistiert
northwest => Nordwesten; Nordwest; nordwestlich; Nordwest-; Nordwest
bruno => bruno; bruno
photographers => Fotografen; Photographen; Photographinnen; Photographen; Photographinnen
do => do; do
udon => Udon; Udon
monthly => monatlich
crier => Schreier; Schreier
christopher => christoph; christoph
dozens => dutzende; Dutzend; Dutzende; dutzende; Dutzend
mechanical => mechanisch; mechanischer; technisch; mechanisch; mechanischer
answered => beantwortet; geantwortet; beantwortete; beantwortet; geantwortet
stepmother => Stiefmutter; Stiefmutter
hijacker => Hijacker; Skyjacker; Hijacker; Skyjacker
paranormal => paranormal; Paranormal; paranormal; Paranormal
plastic => Plastik; plastisch; Plastikgeld; künstlich; Plast; Plaste; Plastik; plastisch
ii => ii; ii
bandit => Bandit; Banditin; Bandit; Banditin
zone => Zone; Zone
clicked => klickte; klickte
punjabi => pandschabi
portable => portabel; Portable; transportabel; portierbar; portabel; Portable
substantiate => substantiieren; substantiieren
turkish => türkisch; türken; türkisch
oxfordshire => oxfordshire; oxfordshire
marlin => Marlin; Marlin
specimen => Spezimen; Spezimen
coded => codiert; codierte; kodiert
insertion => Inserat
establish => etablieren
untested => ungetestet; ungetestet
stave => Stange
bending => Beugung; Windung; beugend
netherworld => Unterwelt
circulated => zirkulierte; zirkulierte
snob => Snob; Snob
e => e; e
sudoku => Sudoku; Sudoku
woodman => Forstmann
line => Bahnlinie
lynx => Lynx lynx
plymouth => plymouth; plymouth
in => in; an; im; rein; in
antennae => Antennen; Antennen
eroticism => Erotik; Erotizismus; Erotizismus
haven => Hafen; Hafen
eccentric => exzentrisch; Exzentriker; eigenartig; exzentrisch; Exzentriker; Exzentrikerin
dribbling => Dribbeln; Dribbling; dribbeln; Dribbling; dribbeln
milliseconds => Millisekunden; Millisekunden
acoustic => akustisch; Akustik; akustisch; Akustik
lotte => Lotte; Lotte
trusted => treu
billboard => Billboard; Billboard
yalta => jalta; jalta
coordinated => koordinierte; koordiniert; koordinierte; koordiniert
elegantly => elegant; elegant
rampaging => randalierend
bikini => Bikini; Bikini
silicone => Silikon; Silicon; Silikone; silikone; Silikon; Silicon; Silikone; silikone
bulldogs => Bulldoggen; Bulldoggen
openers => Öffner; Öffner
mahabharata => mahabharata; mahabharata
bollywood => bollywood; bollywood
hairless => haarlos; haarlos
union => Union; Union
butane => Butan; n-Butan; n-butan; Butan
freeze => frieren; gefrieren; erfrieren; zufrieren
busier => emsiger; emsigere
souffle => Soufflé; Souffle; Soufflé; Souffle
odessa => odessa; odessa
trendy => trendy; trendig; trendy; trendig
protected => protektiert; protektiert
premium => Prämie
adelaide => adelaide; adelaide
putter => Putter; Putter
alms => Almosen
significant => signifikant; signifikant
torpedoed => torpedierte; torpedierten; torpediert; torpedierte; torpediert
prejudicial => präjudiziell; präjudiziell
explodes => explodiert; explodiert
visionary => Visionär; visionär; Visionärin; Visionär; visionär
manipulate => manipulieren; Manipulation; manipulieren; Manipulation
relativity => Relativität; relativität; Relativität; relativität
clod => Kloß; Kloß
glitch => Glitch; Glitch
hackers => Hacker; Hacker
aram => aram; aram
tomahawk => Tomahawk; tomahawk; Tomahawk; tomahawk
joker => Joker; Joker
june => Juni; Juni
stamper => Stampfen; Stampfer; Ramme; Stempel; stempel; Stampfen; Stampfer; stempel
sequences => Sequenzen; Sequenzen
suspension => Suspension; Suspendierung; Suspension
escalates => eskaliert
roller => Rolle; Roller; Rollertaube; Tümmler; Rolle; Roller
punctuality => pünktlich
nim => Nim; Nim
backwards => rückwärts; rückwärts
duped => düpiert
oklahoma => oklahoma; oklahoma
stillness => Stille
inmate => Insasse
aboriginal => Aborigine; Aborigine
calibrate => kalibrieren; kalibrieren
nor => noch
biryani => Biryani; Biryani
mary => maria; marie; mary; mary
hypotheses => Hypothesen; Hypothesen
chutzpah => Chuzpe; Chuzpe
softie => softie; softie
wakes => wachten
applications => Applikationen; Applikationen
woodwork => Holzwerk; Holzwerk
gargling => gurgelnd
elegant => elegant; Eleganz; elegant; Eleganz
extensions => Extensionen; Extensionen
protocols => Protokolle; Protokolle
partnership => Partnerschaft; Partnerschaft
underdogs => Underdogs; Underdogs
tomorrow => tomorrow; tomorrow
deciphering => Dechiffrierung; Entzifferung; dechiffrierend
presidency => Präsidentschaft
bomb => Bombe; bomben; Sexbombe; Bombe; bomben; Sexbombe
guerrillas => Guerilla; Guerillas; Guerilla; Guerillas
dictation => Diktat
prognosis => Prognose; Prognose
specter => Monster
koala => Koala; Koalabär; Koala -s; Koala-Bär; Koala
poseidon => poseidon; poseidon
anchovy => Anchovis; Anschovis; Anschove; Anchovis; Anschove
recluse => Inkluse; Inkluse
catwalk => Catwalk; Catwalk
quoting => quotierend
equally => ebenfalls
thermostat => Thermostat; Thermostat
sectors => Sektoren; Sektoren
antagonism => Antagonismus; Antagonismus
heinrich => heinrich; heinrich
authorised => autorisiert; autorisierte; autorisiert
putties => kittet
embolism => Embolie; Embolismus; embolie; Embolie; Embolismus; embolie
pontus => pontos; pontos
fact => Fakt; Fakt
matter => Materie
jumping => Bungee-Jumping
verifying => verifizierend
titanium => Titan; Titanium; Titanium
finders => Finder; Finderinnen; Finder
mammals => Mammalia; Mammalier; Mammalia
poles => Pole; polen; polen
proclaimed => proklamierte; proklamierten; proklamiert; proklamierten; proklamiert
pas => Pas; Pas
calculate => kalkulieren; kalkulieren
pneumothorax => Pneumothorax; Pneumonie; Pneumonitis; Pneumothoraxbehandlung; Pneumothorax
booted => gebootet; gebootet
prosthetic => prothetisch; prothetisch
hittites => hethiter; hethiter
gate => Gatter; Gate; Gate
dividing => Division; dividierend; dividierend
colostomy => Kolostomie; Kolostoma; Kolostomie; Kolostoma
radius => Radius; Aktionsradius; radius; Atomradius; Carpus; Radius; radius
beluga => Beluga; Belugastör; Beluga-Wal; Beluga
fruit => Frucht; Produkt
trotting => trottend; trottend
euros => Euro
trawler => Trawler; Fischtrawler; Trawler
strays => streunt; streunt; streuner
taskmaster => Zuchtmeister; Lehrmeister; Lehrmeister
magnetized => magnetisiert; Magnet...; magnetisierte; magnetisiert; magnetisierte
tempo => Tempo; Tempo
loose => lose; locker; lockern; loslassen; lose
titties => Titten
defamation => Diffamation; Diffamation
correlation => Korrelation; Korrelation
dibble => dibbeln; dibbeln
jambalaya => Jambalaya; Jambalaya
hansa => hansa; hanse; hansa; hanse
sink => sinken; senken; versinken; einsinken; sinken
quotes => quotiert; quotiert
strands => Strände; Stränge; strandet; strandet
yak => Yak; Jak; Yak; Jak
fibers => Fiber; faser; Fiber
statesmen => Staatsmänner
clattering => Klappern; klappernd; ratternde; Rattern; ratternd
cocktails => Cocktails; Cocktails
carina => Carina; Carina
weasels => Wiesel
yeshiva => Jeschiwa; Jeschiwa
spastic => Spastiker; spastisch; Spastikerin; spasmatisch; spastisch; spasmatisch
licence => Lizenz; lizenzieren; Lizenz
nonce => Nonce; Nonce
flighty => flüchtig; flippig; flüchtig
favorites => Favoriten; Favorites; Favoriten; Favorites
ordinary => ordinär; ordinär
industries => Industrien; Industrien
statute => Statut; Statut
workman => Handwerksmann
decomposition => Dekomposition; Dekomposition
conjunction => Konjunktion; Konjunktion
stature => Statur; Statur
airing => Spaziergang
example => Exempel; Exemplar; Exempel; Exemplar
misunderstand => missverstehen; missdeuten
criminal => kriminell; Krimineller; Kriminelle; kriminell
hooligans => Hooligans; Hooligans
texture => Textur; Textur
greenwich => greenwich; greenwich
lasagne => Lasagne; Lasagne
fish => Fisch; fischen; Fische
deposited => deponierte; deponiert
publications => Publikationen; Publikation; Publikationen; Publikation
wrecks => Wracks; Wracks
sprinklers => Sprinkleranlage
pesticides => Pestizide; Pestizide
separatist => Separatist; separatistisch; Separatistin; Separatist; separatistisch; Separatistin
longtime => lange
superheated => überheizte
calisthenics => Kallisthenie; Calisthenics; Kallisthenie; Calisthenics
heathen => Heiden
web => Gewebe; Web; Gewebe; Web
leased => geleast
hooking => hakend
cranial => kranial; kranial
athens => athen; athener; athen; athener
creations => Kreationen; Kreationen
pleiades => plejaden; plejaden
packet => Paket; Packung; Packen; Paket; Packen
fibula => Fibel; Fibula; Fibula
door => Tor
propaganda => Propaganda; propagandistisch; Propaganda
flounder => Flunder; Flunder
professional => professionell; Professioneller; Professionelle; Professional; professionell; Professioneller; Professionelle; Professional
necrosis => Nekrose; nekrose; Nekrose; nekrose
overdressed => overdressed; overdressed
croat => kroatisch; kroate; kroate
caribbean => karibik; karibisch
header => Header; Header
twig => Zweig
exposition => Exposition; Exposition
excessively => exzessiv; exzessiv
carbonara => Spaghetti Carbonara
marshes => Marsch; Marschen; Marschen
macon => macon; macon
pile => Pfeiler
qualified => qualifiziert; Qualifikation; qualifiziert
pathetic => pathetisch; pathetisch
benefiting => begünstigend
sparring => Sparring; Sparring
pestle => Pistill
proportions => Proportionen; Proportionen
robots => Roboter
pompous => pompös; pompös
climber => Streber
niagara => niagara; niagara
taffeta => Taft; Taffet; Taffet
criminality => Kriminalität; Kriminalität
masturbated => masturbierte; masturbiert; masturbierte; masturbiert
flotilla => Flottille; Flottille
pint => Pint; Pinte; Pint
sensational => sensationell; sensationell
wherein => worin
fortuna => fortuna; fortuna
whaling => Walfang; hauend; walfang
pheromones => Pheromon; Pheromone; Pheromon; Pheromone
rai => Rai; Rai
badlands => Ödland; Brachland; Ödland
galleria => Galerie; Galleria; Galerie; Galleria
primary => primär; primär
hamlet => Hamlet; Hamlet
redoing => Wiederholung
adjectives => Adjektive; Adjektive
professionally => professionell; profihaft; professionell
tyrannosaurus => Tyrannosaurus; Tyrannosaurus
maximum => Maximum; maximal; Maximum; maximal
publication => Publikation; Edition; Publikation
caracas => caracas; caracas
intensifies => intensiviert; intensiviert
mediums => Medien
mhm => hm; hm
pisa => pisa; pisa
gardener => Gärtner
freeing => Freisetzung; befreiend; Befreiung; freigebend
abstraction => Abstraktion; Abstrahieren; Abstraction; Abstraktum; Abstraktion; Abstraction; Abstraktum
paragraphs => Paragraphen; Paragrafen; Paragraphen
hurdles => Hürden
rates => Raten
bunt => Bunt; Bunt
commas => Kommas; Kommata; Kommas
frak => fracken
canadian => Kanadier; kanadierin; kanadisch; Kanadier; kanadierin; kanadisch
polishing => Polieren; polierend; polieren
propeller => Propeller; Propeller
interrupted => unterbrochen
wolfram => Wolfram; Wolframit; Wolfram; Wolframit
philharmonic => Philharmonie; Philharmoniker; philharmonisch; Philharmonie; Philharmoniker; philharmonisch
sentimentality => Sentimentalität; Sentimentalität
otto => otto; otto
quota => Quote; Quote
swatting => Swatting; Swatting
touring => Tourismus
components => Komponente; Komponenten; Komponente; Komponenten
burned => brennen
represent => repräsentieren; vertreten; spielen; repräsentieren
rebellion => Rebellion; Rebellion
salsa => Salsa; Salsa
japan => Japanlack; japan; japan
kosovo => kosovo; kosovo
newsstand => Zeitungsstand; Zeitungsstand
telekinetic => telekinetisch; telekinetisch
synthetics => synthetische Stoffe
authors => Autoren
decidedly => dezidiert
democracy => Demokratie; Demoktratie; demokratie; Demokrati; demokratie; Demokrati
eventuality => Eventualität; Eventualität
collie => Collie; collie; Collie; collie
rodeo => Rodeo; Rodeo
contemplation => Kontemplation; Meditation; Kontemplation
clink => klingen; “Pling”
church => kirchlich
photojournalist => Fotojournalist; Fotojournalist
standards => Standards; Standards
laos => laos; laos
pedal => Pedal; pedalieren; Pedale; Klavierpedal; Pedal; Pedale
hefty => deftig; heftig; deftig; heftig
harlequin => Harlekin; Harlekin
hostel => Hotel; Hotel
banjo => Banjo; Banjo
acidic => Acidität
tomatoes => Tomaten; Tomate; Tomaten; Tomate
treading => tretend
auctioneer => Auktionator; Auktionator
von => von; von
acapulco => acapulco; acapulco
ambivalence => Ambivalenz; Ambivalenz
ceramic => Keramik; keramisch; Keramik; keramisch
heighten => vermehren
venous => venös; venös
decimated => dezimierte; dezimiert
detachment => Detachement; Abmachen; Detachement
symbolically => symbolisch; symbolische
cluster => Cluster; Cluster
iguanas => Iguana; Leguane; Iguana
donor => Donator
fracking => Fracking; Fracking
lister => Auflister; Auflister
shame => Schande; beschämen; schämen; Blamage
subscriptions => Subskriptionen; Subskriptionen
string => String; Strippe; String
stabbed => stach nieder
oldies => Oldies; Oldies
daiquiri => Daiquiri; Daiquiri
appendicitis => Appendizitis; Appendicitis; Appendizitis; Appendicitis
troubadour => Troubadour; Trobador; Troubadourin; Troubairitz; Troubador; Troubadour; Trobador; Troubadourin; Troubador
aftershave => Aftershave; Aftershavelotion; Aftershave
intercostal => interkostal; interkostal
commentators => Kommentatoren; Kommentatoren
resided => angesiedelt; residiert; residierte; residiert
romany => roma; romani; roma; romani
consonants => Konsonanten; Konsonanten
vampirism => Vampirismus; Vampirismus
pellets => Pellet; Pellet
flamboyant => flamboyant; flamboyant
effects => Effekte; Effekt; Effekten; Effekte; Effekt; Effekten
tumbling => Tumbling; Tumbling
leto => leto; leto
bacardi => bacardi; bacardi
banister => Baluster; Baluster
hepatic => hepatisch; hepatisch
fete => feiern; Fete; Fete
marsh => Marsch; Marsch
pronouns => Pronomen; Pronomina; Pronomen
distinguished => distinguiert; distinguiert
nose => Nase; Nase
pricing => Preisbildung; Preisfindung; preisbildung; Auspreisung
marauders => Marodeure
sprinkled => gesprenkelt; besprinkelt
omelets => Omeletten
legionnaire => Legionär
maelstrom => Mahlstrom; Malstrom; moskenstraumen; Mahlstrom; Malstrom
campuses => Campus; Campus
dams => Damm
stung => stank
arboretum => Arboretum; Arboretum
humanities => Humanities; humanities; Humanities; humanities
crab => Krabbe
interfere => intervenieren; intervenieren
regulation => Regulierung; Regulativ; Regulativ
puffs => pafft; pafft
operatic => opernhaft
transfusions => Transfusionen; Transfusionen
centered => zentriert; zentrierte
cost => kosten; Kosten; kosten
brutally => brutal; brutal
total => total; total
fixes => fixiert
fibrillation => fibrillation; fibrillation
earnest => ernst; Ernst; ernst
commute => kommutativ
globe => Globus; Erdglobus
older => älter; Älterer; ältere; oller; Ältere; älter; ältere; oller; Ältere
spiky => spitz; spitzig
unwell => unwohl; unwohl
tuscan => toskaner; toskaner
stoplight => Stopplicht; Stopplicht
airline => Fluglinie; Airline; Luftlinie; airline; Airline; airline
emmy => emmy; emmy
kinetic => kinetisch; Kinetik; kinetisch; Kinetik
bouillabaisse => Bouillabaisse; Bouillabaisse
fragmentation => Fragmentierung; fragmentierung; fragmentierung
ventricle => Ventrikel; Herzventrikel; Ventrikel
mantua => Manteau; mantua; mantua
instigator => Anstifter; Anstifterin
coexist => koexistieren
cider => Zider; Zider
rendezvous => Rendezvous; geheimes Rendezvous; Rendezvous
rationale => Rationale; Ratio; rational; rationale Erklärung; Rationale; rational
dysfunctional => dysfunktional; dysfunktionelle; dysfunktionell; dysfunktional; dysfunktionelle; dysfunktionell
viral => viral; viral
spontaneously => spontan
dopey => deppert
limbo => Limbo; Limbus; Limbo
eruptions => Eruptionen; Eruptionen
fraternize => fraternisieren; fraternisieren
shrines => Schreine
calendars => Kalender; Kalendarien; Kalender; Kalendarien
juno => juno; juno
irritation => Irritation; Inflammation; Irritation
wilds => Wildnis
hash => Hasch; Haschee; Hash; Hash
gypsy => Gypsy; Gypsy
levi => levi; levi
jackpot => Jackpot; Jackpot
bestiality => Bestialität; Bestialität; Brutalität
pundit => Pandit; Pandit
insect => Insekt; Insekten; Insekt; Insekten
dominant => dominant; Dominante; dominierend; dominant; Dominante
zambia => sambia; sambia
recent => neueste; rezent; rezent
crystallized => kristallisiert; kristallisiert
stockings => Socken
timers => Timer; Timer
peeking => kiekend
raja => Raja; Raja
torso => Torso; Torso
proverb => Proverbium; Proverb; Proverb
boring => Bohrung; Abarbeitung
rosa => Rosa; Rose; rose; Rosa; rose
drink => trinken; Getränk; Drink; Trunk; Trank; Drink
bigfoot => bigfoot; bigfoot
brittany => bretagne
puree => Püree; pürieren; Puree; Puree
spotlight => Spotlight; Rampenlicht; Spotlight
modelling => Modellieren; Modellierung; Modellbau; Modellbildung; Modeln; Modellieren; Modellierung; Modellbildung
underpaid => unterbezahlt
bankrupt => bankrott; Bankrotteur; bankrott
inferno => Inferno; Inferno
combines => kombiniert; kombiniert
morgan => morgan; morgan
singsong => Singsang; Singsang
compensate => kompensieren; kompensieren
marking => Markierung; Marke; markierend
syria => syrien; syrien
duplicates => Duplikate; dupliziert; Duplikate
hair => Haar; Haar
veto => Veto; Veto
kaleidoscope => Kaleidoskop; kaleidoskop; Kaleidoskop; kaleidoskop
insider => Insider; Eingeweihter; feines Gehör; Insider
skyscraper => Skyscraper; Skyscraper
cortex => Cortex; Kortex; Cortex; Kortex
continuing => Kontinuität; Kontinuität
disorientation => Desorientiertheit; Desorientierung
inhale => inhalieren
manicures => manikürt; manikürt
lemon => Limone
mime => Pantomime; Mime; mimen; Mime; mimen
pumps => Pumps; Pumpe; Pumpen; pumpt; Pumps; pumpt
downfall => Verfall
peeper => Spanner
suspect => suspekt; suspekt
radio => Radio; Radio
tingle => klingen
judas => judas; judas
nuremberg => nürnberg; nürnberg
candy => Kandis
bong => Bong; Bong
burning => brand
wing => Schwinge
jujitsu => Jiu-Jitsu; Jûjutsu; Jiu Jitsu; Jūjutsu; Jûjutsu; Jūjutsu
hare => Hase; hase; hase
bronchial => bronchial; Bronchial-; Bronchial...; bronchial; Bronchial-; Bronchial...
cursor => Cursor; Kursor; mauscursor; Cursor; Kursor
unearthed => ungeerdet
tame => fade
dinar => Dinar; Dinar
thunder => Donner; Schindel
fever => Fieber; fieber; fieber
stagnant => stagnierend
bowman => bowman; bowman
merlin => Merlin; merlin; Merlinfalke; Merlin; merlin
warmer => wärmer; wärmer
index => Index; Hinweis; Index
checkmate => Schachmatt; schachmatt; schachmatt setzen; Schaakmat
consuming => konsumierend; konsumieren; konsumierend; konsumieren
singularity => Singularität; Singularität
saracen => sarazene; sarazenen; sarazene; sarazenen
substitution => Substitution; Substituierung; Substitution
generated => generiert; geniert
encrusted => überkrustete; überkrustet; überkrustete; überkrustet
washed => gewaschen; ausgewaschen
fissures => Risse
chrysanthemums => Chrysantheme; Chrysanthemen; Chrysantheme; Chrysanthemen
harper => Harfner
vigil => Vigil; vigil; Vigil; vigil
seated => sitzend
partners => Partner; Partner
rustle => rauschen; säuseln
synthesis => Synthese; Einheit; Synthese
stick => Stock; stechen; stecken; stocken; Stecken
harvester => Erntearbeiter; Mähdrescher; Ernter
fest => festival
pakistan => pakistan; pakistan
valid => valid; valid
disarming => charmant
float => Float; Float
swims => schwimmt
hertfordshire => hertfordshire; hertfordshire
peugeot => peugeot; peugeot
charter => Charta; chartern; Charter; Chartervertrag; chartern; Charter
nipple => Nippel; Nippel
conga => Conga; Conga
parka => Parka; Parker; Parka
li => Li; Ri
glaucoma => Glaukom; Glaucoma; glaukom; Glaukom; Glaucoma; glaukom
delinquency => Delinquenz; Delinquenz
flutter => flattern; Flattern; flatternd; flattern; Flattern; flatternd
czech => tscheche; tschechin; tscheche
coordinator => Koordinator; Koordinatorin; Organisator; Koordinator; Koordinatorin
presidents => Präsidenten; Präsidenten
london => london; londoner; london; londoner
central => zentral; Zentral; Zentrale; Zentrum; zentral; Zentral; Zentrale
spider => Spider; Spider
bookmaker => Bookie; Bookmaker; Bookmaker
visas => Visa
parameter => Parameter; Parameter [math.]; Parameter
diarrhea => Diarrhö; Diarrhoe; Diarrhöe; Diarrhoe Diarrhö; Diarrhö; Diarrhoe; Diarrhöe
burka => Burka; Burke; Burka
lockout => Lockout; Lockout
philistine => Philister; philisterhaft; philiströs; Philister; philiströs
mothership => Mutterschiff
fett => feist
suede => Rauleder
fetishes => Fetische; Fetische
rota => rota; rota
bus => Bus; Omnibus; Autobus; Bus
transponder => Transponder; Transpondercode; Transponder; Transpondercode
financing => Finanzierung; finanzierend; Finanzierung; finanzierend
banded => gebändert; verbunden
chase => nachjagen
kidnapping => Kidnapping; Kidnapping
shorter => kürzer
satyr => Satyr; Satyr
spinach => Spinat; spinat; spinat
rapport => Rapport; Rapport
enthusiasm => Enthusiasmus; Enthusiasmus
sticks => Stöcke
vegetarians => Vegetarier; Vegetarierinnen; Vegetarier
effectiveness => Effektivität
charitable => karitativ
display => Display; Display
researching => recherchierend
salty => salzig; salzartig
technique => Technik; Technologie; technisch; technisch
macedonia => makedonien; mazedonien; makedonien; mazedonien
woolly => wollen; wollig; Woll-
cuckoo => Kuckuck; kuckuck; Kuckuck; kuckuck
rayon => Rayon; Reyon; Rayon; Reyon
receiver => Receiver; Receiver
minster => Münster; Münster
milling => mahlend
accuser => accuser; accuser
flirt => flirten; Flirt; flirtend; flirten; Flirt; flirtend
atoms => Atome
forwards => vorwärts; Vorwärts...; vorwärts
absurdly => absurd; absurderweise; absurd
parker => Parkaufseher
pauline => paulinisch
finite => finit; finit
shading => Schattierung; schattierend; Abschattung
nastier => garstiger; garstiger
caricature => Karikatur; Karikatur
sprayed => sprühte
hungary => ungarn; ungarn
krishna => krishna; krishna
la => La; la; la
inconsistency => Inkonsistenz; Inkonsistenz
gangster => Gangster; Gangster
sucked => genuckelt
agoraphobia => Agoraphobie; Agoraphobie
circulating => zirkulierend
ohio => ohio; ohio
hopper => Heuhüpfer
interpretation => Interpretation; Interpretierung; Interpretation
smugglers => Schmuggler; Schmugglerinnen
rainstorm => Regensturm
submerge => Submersion
hawker => Falkner
adoptive => adoptiv; Adoptiv-; adoptiv; Adoptiv-
villas => Villen
platforms => Plattformen; Plattformen
kamp => kamp; kamp
ara => Ara; Ara
ironies => Ironien; Ironien
charlatan => Scharlatan; scharlatan; Scharlatan; scharlatan
catastrophic => katastrophal; Katastrophen-; katastrophisch; Katastrophal; katastrophal; Katastrophen-; katastrophisch; Katastrophal
falsifying => falsifizierend
britannia => britannien; britannien
blaze => Flamme; flammen
intercepted => unterbrochen
releasing => Freisetzung
dipstick => Peilstock
chamois => Gams
rattling => Rattern
culturally => kulturell; kulturell
sioux => Sioux; Sioux
bedding => Bettung; bettend
prevailed => prävaliert
centrifuge => Zentrifuge; Zentrifugal; zentrifugieren; Zentrifugalkraft; etwas Zentrifugales; Zentrifugation; Zentrifuge; Zentrifugal; zentrifugieren
crispy => frisch
anathema => Anathema; Anathem; Anathema; Anathem
explosive => explosiv; explosionsartig; Explosivstoff; explosionsfähig; explosiv
maya => maya; maya
casting => Casting; Besetzung; Casting
auntie => Tante
barriers => Barrieren; Barrieren
medulla => Medulla; Medulla
fiddle => Fidel
jason => iason; jason; iason; jason
slumped => plumpste; geplumpst
bern => bern; bern
creamy => cremig
egotistical => egoistisch; egoistisch
intend => intendieren
forearm => Unterarm; Vorderarm; Vorarm; Vorderarm; Vorarm
supporter => Befürworter
shawl => Shawl; schal; Shawl
gardenia => Gardenie; Gardenia; gardenien; Gardenie; Gardenia; gardenien
malware => Malware; Malware
committees => Komitees; Komitees
jd => jd; jd
iq => iq; iq
knapsack => Rucksack; Knappsack; Knappsack
gallon => Gallone; Gallone
stutters => stottert; stottert
neanderthal => Neandertaler; Neandertaler
raining => regnend; regnen
crew => Crew; Crew
celibacy => Zölibat
fable => fabulieren
goatee => Goatee; Goatee
under => unter; unterhalb; darunter; unten; weniger; Inneres; unter
father => Vater; Pater; Pate; Pfarrer; Väter; Vater; Pater
aka => Aka; Aka
siphon => Siphon; Sipho; Siphon m; Siphon; Sipho; Siphon m
stride => schreiten; Stride-Piano
hymen => Hymen; Hymenaios; Hymenäus; Hymen
femininity => Feminität; femininität; Feminität; femininität
gargoyle => gargoyle; gargoyle
leonard => leonard; leonard
altruistic => altruistisch; Altruismus; altruistisch
email => E-Mail; mailen; Email; Mail; emailen; e-mailen; Email; emailen; e-mailen
houses => Häuser; Häuser
panther => Panther; Panter; panther; Panther; Panter; panther
neurological => neurologisch; neurologische; neurologisch; neurologische
keen => kühn; beißend
apostrophe => Apostroph; Apostrophe; Apostroph; Apostrophe
georgetown => georgetown; georgetown
krypton => Krypton; krypton; Krypton-; Krypton; krypton; Krypton-
hypnotic => hypnotisch; hypnotisierend; Hypnotikum; hypnotisch
pathos => Pathos; Pathos
misery => Misere; Misere
ci => ci; ci
interactive => interaktiv; Interaktivität; Unterhaltung; interactiv; interaktiv; Interaktivität; interactiv
fascists => Faschisten
fez => Fez; fez; Fez; fez
nuance => Nuance; Nuance
typing => Typisierung; tippend
squeeze => ausquetschen
divisions => Divisionen; Divisionen
bigamist => Bigamist; Bigamist
lipsticks => Lippenstifte
allergy => Allergie; Allergie
relay => Relais
corporate => korporativ; korporativ
fancier => Kenner
plane => Platane
angst => Angst; Angst
fabian => fabian; fabian
tennessee => tennessee; tennessee
borneo => borneo; borneo
steward => Steward; Steward
psychiatrist => Psychiater; Psychiaterin; Psychiater ''m'' -s; Psychiater -s; Psychiat; Psychiater; Psychiaterin; Psychiater -s
olympics => olympiade; olympiade
galleon => Galeone
turnpike => Turnpike; Turnpike
cells => Zellen; Zelle
holler => brüllen
moderation => Moderation; Moderation
yard => Yard; Yard
firm => Farm
aloha => Aloha; Aloha
wheeling => wheeling; wheeling
kirk => kirche; kirche
carbon => Karbon; Carbon; Karbon; Carbon
rodent => Rodentia; Rodentia
reservoir => Reservoir; Reservoir
intermission => Unterlass; Intermission; Intermission
ulster => Ulster; Ulster
dundee => dundee; dundee
blues => Blues; Blaumiese; Blues
vietnamese => vietnamese; vietnamesisch; vietnamese; vietnamesisch
alligators => Alligatoren; Alligator; Alligatoridae; Alligatoren; Alligator; Alligatoridae
attraction => Attraktion; Attraktivität; Attraktion
diction => Diktion; Diktion
rams => rammt
regale => regale; regale
joyce => joyce; joyce
tolerant => tolerant; fehlertolerant; tolerante; tolerant, duldsam; tolerant; tolerante
ringer => Klingeln
tactical => taktisch; taktisch
magnus => magnus; magnus
baptism => Baptismus; Baptismus
ducked => geduckt
drinks => Trünke
provisional => provisorisch
ponies => Ponys
animator => Animator; Animatorin; Animateur; Animator; Animatorin; Animateur
triage => Triage; triagieren; Triage
til => Til; Til
erectile => erektil; erektil
humanism => Humanismus; Humanität; Humanismus
artillery => Artillerie; Artillerist; Artilleriewesen; Artillerietruppe; Artillerie; Artillerist
vomiting => Vomitus
attaching => festmachend
camped => kampierte; kampiert; kampiert
hopi => hopi; hopi
roosevelt => roosevelt; roosevelt
symmetrical => symmetrisch; symmetrisch
potty => Pott
syntax => Syntax; Syntax
infection => Infektion; Infekt; infektion; Infektion; infektion
bos => Bos; Bos
robbers => Räuber
workstation => Workstation; Arbeitsstation; Workstation
snatching => haschend
fraternity => Fraternität; Fraternität
shikoku => Shikoku; Shikoku
dated => datiert
humid => humid; humid
research => Recherche
tucking => steckend
denser => dichter
peeler => Schäler
canaan => kanaan; kanaan
corky => korkig; korkig
eureka => Heureka; Heureka
lightheaded => leichtfertig
effusion => Effusion; Effusion
cellulite => Cellulite; Cellulitis; Zellulite; Zellulitis; Cellulite; Cellulitis; Zellulite; Zellulitis
anthropologists => Anthropologen; Anthropologinnen; Anthropologen; Anthropologinnen
billy => Billy; Billy
canton => Kanton; Kanton
cargo => cargo; Kargo; cargo; Kargo
traded => trieb Handel
taiji => Taiji; Taiji
tequila => Tequila; Tequila
sapper => Sappeur; Sappeur
congeniality => Kongenialität; Kongenialität
synthetic => synthetisch; Synthese; einheitlich; synthetisch
philanthropic => philanthropisch; philanthropisch
flew => flog; flogen
irritates => irritiert
lax => lax; lax
registrations => Registrationen; Registrierungen; Registrationen
prudish => prüde
signet => Signet; Signet
moderates => mildert
jewellery => Juwelen
monetary => monetär; monetär
crustacean => Krustentiere; Krustazeen; Krustazeen
batch => Batch; Batch
ambassador => Ambassadeur; Ambassadeur
birdie => Birdie; Birdie
canals => Kanäle; Kanal; Kanal
turbine => Turbine; turbine; Turbine; turbine
adrienne => Adriane; Adriane
nadir => Nadir; Nadir
monger => Händler
capitalists => Kapitalisten; Kapitalistinnen; Kapitalisten
socrates => sokrates; sokrates
frontiers => Frontiers; Frontiers
streams => strömt; Strom; Ströme
rally => Rallye; Rallye
windsor => windsor; windsor
hypertensive => hypertoniker; hypertoniker
frack => fracken; fracken
outlander => Ausländer; ausländer; Ausländer; ausländer
athena => athene; athene
barbados => barbados; barbados
furious => furios; furios
chief => Chef; Chef
dyke => dyke; dyke
candida => Candida; Candida
sand => Sand; sanden; versanden; Sand; sanden
define => definieren
picnic => Picknick; picknicken; Picknick; picknicken
afloat => flott; flott
gorilla => Gorilla; Gorilla gorilla; gorillas; Gorilla; gorillas
chisel => Meißel; meißeln; Beitel; Stechbeitel; schummeln
classical => klassisch; Klassiker; klassisch; Klassiker
nessie => nessie; nessie
polling => Polling; Polling
stammering => Stammeln; stammelnd; stotternd; stammelnd
enos => enosch; enosch
autobahn => Autobahn; Bundesautobahn; Autobahn (A); Autobahn
gastritis => Gastritis; Gastritis
wisconsin => wisconsin; wisconsin
alcmene => alkmene; alkmene
repaired => repariert; repariert
command => Kommando; kommandieren; Kommando
thar => Thar; Thar
inflamed => entflammte; entflammt; infiziert
falling => Fall; fallend; fallend
morgen => Morgen; Morgen
hornet => Hornissen; F-18 Hornet; hornissen
hummel => Hummel; Hummel
services => Verdienst; Service-Industrie
telegraphed => telegraphierte; telegraphierten; telegrafiert; telegraphiert; telegraphierte; telegraphierten; telegrafiert; telegraphiert
wisely => weise
offline => offline; off; Offline; offline; Offline
hemorrhoid => Hämorrhoide; Hämorrhoiden; hämorride; Hämorrhoide; Hämorrhoiden; hämorride
vehicle => Vehikel
sprout => Spross
bosses => Bosse; Bosse
criticising => kritisierend
keel => Kiel; Kiel
excellently => exzellent; exzellent
salient => markant
cardamom => Kardamom; Kardamomen; grüner kardamom; Kardamom; Kardamomen
leon => leon; leon
equipment => Equipment; Equipment
terrorizing => terrorisierend; terrorisierend
hanging => hängend; Hängen; Erhängung; Hängung
scuff => schlurfen
venezuela => venezuela; venezuela
methodology => Methodologie; Methodik; Methodenlehre; methodologie; Methode; Methodologie; methodologie
walker => Alice Walker; walker; walker
benefited => begünstigte
wept => geweint; weinte; beweint
caliber => Kaliber; Kaliber
bootleg => Bootleg; Bootleg
somalia => somalia; somalia
helios => helios; helios
genre => Genre; Genre
aachen => aachen; aachen
scrambling => Scrambling; scrambling; Scrambling; scrambling
unpublished => Unpubliziertheit
colonialism => Kolonialismus; kolonialismus; Imperialismus; Kolonialismus; kolonialismus
clang => klingen
tiberius => tiberius; tiberius
attache => Attache; Attaché; Attache; Attaché
fleck => Fleck; Flecken; Fleck
kwan => Kwan; Kwan
pusher => Pusher; Pusher
partition => Partition; Partition
schizophrenic => schizophren; Schizophrene; Schizophrener; schizophren; Schizophrene; Schizophrener
warmed => erwärmten; warm geworden
transcribe => transkribieren; abschreiben; überschreiben; genau beschreiben; transkribieren
unruly => unruhig; unruhig
rolling => Rollen; wellig; rollend; rollierend; rollend
idealist => Idealist; Idealistin; idealistisch; Idealist; Idealistin; idealistisch
ingested => eingenommen
animosity => Animosität; Animosität
burgundy => burgund; Burgunderwein; burgunder; burgund; burgunder
norway => norwegen
who => wo; who; wo; who
hasty => hastig; Hast; hastig
franc => Franc; Franken; Franc
lambert => Lambert; Lambert
amnesia => Amnesie; Amnesie
par => Par; Pari; pari; Par; pari
cynic => Zyniker; zynisch; Kyniker; kynisch; zynisch; kynisch
holier => heiliger; heiliger
melancholy => Melancholie; melancholisch; Melancholie; melancholisch
liberal => liberal; Liberaler; liberal; Liberaler
auburn => auburn; auburn
jaeger => Jäger; Jäger
operations => Operationen; Operationen
unpopular => unpopulär; unpopulär sein; Unpopularität; unpopulär; Unpopularität
location => Position; Location; Position; Location
lotion => Lotion; Lotion
fruity => fruchtig
anticipating => Antizipieren; antizipierend; antizipierend
euthanasia => Euthanasie; Sterbehilfe Euthanasie; Euthanasie
presbyterian => Presbyterianer; Presbyterianer
hand => Hand; Hand
screech => schreien
doctoral => Doktor; Doktor...; Doktor
scraper => Schaber; Kratzer; Schabe; Schrapper; Schrapper
tester => Tester; Tester
acetone => Azeton; Aceton; aceton; Azeton; Aceton; aceton
vane => Fahne
eliminates => eliminiert
simmer => sieden; simmern; simmern
explosions => Explosion; Explosionen; Explosion; Explosionen
liquidate => liquidieren; liquidieren
sol => Sol; Sole; sol; so; Sol; sol; so
tutankhamun => tutanchamun; tutanchamun
render => rendern; präsentieren; rendern
blabbermouth => Plappermaul
imitations => Imitation; Replikation; Imitationen; Imitation; Imitationen
lichen => Flechte; Flechten; Lichen; flechten; Flechten; Lichen; flechten
breakout => Breakout; Breakout
generators => Generatoren; Generatoren
kilometres => Kilometer; Kilometer
shipping => Verschiffung
piranha => Piranha; Piranhas; piranhas; Piranha; Piranhas; piranhas
harmonics => Harmonielehre; Harmonik; Harmonischen; Harmonik
strenuous => anstrengend
lines => Linien
intercom => Intercom; Intercom
ken => kennen; Ken; Ken
pathology => Pathologie; pathologie; Humanpathologie; Tierpathologie; Pathologie; pathologie; Humanpathologie; Tierpathologie
round => rund; runden; rund
exile => Exil; Exilant; exilieren
moor => Moor; Mohr; Hochmoor; Moor; Mohr
toilets => Toiletten
epsilon => Epsilon; Epsilon
processors => Prozessoren; Prozessoren
fusion => Fusion; Fusion
vandals => Vandalen; Vandalen
restrictions => Restriktionen; Restriktionen
bruges => brügge; brügge
tattle => tratschen
academics => Akademiker; akademische; akademische
sunblock => Sunblocker; sonnenblocker; Sunblocker
spiked => spitz; beißend; bespickte
substances => Substanzen; Substanz; Substanzen
krakow => krakau; krakau
grouping => Gruppierung; Eingruppierung
orally => oral; oral
meetings => Meetings; Meetings
protons => Protonen; Protonen
confrontation => Konfrontation; Konfrontation
detector => Detektor; Detektor
perjury => Perjuration
pollux => pollux; pollux
cabin => Kabine; Kabine
lodgings => Logis
bug => Bug; Bug
ou => Ou
urinate => urinieren
yips => Yips; Yips
schemer => Verschwörer
rationed => rationierten; rationiert; rationierte; rationiert; rationierte
shrapnel => Schrapnell; Schrapnell
shorten => kürzen; stutzen
requiem => Requiem; Requiem
stringy => strähnig; steif
distanced => distanzierte; distanzierte
curriculum => Curriculum; Curriculum
hallo => Hallo; hallo; Hallo; hallo
coochie => muschi
cleaning => Reinigung
sides => seiten
scanning => Scanning; Scanning
respectable => respektabel; respektabel
sitter => Babysitter; Sitzender
rounded => gerundet; rund; gerundet
okey => ok; okay; okay
scroll => Schriftrolle; scrollen; scrollen
exclusivity => Exklusivität; Exklusivität
fix => fixen
basset => basset; basset
podium => Podium; Podien; podest; Podium
kuru => Kuru; Kuru
kernel => Kern; Kernel; kernel; Kernel; kernel
shanghai => schanghaien; schanghai; shanghai; shanghaien; schanghaien; schanghai; shanghai; shanghaien
persistence => Persistenz; Persistenz
debuted => debütiert; debütiert
compatible => kompatibel; Kompatibilität; kompatibel
granada => granada; granada
fatter => fetter; fetter
landed => gelandet; landete; gelandet; landete
emigrant => Emigrant; Emigrantin; Arbeitsmigrant; Emigrant; Emigrantin
hockey => Hockey; Eishockey; Feldhockey; Hockeysport; Landhockey; Hockey; Eishockey
anaconda => Anakonda; Anaconda; Große Anakonda; anaconda; Anakonda; Anaconda; anaconda
assistance => Beistand
darkly => dunkle; dunkle
ovaries => Ovarium; Ovariole
drainage => Drainage; Dränage; Drainage; Dränage
lust => Wollust; Lust; Lust
bigoted => bigott; bigott
stiles => Steigen
reaches => reicht
capture => kapern
celluloid => Zelluloid; Celluloid; Cellulosenitrat; Nitrocellulose; Zelluloid; Celluloid
compromise => Kompromiss; kompromittieren; Kompromiß; Kompromiss; Kompromiß
yahtzee => Yahtzee; Yahtzee
sicken => aneklen; anekeln
smuggler => Schmuggler; Schmugglerin; Schmuggler
earlier => früher; eher; vorher
raki => Raki; Raki
insights => Einsichten; Einsichten
migration => Migration; Migration
dinner => Diner; Dinner; Diner; Dinner
legacy => Legat
detainees => Arrestantinnen
scrubbed => geschrubbt
résistance => Resistance; Résistance; Resistance; Résistance
ganja => Ganja; Ganja
negativity => Negativität; Negativität
spontaneity => Spontaneität; Spontanität; Spontaneität; Spontanität
absolute => absolut; absolut
coconut => Kokosnuss; Kokosnuß; Cocos; Kokonuss; Kokosnuß; Kokonuss
equinox => Äquinoktium; Äquinoktikum
diorama => Diorama; Diorama
kama => Kama; Kama
civilisations => Zivilisationen; Zivilisationen
firmament => Firmament; Himmel; Firmament -s; Firmament; Firmament -s
whoever => jeder; jeder
provocation => Provokation; Provokation
via => via; via
russ => russisch
chameleon => Chamäleon; chamäleons; Chamäleon; chamäleons
beanstalk => bohnenstange
raven => Raben; Raben
paradise => Paradies; paradies; Paradies; paradies
dos => dos; dos
refrigerator => Gefrierfach
denies => dementiert
grounded => grundierte; begründet; gegründet; grundiert
conceptual => konzeptionell; konzeptuell; konzeptionell; konzeptuell
authentication => Authentifizierung; Authentifikation; Authentisierung; Legitimation; Authentifikation
boiler => Boiler; Kocher; Boiler; Kocher
acme => Akme; acme; Akme; acme
galileo => galilei; galilei
foghorn => Nebelhorn; Nebelhorn
dose => dosieren; dosis
harsher => rauher; rauer
taylor => taylor; taylor
gloss => Glosse; glossieren; Glosse
capitalistic => kapitalistisch; kapitalistisch
hyena => hyänen; hyänen
tenerife => teneriffa; teneriffa
nazism => Nazismus; nazismus; Nazismus; nazismus
pointer => Zeiger; Pointer; Laserpointer; Pointer
academically => akademisch
curate => Kurat; kuratieren; Kurat
abort => Abort; abortieren; Abort
portray => porträtieren
pet => Pet; Pet
formidable => formidabel; formidabel
lorelei => Loreley; Loreley
gaga => gaga; gaga
pluck => pflücken
derogatory => derogatorisch; derogativ; derogatorisch; derogativ
snacks => Snacks; Snacks
barrel => Barrel; Barrel
curvy => kurvig; kurvig
telegram => Telegramm; Telegrammtext; telegrafieren; telegraphieren; Telegramm
meditative => meditativ; meditativ
moderator => Moderator; Moderatorin; Moderator; Moderatorin
eradicate => vernichten
humanoid => humanoid; Humanoide; Humanoid; humanoider Roboter; humanoid; Humanoide; Humanoid
junta => Junta; Militärjunta; Junta
astronomer => Astronom; Astronomin; Astronomus; Astronom; Astronomin; Astronomus
theses => Thesen; Thesen
probation => Probation; Probation
manchester => manchester; manchester
intracranial => intrakraniell; intrakranial; intrakraniell; intrakranial
acrobatic => akrobatisch; Akrobat...; Akrobaten-; akrobatisch
bombing => Bombardierung; bombardierend; bomben; bomben
olympic => olympisch; olympic; olympisch; olympic
female => feminin
stimulant => Stimulans; stimulierend; Stimulans
epitome => Epitome; Epitom; Epitome; Epitom
inception => Anbeginn; inception; inception
singular => Singular; singulär; Singular; singulär
apparatus => Apparat; Apparatur; Apparat; Apparatur
fewer => weniger
specialized => spezialisiert; Spezial-; sich spezialisiert; speziell; spezialisiert
tattletale => Tratschtante
talentless => talentlos; talentlos
moped => Moped; Moped
bloodlust => Mordlust; Mordlust
musician => Musikant; Musikerin
puppet => Puppe; Handpuppe; Holzpuppe; Puppe
amir => Emir; emir; Emir; emir
roman => römerin
mem => mem; mem
rehabilitated => rehabilitierte; rehabilitierte
shalt => sollst
grandmaster => Großmeister; Großmeister
beemer => Brenner
berber => Berber; berber; berberisch; Berber; berber
blabber => plappern
sharpshooter => scharfscütze; Scharfschütze; scharfscütze
flees => flieht
rifle => Pistole
representative => Repräsentant; repräsentativ; Repräsentant; repräsentativ
relatively => relativ; relativ
clearer => heller
tolerate => tolerieren
indian => indisch; inder; inderin; indianer; indianerin; indianisch; indio; indianer; indio
middling => leidlig
instructs => instruiert
jos => jos; jos
philosophical => philosophisch; philosophischen; philosophisch; philosophischen
breached => gebrochen
rotterdam => rotterdam; rotterdamer; rotterdam; rotterdamer
verger => Mesner
finder => Finder; Finderin; Finder; Finderin
symptomatic => symptomatisch; symptomatische; symptomatisch; symptomatische
drilling => Training; drillend; drillend
sudo => Sudo; Sudo
zachariah => zacharias; zacharias
november => November; November
whiter => weißer; weißer
saddle => satteln
storey => stock
sambo => Sambo; Zambo; Sambo; Zambo
centers => Zentren; zentriert; zentriert
catechism => Katechismus; Katechismus
servers => Server; Servierer; Server
nitrogen => Nitrogen; Nitrogenium; Nitrogen; Nitrogenium
aussie => australien
dir => Dir; Dir
falconer => Falkner; Falkenjäger; Falknerin; Falkner
wallpaper => Wallpaper; Wallpaper
sonogram => Sonogramm; Sonografie; Sonogramm
whitehall => whitehall; whitehall
curve => Kurve; Kurve
concussion => Konkussion; Konkussion
notoriously => notorisch; notorisch
mustang => Mustang; Mustang
religious => religiös; religiös
shalom => Schalom; Shalom; Schalom; Shalom
motor => Motor; motorisch; Motor
engineer => Ingenieur; Ingenieurin
exotic => exotisch; exot; exotisch; exot
oxide => Oxid; Oxide; Oxid...; Oxide
blockage => Blockade; Straßenblockade; Blockade
answer => antworten; Antwort; antworten; Antwort
pine => Pinie
drapes => drapiert; drapiert
pasta => Pasta; Paste; Pasta
mogul => Mogul; Mogul
chips => Chips; Chips
validated => validiert
lava => Lava; Lave; Lava
forefront => Vordergrund; vorderste Front
organise => organisieren; Organisation; Organisieren; Organisator; organisieren
lethargic => lethargisch; lethargisch
freeman => freier Mann
triangulated => trianguliert; trianguliert
optometrist => Optometrist; Optometer; Optikerin; Optometrist; Optometer
certificate => Zertifikat; Zertifikat
composing => Komposition; komponierend; komposition; komposition
risking => riskierend
polygamy => Polygamie; Polygynie; Polygamie
musketeer => Musketier; Musketier der Garde; Musketier
endures => erduldet
commerce => Kommerz; Kommerz
surf => surfen; surf; Surfen; surfen; surf
enlightening => erleuchtend
inspecting => Inspektion; inspizierend; Inspektion
parked => geparkt; parkte; parkten; parkte; parkten
extractor => Entsafter; Separator
denise => Denise; Denise
hermetically => hermetisch
typically => typisch
waterfalls => Wasserfall; Wasserfälle; Wasserfälle
alcoholics => Alkoholiker; Alkoholiker
reproductive => reproduktiv; reproduktiv
designate => designieren; designieren
determination => Determination; Determination
nona => nona; nona
charismatic => charismatisch; Charismatiker; Charismatikerin; charismatisch; Charismatiker
pierced => gepierct
handmade => handgemacht; handgearbeitet
knots => Knoten; knotet; verknotet; knotet
quantum => Quant; Quantum; Quanten; Quanten-; Quantum
noting => notierend
siberian => sibirisch
win => Gewinn
erect => errichten; aufrecht; erigiert
hospitalised => hospitalisiert; hospitalisierte; hospitalisiert; hospitalisierte
icon => Icon; Ikon; Zeichen; Icon; Ikon
crash => Krach; krachen; Crash; Krachen; Crash
intensely => intensiv; intensiv
templar => Templer; Templer -s; tempelritter; Templer
dart => Dart; Dart
vitamin => Vitamin; Niacin; Vitamin; Niacin
entering => Unterbringung
curiosities => Kuriositäten; Kuriositäten
classics => Klassik; Klassiker; klassische Musik; klassisches Werk; Klassik
androids => Androiden; Androiden
answering => antwortend; antworten; beantwortend; antwortend; antworten
terrorists => Terroristen; Terrorist; Terroristin; Terroristen; Terrorist; Terroristin
commie => Kommi; Kommunist; Kommi
scene => Szene; Szene
bring => bringen; mitbringen; herbringen; erbringen; überbringen; hinbringen; anbringen; bringen
octagon => Oktogon; Oktagon; Oktogon; Oktagon
islamic => islamisch; islamisch
pelvis => Pelvis; Pelvis
liaison => Liaison; Liaison
record => Rekord; Rekord
standoff => Abstandsbolzen
rom => rom; rom
design => Design; designen; Design; designen
should => soll
monotone => monoton; monton; Monotonie; monotones Geräusch; monoton; monton; Monotonie
reigning => regierend
ent => Ent; Ent
kappa => Kappa; Kappa
honduras => honduras; republik honduras; honduras
dispensary => Dispensaire; Dispensaire
diplomatic => diplomatisch; diplomatisch
odour => Odor
evaluation => Evaluation; Evaluierung; Evaluation
neuroscience => Neurowissenschaften; Neurowissenschaft
green => grün; grünen; grünen
minivan => Minivan; Minivan
beakers => Becher
nano => Nano; Nano
restructuring => Umstrukturierung; Restrukturierung; Neustrukturierung; Umstrukturierung; Restrukturierung; Neustrukturierung
analysis => Analyse; Analysis; Analyse; Analysis
teleportation => Teleportation; Teleportation
compilation => Kompilation; Compilierung; Kompilierung; Kompilation
dorsal => dorsal; dorsale; dorsal; dorsale
prince => Prinz; Prinz
bands => Bands; Bands
oracle => orakeln; orakeln
colic => Kolik; kolik; Kolik; kolik
communicator => Kommunikator; kommunikativer Mensch; Kommunikator
synopsis => Synopse; Synopsis; Synopse; Synopsis
western => westlich; Western; West; western; West-; Western; western
symphonic => symphonisch; symphonisch
mulberry => Maulbeere; Maulbeerbaum; Maulbeere
keeper => Keeper; Keeper
sown => säen; säen
tiptop => tipptopp; tipptopp
iranian => iranisch; iraner; iranerin; iranisch; iranerin
neck => Genick
ran => rannte
persuasive => persuasiv; persuasiv
acreage => Areal
sailboat => Segelboot
priesthood => Priestertum; Priesterschaft; priesterwürde
madras => Madras; Madras
unforeseen => unvorhergesehen; unvorgesehen; unvorgesehen
unofficially => inoffiziell; inoffizielle; inoffiziell; inoffizielle
meant => gemeint; meinen
pelvic => pelvin; pelvin
statuette => Statuette; Statuette
tunnel => Tunnel; Folientunnel; Tunnel
monaco => monaco; monaco
hadji => Hadschi; haji; haji
cinematography => Kinematographie; Kinematografie; Cinematografie; cinematographie; Kinematographie; Kinematografie; Cinematografie; cinematographie
neo => neo; neo
expertise => Expertise; Expertise
buggy => Buggy; Buggy
inhalation => Inhalation; Inspiration; Aspiration; Inhalation
manor => Manor; Manor
block => Block; blockieren; Häuserblock; abblocken; Block
ido => ido; ido
sash => Fatsche
indiscretion => Indiskretion; Indiskretion
document => Dokument; dokumentieren; Dokument; dokumentieren
individual => Individuum; individuell; Individuum; individuell
bassist => Bassist; Bassistin; Kontrabassist; Kontrabassistin; Bassist; Bassistin
mystical => mystisch; mystische; mystisch; mystische
flyer => Flieger; Flyer; Flyer
warrant => Garantie
mentors => Mentoren; Mentorinnen; Mentoren
fettuccine => Fettuccine; Fettuccine
criterion => Kriterium; Kriterium
bulgarian => bulgarisch; bulgare; bulgarin; bulgarisch; bulgare; bulgarin
ainu => ainu; ainu
website => Website; Webseite; Website; Webseite
confirm => konfirmieren
prom => Prom; Prom
inch => Inch; Inch
subatomic => subatomar; subatomar
sweatshop => Sweatshop; Sweatshop
hardball => Baseball; baseball; Baseball; baseball
rescuing => Rettung
yodeling => Jodeln; jodelnd; Jodeln; jodelnd
forests => Forste
mentality => Mentalität; Denkart; Mentalität
al => Al
simulation => Simulation; Simulieren; Simulierung; Imitation; Simulation
grille => Grill; grill; Grill; grill
soba => Soba; Soba
castile => kastilien; kastilien
ranching => Ranching; Ranching
combination => Kombination; Kombination
beehive => Beehive-Frisur
photogenic => fotogen; photogen; Fotogenität; photogen
gardner => Gärtner; Gärtnerin
zest => Lust; Lust
machiavellian => machiavellistisch; machiavellistisch
kursk => kursk; kursk
person => Person; Wesen; Person
junior => jünger; Junior; junior; Junior; junior
caddy => Caddie; Caddy; Caddy
georgia => georgien; georgia; georgien; georgia
atomic => atomar; Atom; atomisch; Atom-; Atom...; atomar; atomisch
informing => informierend; informierend
understandable => verständlich
aga => aga; aga
getty => getty; getty
aberration => Aberration; Aberratio; Aberration; Aberratio
offshore => offshore; Off-Shore-; offshore
livy => livius
omelette => Omelett; Omelette; Omelett; Omelette
shunt => Shunt; shunt; Shunt; shunt
squeaks => quiekt
array => Array; Array
moustache => Moustache; Moustache
curt => kurz; kurz
reactive => reaktiv; reaktiv
caviar => Kaviar; kaviar; Kaviar; kaviar
philippine => philippinisch; philippinisch
hydroxide => Hydroxid; Hydroxyd; Hydroxide; Hydroxid; Hydroxyd; Hydroxide
diploma => Diplom; Diplom
tentative => tentativ; tentativ
bunches => Bunde
turtle => Turteltaube
dubious => dubios; dubios
byline => Nebenlinie
lorazepam => Lorazepam; Lorazepam
jig => Jig; Jig
janus => janus; janus
mandates => Mandate; Mandate
trickling => sickernd; triefend
radiator => Radiator; radiator; Radiator; radiator
nest => Nest; nisten; Vogelnest; Nest
systematic => systematisch; System; systematisch
swing => schwingen; Swing; Schwingen; Swing
mangled => gemangelt
bastards => Bastarde; Bastarde
bundles => Bündel
bolsheviks => Bolschewiken; Bolschewiki; Bolschewiken; Bolschewiki
broccoli => Brokkoli; Broccoli; Broccolisprossen; Brokkoli; Broccoli
rapidly => rapide; rapid; rapide; rapid
hierarchy => Hierarchie; Hierarchie
simpleton => Simpel
retrieving => rettend
clara => klara; klara
manipulating => manipulierend; manipulierend
whisker => Whisker; Whisker
erratic => erratisch; irrig; erratisch
ideal => ideal; Ideal; ideell; ideal; Ideal; ideell
platform => Plattform; Plattform
mayo => Majo; Mayo; Majo; Mayo
clammy => klamm; klamm
gallantry => Galanterie
valkyrie => Walküre; Walküre
fecal => fäkal; fäkal
elevators => Becherelevator
java => Java; java; Java; java
fraternizing => fraternisierend; fraternisierend
replay => replay; replay
mulch => Mulch; mulchen; Mulchen; Mulch; mulchen
guatemala => guatemala; republik guatemala; guatemala
presses => Presse; Pressen; Presse; Pressen
sensei => Sensei; Sensei
wording => Formulierung
fucking => ficken; Ficken; ficken
plum => Pflaume
shearer => Schafscherer; scherer; scherer
tracer => Tracer; Tracer
reminiscent => reminiszent; reminiszent
uproot => ausrotten
byproduct => Nebenprodukt; Nebenprodukt
stradivarius => stradivari; stradivari
extravaganza => Extravaganza; Extravaganza
karachi => karatschi; karatschi
mare => Mare; Mare
fleming => flame
mage => Magier
cult => Kult; Kultus; Kult-; kultig; Kult; kultig
stimulated => stimulierte; stimulierte
gestapo => Gestapo; Gestapo
vishnu => vishnu; vishnu
impartial => unparteiisch; unparteilich
kissed => küsste; küsste
mongolia => mongolei; mongolei
men => man; man
sanitizer => Reiniger
colony => Kolonie
smelting => Abschmelzung; schmelzend
boor => Tor
ai => Ai
paradigm => Paradigma; Flexionsparadigma; Paradigma
folding => faltend; Faltung
crashing => krachend; krachend
enthusiastically => enthusiastisch; enthusiastisch
directional => direktional; bidirektional; direktional; bidirektional
latch => Latch; Latch
southwest => Südwest
motherland => Vaterland; Mutterland; Vaterland; Mutterland
offer => Offerte; offerieren; opfern; opfern
ate => aßen; at; aß; aßen; at
bluish => bläulich; Bleiche; blaustichig; bläulich
mobilize => mobilisieren; mobil machen
additional => additiv; additional; additional
angela => angela; angela
diabetes => Diabetes; Diabetes mellitus; diabetes Mellitus; Diabetes
twisted => Twist
sapphire => Saphir; saphiren; saphir; saphirblau; Sapphire; Saphir -s; Saphir; saphiren; saphir; Sapphire
basra => basra; basra
handstand => Handstand; Handstand
latter => letztere; letzter; letzterer; zweiter; letzte; Letztere; letzteres; letztere; letzter; letzterer; letzte; Letztere; letzteres
hardens => härtet
forensics => Forensik; Forensik
neolithic => neolithisch; Neolithikum; nölitisch; neolitisch; neolithisch; Neolithikum; neolitisch
pliny => plinius
martyrs => martert; martert
overdose => Überdosis; überdosieren; ueberdosis; Überdosierung
qualify => qualifizieren
million => Million; million; Millionen; eine Million; Million; million; Millionen
respect => Respekt; respektieren; Respekt
toughen => eintauchen; tauchen; tauchen
macintosh => apple macintosh
send => senden; versenden; entsenden; zusenden; senden
gold => Gold; golden; gülden; Geld; gold; goldig; Gold; golden; gold; goldig
private => privat; privat
influx => Zufluss; Einfluss; Einfuhr; Zufluß; Einfluss
rotisserie => rotisserie; rotisserie
jab => Jab; Jab
jarl => Jarl; Jarl
adequate => adäquat; adäquat
biker => Biker; Rocker; Bikerin; Biker
friend => Freund
coronary => koronar; koronar
wealthier => reicher; Reicher
id => Id; ide; ide
finesse => Finesse; Raffinesse; Finesse; Raffinesse
confluence => Konfluenz; Konfluenz
lustful => lüstern
decree => Dekret; dekretieren; Dekret
sporadic => sporadisch; sporadisch
onyx => Onyx; Onyx
immovable => Immobilie
substandard => Substandard; Substandard
sexual => sexuell; sexual; Sexual; Sexual...; sexuell; sexual; Sexual
bronco => bronco; bronco
skepticism => Skeptizismus; Skepsis; Skeptizismus
elm => Ulme; Ulme
fen => Fenn
unmade => ungemacht
chaff => Kaff; Schale
cellulose => Zellulose; Cellulose; Zellstoff; Zellulose; Cellulose
swahili => Swahili; Suaheli; Swahili; Suaheli
mask => Maske; maskieren; Mundmaske
angiogram => Angiogramm; Angiogramm
smuggled => geschmuggelt; schmuggelte
election => Elektion; Election; Elektion; Election
ammunition => Munition; Munition
transmutation => Transmutation; Transmutation
rhetorical => rhetorisch; rhethorisch; rhetorisch; rhethorisch
compensated => kompensiert; kompensiert
hangers => Aufhänger; Anhänger
herbal => Herbarium; herbarium
wal => wal; wal
marshall => Marschall; marshall; Marschall; marshall
partisan => Partisan; Partisane; parteiisch; Partisanin; Parteigänger; Partisan; Partisane; Partisanin
teaching => Unterweisung; Unterrichtung; Belehrung
robes => Roben
dialog => Dialog; Dialogfeld; Dialog
fax => Fax; faxen; Telefax; Fax
consolidate => konsolidieren; konsolidieren
crucifix => Kruzifix; Kruzifix
caregiver => Pfleger
swim => schwimmen
cantor => Kantor; Kantor
construct => konstruieren; Konstrukt; Konstrukt
frugal => frugal; frugal
online => online; Online; Online...; online; Online
macao => macao; macao
weekend => Weekend; Weekend
marimo => Marimo; Marimo
sonar => Sonar; Sonar
genome => Genom; Genom
omaha => omaha; omaha
half => halb; Halfte; halb
cw => cw; cw
puma => Puma; Puma
demos => Demos; Demos
disillusionment => Desillusionierung; Desillusion; Desillusionierung
weights => Gewichte; Gewichte
portraying => porträtierend; porträtierend
knockouts => Knockouts; Knockouts
semen => Samen
buddhism => buddhismus; buddhismus
tang => Seetang
sicilian => sizilianer; sizilianisch; sizilianer; sizilianisch
intensive => intensiv; intensive; intensiv; intensive
prospecting => Prospektion; Prospektierung; Prospektion; Prospektierung
mandatory => mandatorisch; mandatorisch
corrupts => korrumpiert
papua => papua; papua
amphibians => Amphibie; Amphibien; Amphibia; Amphibie; Amphibien; Amphibia
perugia => perugia; perugia
imaginary => imaginär; imaginär
grenade => Granate; Handgranate; Wurfgranate
prove => prüfen; erproben
continents => Kontinente; Kontinente
asgard => asgard; asgard
police => Polizei; polizeilich; polizei; Polizei-; polizei
cerebral => zerebral; Zerebral-; cerebral; Cerebro-; zerebral; Zerebral-; cerebral; Cerebro-
gynecologist => Gynäkologe; Gynäkologin; Gynäkologe; Gynäkologin
reviewing => rezensierend
liposuction => Liposuktion; Liposuktion
juggler => Jongleur; Gaukler; Magier; Jongleur
couplet => Couplet; Couplet
spaniards => spanier; spanier
absolution => Absolution; Absolution
thread => Thread; Thread
kyu => Kyu; Kyu
mingle => mischen; mengen
cameras => Kameras; Kameras
duelling => duellierend; duellierend
reflects => reflektiert; reflektiert
obstetrics => Obstetrik; Obstetrik
rosé => Rosé; Rosé
steer => steuern; Stier; steuern
smith => smith; smith
bushes => Buschwerk; Buchsen
i => i; i
whacked => haute
sexting => Sexting; sexting; Sexting; sexting
worried => Sorge
bora => bora; Bora; bora; Bora
element => Element; Bauelement; Moment; Element; Bauelement
copywriter => Copywriter; Copywriter
fingerprints => Fingerabdrücke
corresponds => korrespondiert; korrespondiert
configuration => Konfiguration; Konfiguration
lump => Klumpen
pester => piesacken
prefect => Präfekt; Präfektin; Präfekt; Präfektin
respectful => respektvoll; respektvoll
hemisphere => Hemisphäre; Hemisphere; Hemisphäre; Hemisphere
symptom => Symptom; Krankheitssymptom; krankheitssymptom; Symptom
edinburgh => edinburg; edinburgh; edinburg; edinburgh
hip => hip; hip
modernize => modernisieren; Modernisieren; Modernisierung; modernisieren
tormented => triezte
transferred => transferierte; transferiert; transferierte; transferiert
depressing => deprimierend
taro => Taro; Taro
applause => Applaus; Applaus
downtime => Downtime; Downtime
claustrophobic => klaustrophobisch; klaustrophobisch
maritime => maritim; marin; maritim
reduction => Reduktion; Reduktion
anastasia => anastasia; anastasia
amputee => Amputierte; Amputierter; amputierte; amputierte
aberrant => aberrant; aberrante; aberrant; aberrante
sympathizers => Sympathisanten; Sympathisantinnen
breathed => geatmet
ambiance => Ambiente; Ambiance; Ambiente; Ambiance
qualifications => Qualifikation; Qualifikation
graduation => Graduierung; Gradeinteilung; Promotion
tolerated => toleriert; tolerierte
anthrax => Anthrax; Anthraknose; Anthrax
instruction => Instruktion; Instruktion
trauma => Trauma; trauma; Trauma; trauma
whistleblower => Whistleblower; Whistleblower
cooperates => kooperiert
femur => Femur; Femur
humming => summend; Summen; Brummen; brummend
prescriptions => Präskriptionen; Präskriptionen
combo => Combo; kombi; Combo; kombi
scotch => schottisch; Scotch; Scotch
inference => Inferenz; Inferenz
toner => Toner; Toner
intervene => intervenieren; eintreten; intervenieren
robotic => roboterhaft
hypnotised => gehypnotisiert; gehypnotisiert
answers => antwortet; antwortet
palate => Palatum
corrosive => korrosiv; korrodierend; korrosiv
gratin => Gratin; Gratinieren; gratinieren; Gratin
napoleon => Napoleondor; Napoleondor
hernia => Hernie; Hernia; hernie; Hernie; Hernia; hernie
assembled => assemblierte; assembliert; assemblierte; assembliert
spatter => spritzen; Spritzer; schwatzen
revised => revidierte; revidiert
greenback => Greenback; Greenback
unkempt => ungekämmt; ungekämmt
visions => Visionen; Vision; Visionen; Vision
alarmed => alarmiert; alarmiert
boxes => Boxen; boxt; boxt
seminary => Seminar; Seminar
revolutions => Revolutionen; Revolutionen
oaks => Oaks; Oaks
ideally => idealerweise; ideell; ideal; ideell; ideal
creek => Creek; Creek
instant => instant; instant
banker => Bankier; Banker; Bankdirektor; Bankhalter; Bank; Bankchef; Bankbeamter; Bankier; Banker
filmmakers => Filmemacher; Filmemacherinnen; Filmemacher
jazz => Jazz; jazzen; jazzmusik; Jazz; jazzen
motivations => Motivationen; Motivationen
run => Run; Run
democrat => Demokrat; Demokratin; demokratisch; Demokrat; Demokratin; demokratisch
monseigneur => monseigneur; monseigneur
cardiovascular => kardiovaskulär; kardiovaskular; kardiovaskulär; kardiovaskular
dinghy => Dingi; Dinghi; Dinghy; Dingi; Dinghi; Dinghy
ruthless => ruchlos; ruchlos
equator => Äquator; Äquator
ulna => Ulna; ulna; Ulna; ulna
mutiny => meutern
shamelessly => schamlos; schamlose
pope => Pope; Pope
baggage => Bagage; Bagage
storming => erstürmend; stürmend; stürmend
comic => komisch; Comic; Komiker; Comicheft; komisch; Comic
urgency => Urgenz; Urgenz
servitude => Servitut; Servitut
hints => Winks
curves => Kurven; Kurven
shite => Scheiße
hamper => hindern
waters => wässert
dopamine => Dopamin; Dopamin
steep => steil
flashlights => Blitzlichter
optic => optisch; optisch
disorganized => desorganisierte; desorganisiert; desorganisiert
demonstrating => demonstrierend; demonstrierend
tau => Tau; Tau
intact => intakt; intakt
israelite => israelit; israelit
jukebox => Jukebox; Musikbox; Musicbox; Jukebox; Musikbox; Musicbox
sportsman => Sportler; Sportsmann; Sportlerin; Sportsmann
contrasts => Kontraste; Kontraste
aortic => Aorten-; aortal; aortisch; Aorta-; aortal; aortisch
flatulence => Flatulenz; Flatulenz
zion => zion; zion
wisteria => Wisteria; Wistarie; Wisteria; Wistarie
articulate => artikulieren; artikuliere; artikulieren; artikuliere
malta => malta; malta
mammal => Mammalia; Mammalier; Mammalia
visually => visuell; visuell
inhales => inhaliert; inhaliert
fund => Fundus
experiences => Experimente; empfindet; Experimente
baggy => Buggy
gangway => Gangway; Gang; Gangway
paneling => Wandbekleidung; Täfelung; paneelierend
antidepressant => Antidepressivum; antidepressiv; Antidepressivum; antidepressiv
implication => Implikation; Implikation
stigma => Stigma; Stigma
promiscuity => Promiskuität; promisker Sex; Promiskuität
either => entweder
upgrade => Upgrade; upgraden; Upgrade; upgraden
beeps => beept; beept
themes => Themen; Themata; Themen
implode => implodieren; implodieren
kickboxing => Kickboxen; Kickboxing; Kickboxen; Kickboxing
raging => rasend
amoral => amoralisch; amoral; unmoralisch; amoral
analysing => analysierend; analysierend
undocumented => undokumentiert; undokumentiert
generate => generieren
papa => Papa; Papi; Papa; Papi
documentaries => Dokumentarfilme; Dokumentarfilme
aggro => aggressiv
barmaid => Bardame; barfrau
velvet => Velvet; Velvet
mosque => Moschee
yankee => Yankee; yankee; Yankee; yankee
sapphires => Saphire; Saphire
paired => paarig; paarweise; paarig
genes => Gene
persia => persien; persien
rebelling => rebellierend; revoltierend; rebellierend
cabinets => Kabinette; Kabinette
por => por; por
overwhelming => überwiegend
arbitrarily => arbiträr; arbiträr
lurk => lauern
bullshitter => Dummschwätzer
exterminator => Exterminator; Exterminator
spared => erspart; gespart
hang => hängen
horoscopes => Horoskope; Horoskope
peer => Peer; Peer
filet => Filet; Filet
tend => tendieren
guaranteed => Garantie; garantiert; garantierte; mit Garantie
san => San; san; San; san
mended => genesen
melodic => melodisch; melodisch
bahia => Bahia; Bahia
splutters => stottert
praises => preist an
untrained => unerfahren
max => max; max
grills => grillt; Grillen; grillt
binds => bindet; bindet
bouillon => Bouillon; Bouillon
satan => Satan; Satan
imagined => imaginär; imaginär
enter => eintreten; eintragen
snickers => kichert
thickness => Dicke
music => Musik
cabaret => Kabarett; Cabaret; Kabaret; Kabarett; Cabaret; Kabaret
guerilla => Guerilla; Guerillakämpfer; Guerillero; Guerilla
strategically => strategisch; strategischer; strategisches; strategisch; strategischer; strategisches
pleading => Verteidigung
proton => Proton; Proton
shh => sch; sch
graviton => Graviton; Graviton
spike => Spitze; Spike; Spike
humbug => Humbug; Humbug
entrusted => vertraute an
bursts => berstet
concede => konzedieren; konzedieren
latex => Latex; Latex
output => Output; Output
undisputed => unbestritten; unumstritten
correct => korrekt; recht; korrekt
intense => intensiv; intensiv
manuscript => Manuskript; Handschrift; Handscrift; handschriftlich; Manuscript; Manuskript; Handschrift; Handscrift; Manuscript
rumbling => rumpelnd
beater => Treiber
lusty => lüstern
cambodian => kambodschaner; kambodschanisch; kambodschaner
violet => violett; Violett; Violet; violett; Violett; Violet
prism => Prisma; prisma; Winkelprisma; Prisma; prisma
emotionless => emotionslos; emotionslos
lymphoma => Lymphom; Lymphom
shinto => Shinto; shintō; Shinto; shintō
numbered => numeriert; nummeriert; numerieren
presence => Anwesenheit; Präsenz; Präsenz
compress => komprimieren; Kompresse; Kompresse
superheroes => Superhelden; Superhelden
portsmouth => portsmouth; portsmouth
evident => evident; evident
oratory => Oratorium
premieres => Premieren; Premieren
mosquitoes => Moskito; Moskitos
melodious => melodiös; melodisch; melodiös; melodisch
carotid => Carotis; Karotis; Carotis; Karotis
beginnings => Beginn
thunk => Thunk; Thunk
mecca => mekka; mekka
basal => basal; basal
dubrovnik => dubrovnik; dubrovnik
spear => Speer
portions => Portionen; Portionen
resume => Resümee
posts => Pfosten; Posten
chica => chica; chica
tonnage => Tonnage; Tonnengehalt; Tonnage
corrupt => korrupt; korrumpieren; korrupt
crepe => Krepp; Crêpe; Crepe; Crêpe; Crepe
perception => Perzeption; Rezeption; Perzeption; Rezeption
munich => münchen
predisposition => physische Konstitution
swastika => Swastika; Swastika
breadwinner => Brotverdiener
hustled => stieß
zaire => Zaire; Zaire
substitute => substituieren; substituieren
nicest => netteste; nettesten
secondary => sekundär; sekundär
illinois => illinois; illinois
paranoia => Paranoia; Paranoia
classmate => Klassenkamerad
militarily => militärisch; militärisch
loyalty => Loyalität; Loyalität
hilton => hilton; hilton
lobbying => Lobbying; Lobbyismus; Lobbying
samoan => samoaner; samoaner
tantalizing => langweilig
partnerships => Partnerschaft; Partnerschaften; Partnerschaft
originally => originell; originell
endings => Endungen
tenor => Tenor; Tenor
gymnasium => Gymnasium; Gymnastikraum; gymnasium; Gymnasium; Gymnastikraum; gymnasium
unwashed => ungewaschen; ungewaschen
myanmar => myanmar; myanmar
untalented => talentlos; untalentiert; untalentiert
shimizu => shimizu; shimizu
punctured => punktiert; punktiert
armenians => armenier; armenier
enclose => einschließen
slung => geschlungen
rebelled => rebellierte; rebelliert; rebellierte; rebelliert
seasonal => saisonal; saisonal
moussaka => Moussaka; Mousakas; Moussaka; Mousakas
twelfth => zwölfte; Zwölftel; Zwölfte; zwölfter; Zwölfter; zwölfte; Zwölftel; Zwölfte; zwölfter; Zwölfter
bonded => gebunden; verbunden
generously => generös
rudy => rudi; rudi
convalescence => Rekonvaleszenz; Rekonvaleszenzzeit; Rekonvaleszenz; Rekonvaleszenzzeit
du => du; du
motto => Motto; Motto
nicknames => Spitznamen; Spitznamen
unrestricted => unbefristet
opportunistic => opportunistisch; opportunistisch
prediction => Projektion; Präkognition
shots => Geschoss
escalator => Eskalation; Eskalation
elasticity => Elastizität; elastizität; Elastizität; elastizität
expansion => Expansion; Expansion
dwarves => dwarves; dwarves
welder => Schweißer; schweißer
fresh => frisch; frech; Frische; frisch; frech
insightful => einsichtig; einsichtsvoll; einsichtsvoll
pyramids => Pyramiden; Pyramiden
tradesman => Handelsmann
sufficient => ausreichend; suffizient; zureichend; suffizient
capitulate => kapitulieren; kapitulieren
picks => pflückt; pickt; Pickel; Picken; pickt
stifle => ersticken
predictable => prädiktabel; prädiktabel
organism => Organismus; Organismen; Organismus; Organismen
constituent => Konstituente; Konstituente
charger => charger; charger
molars => Molar; Molar
barricade => Barrikade; verbarrikadieren; Barrikade
koran => koran; koran
rectum => Rektum; Rectum; Cäcum; Rektum; Rectum
sam => sam; sam
sadists => Sadisten; Sadistinnen; Sadisten
outsource => outsourcen; outsourcen
hungrier => hungriger; hungriger
anesthetic => Anästhetikum; anästhetisch; Anästhetikum; anästhetisch
ouija => Ouija; Ouija
handing => einhändigend
vigilance => Vigilanz; Vigilanz
unpacked => ungepackt; entpackt; unverpackt
ville => ville; ville
fit => fit; fit
manaus => manaus; manaus
thermonuclear => thermokernförmig; thermonuklear; thermonuklear
respective => respektive; respektive
interview => Interview; interviewen; Interview; interviewen
ese => ese; ese
lili => lili; lili
pershing => pershing; pershing
reprogram => umprogrammieren; neu programmieren
commando => Kommando; Kommandotruppe; Kommandosoldat; kommando; Kommando; kommando
incubator => Inkubator; Inkubator
macabre => makaber; makaber
stood => stand
grandson => Grosssohn
adoration => Adoration; Faszination; Adoration
zodiac => Zodiak; Zodiakus; Zodiac; Zodiak; Zodiac
acquisitions => Akquisen; Akquisitionen; Akquisitionen
zealand => seeland; seeland
psychiatry => Psychiatrie; Psychiatrie
hearts => hearts; hearts
ganymede => Ganymed; ganymed; Ganymed; ganymed
medina => Medina; medina; Medina; medina
columbia => columbia; columbia
therapies => Therapien; Therapien
sarcastic => sarkastisch; sarkastisch
conflicts => Konflikte; Konflikte
overall => Overall; Overall
cracks => knackt; kracht; knackt; kracht
soles => Sohlen
jingo => jingo; jingo
isabel => isabella; isabella
leonardo => leonardo; leonardo
sacking => Sackleinen
chemo => Chemo; Chemo
stewardesses => Stewardessen; Stewardessen
worthless => wertlos
defensive => defensiv; Defensive; defensiv; Defensive
bannister => Baluster
rougher => rauher; rauer; roher; rauher; roher
pattern => Muster
sinner => Sünder
zealots => Zeloten
idolatry => Idolatrie; Idolatrie
month => monat
constant => Konstante; konstant; Konstante; konstant
impulsive => impulsiv; impulsförmig; impulsgebend; impulsiv, treibend; impulsiv
apricot => Aprikose; apricot; Aprikose; apricot
firms => Firmen; Firma; Firmen
f => f.
moniker => Moniker; Moniker
network => Netzwerk; Netzwerk
damn => verdammen
especial => speziell; spezial-; speziell; spezial-
forsaken => verlassen
casablanca => casablanca; casablanca
marbles => Marbeln
notary => Notar; Notarin; Notare; Notar; Notare
synthesize => synthetisieren; synthetisieren
posting => Notiz
everyone => jedermann
schilling => Schilling; Shilling; Schilling; Shilling
benzene => Benzol; Benzen; benzol; Benzen; benzol
shudder => Schauder; schaudern
inhuman => inhuman; inhuman
tunisian => tunesier; tunesisch; tunesier
sole => Sohle; Fußsohle; besohlen
shard => Shard; Shard
significance => Signifikanz; Signifikanz
wondrous => wundersam; wunderbar
redwood => redwood; redwood
planets => Planeten; Planeten
traumatised => traumatisiert; traumatisierte; traumatisiert; traumatisierte
choreographer => Choreograph; Choreograf; Choreographin; Choreografin; Choreograph; Choreograf; Choreographin; Choreografin
exponentially => exponentiell; exponenziell; exponentiell; exponenziell
obligatory => obligatorisch; obligat; obligatorisch; obligat
archeologist => Archäologe; Archäologin; Archäologe; Archäologin
cruises => Seereisen
log => Log; Log
toxin => Toxin; Toxin
pertinent => geeignet
croutons => Croutons; Croûtons; Croutons; Croûtons
hose => Hose; Hose
weighty => gewichtig; wichtig
spasms => Spasmus; Spasmus
is => ist; Kies; ist
scalpels => Skalpelle; Skalpelle
sommelier => Sommelier; Sommelière; Sommelier; Sommelière
sceptre => Zepter; Szepter; Szepter
authoritarian => autoritär; autoritativ; autoritär; autoritativ
ethiopia => aethiopien; äthiopien; aethiopien; äthiopien
ethereal => ätherisch; etherisch
demolishing => demolierend; demolierend
aversion => Aversion; Aversion
samaritan => samariter; samariter
pizza => Pizza; Pizzas; Pizzen; Pizza; Pizzas
slaughtered => schlachtete; schlachtete ab
graduates => Graduierte; Graduierten; Graduierten
paternity => Paternität; Vater; Vatertier; paternitaet; Paternität; paternitaet
materialize => materialisieren; materialisieren
endorphins => Endorphin; Endorphine; Endorphin; Endorphine
unbecoming => ungehörig
cube => Cube; Cube
collided => kollidierte; kollidiert; kollidierte; kollidiert
dorado => Dorade; Dorade
bankruptcy => Bankrott; bankrott
restored => restauriert; restaurierte
neutralise => neutralisieren; Neutralisation; neutralisieren
diazepam => Diazepam; Diazepam
unfair => unfair; unlauter; Unfairness; unfair
motherly => mütterlich
exhumed => exhumiert; exhumierte; exhumiert
scrubbing => schruppend
jacob => jakob; jakob
spectacularly => spektakulär; spektakulär
pressure => Pressen; Pressen
momentary => momentan; momentan
happening => Happening; Happening
biohazard => Biohazard; Biohazard
identified => identifiziert; identifizierte; identifiziert; identifizierte
spray => Spray; sprühen; Spray
respects => respektiert; respektiert
dilated => dehnte; dehnte
yucatan => yucatán; yukatan; yucatán; yukatan
yugoslav => jugoslawe; jugoslawisch; jugoslawe; jugoslawisch
varying => variiert; variierend; variiert
fissure => Riss
abandonment => Abandon
arms => Arme; Arme
task => Task; Task
russell => russell; russell
blinker => Blinker; Blinker
mustered => gemustert
electrocute => elektrokutieren; elektrokutieren
scare => Schreck
trampled => getrampelt; trampelte; zertrampelt; zertrampelte; trampelte
elizabeth => elisabeth; elizabeth; elisabeth; elizabeth
metz => metz; metz
modify => modifizieren
psychotherapy => Psychotherapie; Psychotherapie
decimate => dezimieren; dezimiere; dezimiere
taff => taff; taff
legitimize => legitimieren; legitimieren
routing => Routing; Sortierung; Routing
incontinence => Inkontinenz; Inkontinenz
keystone => keystone; keystone
oral => oral; oral
verbal => verbal; verbal
brunch => Brunch; brunchen; Brunch; brunchen
halle => halle; halle
prepare => präparieren; präparieren
convertible => konvertierbar; konvertierbar
larissa => larisa; larisa
neutron => Neutron; neutron; Neutron -s; Neutron; neutron
pissing => pieselnd; pissend; pissend
dram => Dram; Drachme; Drum; Durham; Dram
watt => Watt; watt; Watt; watt
complicated => kompliziert; komplex; Kompliziertheit
habitats => Habitat; Habitat
kid => Kind
cla => cla; cla
partial => parteiisch; partiell; partiell
casket => Kassette
standardized => standardisiert; standardisierte; Standard; standardisiert; standardisierte
curveball => Curveball; Curveball
circulation => Zirkulation; Rotation; Zirkulation
rites => Riten
plutonium => Plutonium; Plutonium
april => april; april
elysium => elysion; elysium; elysion; elysium
landless => landlos; landlose; landlos; landlose
patriot => Patriot; Patriotin; Patriot; Patriotin
romanian => rumänisch
boss => Boss; Boss
acceptance => Akzeptanz; Akzeptanz
continental => kontinental; continental; kontinentaleuropäer; kontinental; continental
deposit => deponieren
alerting => Alarmierung; alarmierend
perennial => perennierend
irrigation => Irrigation; Irrigation
puritan => puritanisch; Puritaner; Puritanismus; puritanisch; Puritaner
ermine => Hermelin; Hermelinfell; Hermelinpelz
princes => Prinzen
gerry => gerry; gerry
pizzeria => Pizzeria; Pizzeria
kitchens => Küchen
vincent => vinzenz; vinzenz
westbound => westwärts
narcissist => Narzisst; Narziss; Narzisstin; Narzisst
transmitters => Übermittler
seizing => Zeising; Zeising
dots => Dots; Dots
confession => Konfession; Konfession
millimeter => Millimeter; Millimeter
exclusive => exklusiv; Exklusivmodus; exklusive; exklusiv; exklusive
nitroglycerin => Nitroglyzerin; Nitroglycerin; Trinitroglycerol; Nitroglyzerin; Nitroglycerin; Trinitroglycerol
scandinavia => skandinavien; skandinavien
greet => grüßen
toxic => toxisch; Toxikum; toxisch
tinfoil => Zinnfolie
kalashnikov => kalaschnikow; kalaschnikow
peroxide => Peroxid; Superoxyd; Peroxide; Peroxyd; peroxide; Peroxid; Peroxide; Peroxyd; peroxide
idols => Idole; Idols; Idols
abnormally => abnorm; unnormal; anomal; abnormal; anormal; abnormal; anormal
forearms => Unterarme; Vorderarme; Vorderarme
ha => ha; ha
thicker => dicker; dicker
stinking => stinkend; stinkig; Stinker; stinkend; stinkig; Stinker
warm => warm; wärmen; warm; wärmen
boston => boston; bostoner; boston; bostoner
institute => Institut; instituieren; initiieren; Anstalt; Institut; instituieren
authorisation => Autorisierung; Autorisation; Autorisation
bengali => bengale; bengali; bengalisch; bengale; bengali; bengalisch
hooliganism => Hooliganismus; hooligan; Hooliganismus; hooligan
pump => Pumpe; pumpen; aufpumpen; Pumps; Luftpumpe; Pump; pumpen; Pump
unattractive => unattraktiv; unattraktiv
regiments => Regimente; reglementiert; Regimente
dionysus => dionysos; dionysos
pharmaceutical => pharmazeutisch; pharmazeutischen; pharmazeutisch; pharmazeutischen
hospitalization => Hospitalisierung; Hospitalisieren; Hospitalisiertwerden
abysmal => Abyssal; Abyssal
tamper => Stampfer; Stampfer
absurdity => Absurdität; Absurdität
ale => Ale; Ale
linguist => Linguist; Linguistin; Linguist; Linguistin
odysseus => odysseus; odysseus
hallucinations => Halluzinationen; Halluzinationen
argentinian => argentinier; argentinierin; argentinier; argentinierin
uncertain => unbeständig; ungewiß
ratchet => Ratsche
rationalize => rationalisieren; Rationalisierung; rationalisieren
shampoo => Shampoo; schamponieren; Schampon; Schampu; Schampus; shampoonieren; Schampun; Shampoo; Schampon
gave => gab; gab
pollock => Pollack; Pollack
moira => moira; moira
catheter => Katheter; Katheter
unsympathetic => unsympathisch; unsympathisch
stereotypical => stereotyp; stereotypisch; stereotyp; stereotypisch
reversible => reversibel; reversierbar; reversibel; reversierbar
mush => Mus
magistrate => Magistrat; Magistrate; Magistrat; Magistrate
rolf => rolf; rolf
brushes => bürstet
ordeal => Ordal; Ordal
penguins => Pinguin; Pinguine; Pinguin; Pinguine
coquette => Kokette; kokett; Kokette; kokett
propofol => Propofol; Propofol
plot => Komplott; Plot; plotten; Plot
lynch => lynchen; lynch; lynchen; lynch
plagiarism => Plagiat
orpheus => orpheus; orpheus
spaniard => spanier; spanierin; spanier; spanierin
leaks => Lecks; leckt
tightness => Dichtheit; Dichte
nymphomaniac => Nymphomanin; nymphoman; nymphomanisch; Nymphomanin; nymphoman; nymphomanisch
nanjing => nanking; nanking
kurdish => kurdisch; kurdisch
chorus => Chor; Chorus; Chorus
hugh => hugo; hugo
retrograde => retrograd; retrograd
brew => brauen
peering => Peering; Peering
positions => Positionen; positionen; positioniert; Positionen; positionen; positioniert
airport => Airport; Airport
citations => Zitate
sentimental => sentimental; emotional; sentimental
argued => argumentiert; dargelegt
barricaded => verbarrikadierte; verbarrikadiert
owen => owen; owen
settler => Siedler; Ansiedler
thanksgiving => Danksagung; thanksgiving; thanksgiving
trent => trient; trient
hebrew => hebräer; hebräisch; hebräer
disciplinary => disziplinarisch; disziplinär; Disziplinar-; disziplinarisch; disziplinär; Disziplinar-
seeding => Seeding; säend; Seeding
tig => tig; tig
endorsing => Indossierung; indossierend
divas => Divas; Divas
agnes => agnes; agnes
favoured => favorisiert
diagnostics => Diagnostik; Diagnose; diagnostisch; Diagnostik; diagnostisch
imagine => meinen
wei => wei; wei
emphasis => Emphase; Emphase
profiling => Profilierung; profilierend; Profiler; Profilerstellung; Profilierung; profilierend; Profiler
segment => Segment; segmentieren; Segment
willingly => willig; willig
yeti => Yeti; Yeti
lighten => erleichtern; erleuchten; leichtern; blitzen; Leichterung; bleichen; erleichtern; leichtern; bleichen
amateurs => Amateure; Amateurinnen; Amateure
triggering => Triggern; Triggern
creditor => Kreditor; Kreditgeber; Kredit; Kreditor; Kredit
texan => texaner; texanerin; texaner
paralytic => paralytisch; paralysieren; Paralytiker; paralytisch; Paralytiker
odyssey => Odyssee; Odyssee
terracotta => Terrakotta; Terracotta; Terrakottafigur; Terrakotta; Terracotta
domicile => Domizil; Domizil
explosion => Explosion; Explosion
wins => gewinnt
fled => floh; fliehen
disintegrate => desintegrieren; disintegrieren; desintegrieren; disintegrieren
threaten => vorwerfen
clubhouse => Klubhaus; Clubhaus; Klubhaus; Clubhaus
underdog => Underdog; Underdog
pistols => Pistolen; Pistolen
basel => basel; basel
psychopaths => Psychopathen; Psychopathinnen; Psychopathen
flaccid => lasch
buttery => butterweich; butterartig
bondage => Bondage; Bondage
neonatal => neonatal; neonatal
manticore => Mantikor; Manticor; Mantikor; Manticor
chillies => Chilly
resistance => Resistenz; Resistenz
manipulates => manipuliert; manipuliert
celebrating => zelebrierend
impotent => impotent; Impotenter; impotente; impotent; Impotenter; impotente
dunkirk => dunkerque; dünkirchen; dünkirchen
hey => he; ey; he; ey
reborn => wiedergeboren
clumps => Klumpen
ghoulish => greulich; gräulich; greulich; gräulich
islamabad => islamabad; islamabad
chimpanzee => Schimpanse; Schimpansen; Schimpanse; Schimpansen
paraguayan => paraguayisch; paraguayisch
evermore => immerfort
confetti => Konfetti; Konfekt; Konfetti; Konfekt
routes => Routen; Fahrtrouten; Marschrouten; Routen
pervasive => pervasiv; pervasiv
erin => erin; erin
putt => putten; Putt; putten; Putt
kgb => kgb; kgb
spoke => Sprosse
tourism => Tourismus; Touristik; tourismus; Tourismus; tourismus
handy => handlich; handsam
pram => Prahm; Pram; Pram
nicholas => nikolaus; nikolaus
liven => beleben
backgammon => Backgammon; backgammon; Backgammon ''n'' -s; Backgammon; backgammon
badminton => Badminton; Badminton
incorrect => inkorrekt; inkorrekt
polygraph => Polygraph; Polygraph
freakish => freakig; freakig
striker => Stürmer; Streikende; Streikender; Angreifer
formula => Formel; Formalitat; Formular; Formular
photographic => fotografisch; photographisch; photografisch; photographisch; photografisch
wahoo => wahoo; Wahoo; wahoo; Wahoo
handwriting => Handlinien
speciality => Spezialität; Spezialfach; Spezialgebiet; Spezialität
humorous => humorvoll; humoristisch; humorig; humorvoll; humorig
arctic => arktisch; arktis; Arktis; arctisch; arktisch; arktis; Arktis; arctisch
headstrong => halsstarrig
degrading => degradierend; degradierend
megalomaniac => megaloman; Megalomane; megaloman; Megalomane
roderick => roderick; roderick
cirrhosis => Zirrhose; Zirrhose
riga => riga; rigaer; riga; rigaer
paralysed => paralysiert; paralysiert
tranquilizers => Tranquilizer; Tranquilizer
tangier => tanger; tanger
bigger => wichtiger
nymphs => Nymphe; Nymphen; Nymphe
oncologist => Onkologe; Onkologin; Onkologin
tipped => kippte; kippte
filipino => filipino; philippiner; philippinisch; filipino
pumping => Pumpen; pumpend; Abpumpen; pumpend
subtract => subtrahieren
weber => Weber; Weber
yardstick => Zollstock; Zollstock
veracity => Geradheit
immunity => Immunität; immunität; Autoimmunität; Immunsystem; Immunität; immunität; Autoimmunität
smutty => schmutzig
precaution => Prävention
complicates => kompliziert
mimes => mimt
prioritize => priorisieren; prioritisieren; priorisieren; prioritisieren
chute => Schurre; Schuss; Schütte
checks => Schecks; Schecks
pseudo => Pseudo...
informed => informiert; informierte; informiert; informierte
demonstrates => demonstriert; demostrieren; demonstriert
single => Single; einzeln; single; Single; single
armada => Armada; Armada
norse => nordisch
auld => alt
shelf => Schelf; Schelf
jung => young
haemorrhage => Hämorrhagie; Hämorrhagie
seed => säen; setzen; säen
oligarchs => Oligarchen; Oligarchen
proved => erproben; prüfen
snobs => Snobs; Snobs
cherub => Cherub; Kerub; Cherubim; Cherub; Kerub; Cherubim
galley => Galeere; Galley; Galley
shaman => Schamane; Schamanin; Schamane
manifests => manifestiert; manifestiert
cacophony => Kakophonie; kakophonie; Kakophonie; kakophonie
secular => säkular; säkular
canon => Kanon; Kanoniker; Canon; Kanon; Canon
te => te; te
incarnation => Inkarnation; Inkarnation
bangladesh => bangladesch; bangladesh; bangladesch; bangladesh
hygienic => hygienisch; hygienisch
brigade => Brigade; Brigade
ding => Ding; Ding
pancreas => Pankreas; Pankreas
signpost => Signalposten
zephyr => Zephir; Zephyr; Zephir; Zephyr
clerics => Kleriker; Kleriker
penny => Penny; Pfennig; Penny
electromagnetism => Elektromagnetismus; elektrodynamik; Elektromagnetismus
hyperventilating => hyperventilierend; hyperventilierend
transmissions => Transmissionen; Transmissionen
mystique => Mystik
sikh => sikh; sikh
utah => utah; utah
luau => Luau; Luau
landscaper => Landschaftsgärtner
bengal => Bengal-Katze; bengalisch; bengalen; bengalen
trimming => Trimmen; Trimmung; Trimmen; Trimmung
refrain => Refrain; refrain; Refrain; refrain
wildcat => Wildkatze; wild; Wildkatze
recites => rezitiert; rezitiert
bachelor => Bachelor; Bachelor
bulb => Bulbus
lick => lecken
synchronization => Synchronisierung; Synchronisation; synchronisation; Prozesssynchronisation; Synchronismus; Synchronisation; synchronisation; Prozesssynchronisation
fifth => fünfte; fünfter; fünftel; fünftes; fünfte
chihuahua => Chihuahua; Chihuahua
lucrative => lukrativ; lukrativ
suites => Suiten; Suiten
cascade => Kaskade; kaskadieren; Kaskade; kaskadieren
scratched => kratzte
magically => magisch
delicacies => Delikatessen; Zierlichkeiten
stamping => Stampfen; einstampfend; Stampfen
monorail => Monorail; Monorail
zoo => Zoo; Zoo
phallic => phallisch; phallisch
explain => explizieren
euphoric => euphorisch; Euphorie; euphorisch; Euphorie
amphitheater => Amphitheater; Amphitheater
motorcycle => Motorroller
precision => Präzision; Präzision
scariest => erschreckenste
bottle => Bouteille
perfidious => perfide; perfid
etiquette => Etikette; Etikette
orchestrating => orchestrierend; orchestrierend
corresponded => korrespondiert; korrespondierte; korrespondiert; korrespondierte
windward => windwärts; windwärts
catalyst => Katalysator; catalyst; Katalysator; catalyst
magnet => Magnet; Magnet
uzbekistan => usbekistan; republik usbekistan; usbekistan
partially => partiell; partiell
mascara => Mascara; Maskara; Mascara; Maskara
palladium => Palladium; Palladium
scenario => Szenario; Szenarium; Szenario; Szenarium
women => Damen
intelligence => Intelligenz; intelligentes Leben; Intelligenz
ocular => Okular; okular; Okular; okular
irrational => irrational; Irrationalität; irrational; Irrationalität
decorations => Dekorationen; Dekorationen
snowflake => Schneeflocke
quotient => Quotient; Quotient [math.]; Quotient
militant => militant; militärisch; militant
catharsis => Katharsis; Katharsis
veterinarian => Veterinär; Veterinärin; Veterinärin
judaism => judaismus; judaismus
disproportionate => überproportional; überproportional
problematic => problematisch; Problematik; problematic; problembehaftet; problematisch; Problematik; problematic
browsing => Browsen; Browsen
slavs => slawen; slawen
moderate => moderat; moderieren; moderat
milkman => Milchmann; Milchmann
nerve => Nerv; Nerv
conglomerate => Konglomerat; konglomerat; Agglomerat; Konglomerat; konglomerat; Agglomerat
gallstones => Gallensteine; Gallensteinleiden
escapade => Eskapade; Eskapade
neutrino => Neutrino; neutrino; Neutrino; neutrino
camellia => Kamelie; Camellia japonica; kamelien; Kamelie; kamelien
tranquilizer => Tranquilizer; Tranquiliser; Tranquilizer; Tranquiliser
cobras => Kobra; Kobras; Kobra; Kobras
aladdin => aladdin; aladin; aladdin; aladin
framework => Fachwerk; Rahmenwerk
legion => Legion; Legion
tractors => Traktoren; Traktoren
deposits => Depositen; Depots; Depositen; Depots
jumbo => Jumbo; Jumbo-Jet; Jumbo
cocoons => Kokon
santorini => santorin; santorin
meaner => gemeiner; gemeiner
uranus => Uranus; uranos; Uranus; uranos
aquitaine => aquitanien; aquitanien
rusty => rostig
implications => Implikationen; Denotation; Implikationen
photograph => Fotografie; Fotographie; Photographie; photographieren; Fotographie; Photographie; photographieren
continual => kontinuierlich
speedometer => Tachometer
midterm => Mitte
matthew => matthäus; matthias; matthäus; matthias
stimulants => Stimulans; Stimulantia; Stimulanzien; Stimulans; Stimulantia
leda => leda; leda
groups => gruppen
pajamas => Pyjama; Pyjamas; Pyjama; Pyjamas
perspective => Perspektive; perspektivisch; Perspektive; perspektivisch
saboteurs => Saboteure; Saboteurinnen; Saboteure
service => Service; Service
predisposed => prädisponiert; prädisponierte; prädisponierten; prädisponiert; prädisponierte
articulated => artikulierte; artikulierten; artikuliert; artikulierte; artikulierten; artikuliert
ricotta => Ricotta; Ricotta
macaroni => Makkaroni; Makaroni; makkaroni; Makkaroni; Makaroni; makkaroni
england => England; england; England; england
boomerang => Bumerang; Bumärang; boomerang; Bumerang; boomerang
analyzed => analysiert; analysierte
cultivated => kultiviert; kultivierte; kultivierte
banger => Knaller; Kracher
migrated => migriert
nastiness => Garstigkeit
milwaukee => milwaukee; milwaukee
winnipeg => winnipeg; winnipeg
tobacco => tabak; tabak
petition => Petition; Petition
lz => lz; lz
motorbike => Motorrad
files => Files; Feilen; Files
reputable => reputabel; reputierlich; reputabel
souvenir => Souvenir; lokales Souvenir; Souvenir
leathery => ledern
boyfriend => Boyfriend; Boyfriend
strangler => Würger
slick => Slick; geleckt; Slick
yearbook => Jahrbuch
cracow => krakau
cyclical => zyklisch
novelty => Novität
utter => äußern
fostered => förderte