sms => sms
kassi => cassia
emma => emma
skalpi => scalp
ununterbroch => uninterrupted
tell => teller
reicht => reached
experimenti => experiment; experimentation
russell => russell
loslass => let loose; loose
diesel => diesel
normalisi => normalize; normalise; nomalize
dank => thanks; thank
amen => amen
hall => halle
chaos => chaos
fellow => fellow
blut => blood; bled
solid => solid
liquidi => liquidate
dido => dido
reprasentiert => represented; represents
nist => nest
gold => golden; gold
ehe => ere
moment => moment; momentum
potenziell => potential; potentially
gabriel => gabriel
sudkorea => south korea
pur => pure
fanat => fanatical; fanatic
division => division
kain => cain
pflug => plough; plow
massag => massage
formi => form
abbind => bind
primitiv => primitiv; primitive
sinkend => sinking
revidi => revise; review
gesturmt => stormed
junction => junction
streb => strive
pedant => pedantic; pedanticly
rhetor => rhetoric
konsequent => consistent; consequential; consequently; consequent
lloyd => lloyd
streif => streak; stripe
minos => minos
arthur => arthur
vinzenz => vincent
deaktivi => deactivate
komite => committee
tar => tar
filip => philip
schizophreni => schizophrenia
goo => goo
paris => paris; parisian
animal => animal
kgb => kgb
streu => strew; strewn
kniet => kneed; knelt
josephin => josephine
konventionell => conventional; conventionally; Conventional
stella => stella
fullt => filled
variiert => varied; variegated; varies
scharf => sharper
gloria => glory
grau => gray
edgar => edgar
elektron => electronically
signalisi => signal; signalize; to signalise
halbnackt => half-naked; half naked
belad => load
just => just
meth => meth
jung => younger; youngest
taipeh => taipei
praktiziert => practises; practiced; practised
nina => nina
ankara => ankara
herzlos => heartless; heartlessly
aha => aha
rov => rover
darfur => darfur
drosseln => throttle
erleuchtet => enlightened; enlightens; lighted
freigeb => free
nervt => nerves
schul => school
rac => racer
fettig => fatty; fattily
gouda => gouda
chevy => chevy
rabbin => rabbi
bericht => right
platon => plato
operativ => operative; operational; operatively
chil => chile
trust => trust
klaustrophob => claustrophobic
kibbuz => kibbutzim
wandeln => wander
circa => circa
stampft => stamps
mikroskop => microscope
roug => rouge
christlich => Christian; christian; Christianly
afghanistan => afghanistan
kompliziert => complicated
wortwort => word for word; word-for-word
dao => tao
berat => debate
schmelz => melt; smelt
ram => ram
eleonor => eleanor
luth => luther
viktoria => victoria
fit => fit
apropos => apropos
horizontal => horizontal; horizontally
renoviert => renovated; renovates; redecorated
schein => shine
disqualifiziert => disqualifies; disqualified
interagi => interact
immunitat => immunity
dalton => dalton
tanz => dancer; dance
mental => mental; mentally
liliputan => lilliputian
delta => delta
guardian => guardian
brown => brown
uganda => uganda
mai => may
konzentri => concentrate
sortiert => assorted; sorted; sorts
flattert => flitters; flutters; flits
budap => budapest
kommando => commando
chip => chip
wind => wind
obszonitat => obscenity
bakteriell => bacterially
mystisch => mystical
gefesselt => fettered
konstrui => construct; construe
sensibilitat => sensitivity
sir => siren
atmosphar => atmospherical
kultivi => cultivate; culture
rush => rush
ident => identical; identic
brabbelt => gabbles
genagelt => nailed
pikant => piquant; poignant
verblendet => blended; blinded
schubs => shove
jason => jason
turk => turk
zuvor => before; afore
telegrafiert => telegraphed
us => us
galahad => galahad
delikat => delicate
goliath => goliath
malmo => malmo
mandat => mandate
riski => risk
kultiviert => cultured; cultivated; cultivates
zur => to
geformt => formed
relativ => relative; relatively
sodom => sodom
ublich => usually
gesetzt => sedate; seated
theoret => theoretical; theoretic; theoretically; theoreticly
atropin => atropine
samuel => samuel
ruth => ruth
adelaid => adelaide
sack => sack
maki => maki
lehnt => leaned; leant
einpack => pack
ol => ol
stinkreich => stinking rich
japp => yup
granit => granite
legend => legend
monaco => monaco
entleert => depleted
scharft => sharpens
rio => rio
fuji => fuji
eingekerkert => incarcerated
dumbo => dumbo
ethisch => ethical; ethic; ethically
unterwandert => undermined
spendi => spend; to spend
packt => packs
montreal => montreal
simuliert => simulated; simulates
skandalos => scandalous; scandalously
relevant => relevant
undercov => under; undercover
synagog => synagogue
bangladesch => bangladesh
faszini => fascinate
isoliert => insulated; isolated
furchtbar => formidable
unternehm => intend
doppelgang => doppelgangers; doppelgängers
orientiert => oriented; orientates; orientated; orients
produktivitat => productiveness
last => last
indian => Indian; indian
selb => self; itself; myself
superb => superb
dito => ditto; dito
manipuliert => manipulated
ariel => ariel
hanoi => hanoi
stoppt => stops
halbiert => halved; halves
onion => onion
einschreib => inscribe
massig => massive; massy; mass
emboli => embolism
nord => north
bogotá => bogotá
telegraph => telegraph
qualifiziert => qualified
regeneriert => regenerates; regenerate; regenerated
hongkong => hong kong
vorwarn => forewarn
mission => mission
schockier => shocking
sydney => sydney
archimed => archimedes
bib => biber
isa => isa
erreicht => reached
impulsiv => impulsive; impulsively
global => global; globally
industriell => industrially
regal => regal
schick => chic
sozial => social; societal; socially
schleimig => slimly
paddeln => paddle
thema => theme
kritisch => critical; crucial; critically; sceptical
bibliothek => bibliothek; bibliotheca
blami => blame
control => control
zwo => two
eskaliert => escalates
trunk => trunk
befindet => finds
apart => apart
spanierin => spaniard
pathologi => pathology
test => test
delhi => delhi
komplex => complex; complexly
muslim => muslim
national => national
ostwart => eastward; eastwards
unbezahlbar => invaluable
wyoming => wyoming
volt => volts
gibbon => gibbon
elias => elijah
einlad => load
eroffnet => opened
bambi => bambi
scratch => scratch
amputi => amputate
chamaleon => cameleon
graham => graham
gas => gas
miaut => miaows; miaoued; miaous; miaowed
aquarius => aquarius
sahara => sahara
ubertreib => overdo
testet => tests
melissa => melissa
tort => torte
positioniert => positioned; positions
ludlow => ludlow
reprasenti => represent; represents
amerikan => american; americans
solo => solo
realisi => realize; realise
boarding => boarding
unkontrollierbar => uncontrollable; uncontrollably
achtzig => eighty
geschwarmt => swarmed
anti => anti
kollidi => collide
net => not
addiert => added; added up
plundert => plunders
tanzt => dances
horst => horst
produziert => produced; produces
bewein => bewail
thorn => thorn
koordini => coordinate
operator => operator
libanon => lebanon
knietief => knee-deep
mumbai => mumbai
credit => credit
commonwealth => commonwealth
einflussreich => influential
uberblick => overlook; overview
unbestand => unstable; unsteady
west => west
unpartei => impartial; nonpartisan
eingetret => entered
kompromittiert => compromised
stabil => stable
delphin => dolphin
beleucht => light
lucretia => lucretia
ratt => rat
uberlastet => overcharged; overload; overloaded; overloads
birma => burma
synthet => synthetic; synthetical; synthetically
els => else
gail => gail
atrium => atrium
beaujolais => beaujolais
effizient => more efficient
minimi => minimize; minimise
diktatur => dictatorship; dictate
haitian => haitian
fatal => fatal
melbourn => melbourne
bah => bah
sc => sc
te => te
delegiert => delegated
breit => spread
spezif => specific
toleriert => tolerated; tolerates
phoenix => phoenix
bounty => bounty
monti => mount
tschechi => czechia
kapituli => capitulate
awesom => awesome
bindung => bonding; linking
simpel => simple; simply
liebend => loving; lovingly
halb => half
zink => zinc; zink
am => am
rebelliert => rebelled; rebels; revolted
vortex => vortex
etabliert => established
geblutet => bled; bleeded
meditiert => meditates; meditated
besprech => bespeak
uberrumpelt => overpowers
indiana => indiana
uberlast => overload; overwork; overtax
rezitiert => recites; recited
kalkuliert => calculated
sollt => should
damon => demonic
pfund => pound; pounds
geschnappt => snaped
bermudas => bermuda; bermudas
angus => angus
fick => fuck
penicillin => benzylpenicillin
spann => spun
gottin => göttin
arminius => arminius
find => find
hofft => hoped
beaumont => beaumont
form => form
brit => brit; briton
ihm => him
knick => crack
lincoln => lincoln
phras => phrase
bildung => breeding
schrill => shrill
wu => wu
medizin => medical; medicinal; medic; medicinally; medicated
schrubb => scrub
blutend => bleeding; bloodied
konrad => conrad
adoptiert => adopted
skrupellos => unscrupulous
fred => fred
objektiv => objectively
konservi => conserve
manovriert => maneuvers; maneuvered
yin => yin
unorthodox => unorthodox; nonorthodox; unorthodoxly; non-orthodox; unorthodoxy
gesegelt => sailed
katholikin => catholic
omaha => omaha
inkognito => incognito
bulldog => bulldog
synapt => synaptic
persi => persia; persian
wandelt => changed
zufall => casually
barbara => barbara
anastasia => anastasia
bass => bass
lebt => lived
teuerst => dearest
technicolor => technicolor
wolga => volga
extraktion => extraction
vermont => vermont
bitterkalt => bitterly cold
deserti => desert; defect
scharlach => scarlet
kaschmir => kashmir
grob => gruff
rock => rock
mem => mem
grund => found
defekt => defective; defect
filz => felt
geoffnet => opened
sinnlos => senseless; pointless; mindless
infiltri => infiltrate
enigma => enigma
anfecht => appeal
metaphor => metaphorical; metaphoric
mel => mel
rhythmisch => rhythmically
gereicht => reached
enkel => ankle
macon => macon
klassisch => classical; classic; classically
dekadenz => decadency
sparta => sparta
romant => romantic
po => po
dankend => thanking
gestolpert => stumbled
konfuzius => confucius
uninteressant => uninteresting; uninterestingly
grand => grand
entflammt => inflamed
isaak => isaac
mimi => mimi
fixi => fix
salutiert => salutes; saluted
august => august
sexuell => sexual; sexually
lacht => laughs
itali => italy
chanukka => chanukah; hanukah
denunzi => denounce; denunciate
geordnet => sorted
gesponn => spinned; spun
allerg => allergic
sektion => section
leo => leo
terpentin => turpentine
individuell => individuals
geschnuffelt => snuffed; snuffled
herm => hermes
weis => wiser
ukrain => ukraine
stinkend => stinking; stinky
contain => container
begann => began; begun
hierfur => therefore; therefor
provinz => province
zugreif => to grip
applaudi => applaud
pipelin => piping
nobl => nobler
dat => date; data
human => humane; human; humanely
subtil => subtle; subtly; subtile
berni => bernie
first => first
rezeption => receptionist
ideal => ideal; ideally
de => de; dee
initiiert => initiated
schwind => shrink
oregon => oregon
destabilisi => destabilize; destabilise
mistress => mistress
maschin => machine
bora => bora
superintendent => superintendent
woll => will; woolly
london => london; londoner
pyramid => pyramid
flieh => flee
kopf => top
unbezwingbar => invincible
lukas => luke
punkt => points
deponiert => deposites; deposited
pontifex => pontifex
scheut => eschews
sabrina => sabrina
interpreti => interpret
pap => pap
port => porter
drastisch => drastic; drastically; radical
kompensi => compensate
krypton => krypton
ministerium => ministry
koordiniert => coordinately; coordinated; coordinates
tun => do
wank => waver
grant => grant
flott => afloat
argument => argument
dahint => behind
peer => peerage
denkt => thinks
brau => brew
chuck => chuck
leb => live
schokolad => chocolate
optimist => optimistic; optimistically
egoist => egoistic; egotistic; egoistical; egotist; egotistical
angestiftet => instigated
bereitwill => readily
abtrenn => abstain
klara => clara; clare
projiziert => projected; projects
mantl => mantle
realisiert => realizes; realised; realized
park => park
reaktivi => reactivate
elan => elan
gegrundet => grounded
metamorphos => metamorphosis
modern => modernest
spritzt => sprayed
permanent => permanent; permanently
bronco => bronco
glitzert => glistens; glitters
jiddisch => Yiddish; yiddish
kurdisch => Kurdish; kurdish
gefuhlvoll => soulful
vanill => vanilla
kritisiert => criticizes; criticised; criticises; criticized; critiqued; critiques
boykott => boycott
observi => observe
ciao => ciao
ruini => ruin
pongo => pongo
monogami => monogamy
typisch => typical
magic => magic
homecoming => homecoming
banal => banal; banally
uberlad => overload
taiwan => taiwan
hackt => hacked
argos => argos
karussell => carrousel
telefoni => telephone
rattert => clatters
alabama => alabama
aussorti => assort
clean => clean
fabian => fabian
reguliert => regulated; regulates
hudson => hudson
kairo => cairo
paranoid => paranoidal
bakteri => bacterium; eubacteria
guinness => guinness
big => big
saboteur => saboteur
findet => finds
weston => weston
moe => moe
eingang => entrance
oktopus => octopuses
softwar => software
nil => nile
amerika => americas; america; amerika
salom => salome
polizei => police
bridget => bridget
sex => sex
lang => longest
augsburg => augsburg
sorti => sort; assort
nevada => nevada
befund => found
burma => burma
massiert => massages; massaged
fakultat => faculty
bra => bra
makkaroni => macaroni
neugebor => newborn; new-born; new born
pass => pass
taylor => taylor
mik => mike
boeing => boeing
dvd => dvd
evolution => evolution
befreiend => freeing
bindet => binds
dezimiert => decimates; decimated
kochend => boiling; cooking; lolling
fragil => fragile
wai => wai
gebor => born; borne
meschugg => meshugge; meshuga; meshugah; meshuggah; meshugga
kar => karen
mordechai => mordecai
chemisch => chemical; chemically; chemistry
kontamination => contamination
spezifizi => specify
blockad => blocking
natur => natural; native
triumphiert => triumphs; triumphed
lamas => lama
kolumbi => colombia
geblinzelt => blinked
gesponsert => sponsored
pjongjang => pyongyang
kredit => credit
international => international; internationally
hi => hi
georgi => georgia
blutlini => bloodline
anal => anal; anally
alarmiert => alarmed; alert; alerted
beantwortet => answered
injektion => injection
wartet => waited
kompromisslos => uncompromising
fleet => fleet
top => top
magnesium => magnesium
harmon => harmonical
konstruiert => constructs; construes; constructed; construed
rud => rude
kommentiert => commented; comments
schreiend => crying; screamingly
formlich => formal; formally
surf => surf
korsika => corsica
dupont => dupont
wichita => wichita
manovri => maneuver; manoeuvre; maneuvering
murr => murmur; mutter
collin => collins
glasgow => glasgow
schild => shield
audio => audio
verstau => bestow
replizi => replicate
elisabeth => elizabeth
blendet => blinds
einrahm => enframe
stolpert => stumbled
horus => horus
sudafrika => south africa
hoffend => hoping
plan => plan; plot
sam => sami
neuengland => new england
fabriziert => fabricates; fabricated
tatowiert => tattooed
schamlos => shamelessly
irreparabel => irreparable; irreparably; irremediable; irreparabel; unrepairable
traini => train
klima => climate; clime
pathet => pathetic
gebracht => brought
ripp => rip
protein => protein
jugoslawi => yugoslavia; jugoslavia
pippin => pepin
komfortabel => comfortable; comfortably
imperialismus => imperialism
ali => ali
tropft => drops
eleganz => elegancy
idaho => idaho
offlin => offline; off-line
lissabon => lisbon
zwitschert => twitters
kostenlos => costless
rick => rick
bethleh => bethlehem
kent => kent
dialys => dialysis
nairobi => nairobi
kabeln => cable
brut => brood
michigan => michigan
inoffiziell => nonofficially; unofficially
islamabad => islamabad
chicago => chicago
murmeln => mumble; murmur
generi => generate
columbia => columbia
perfektioni => perfect; perfection
flut => flood
casar => caesar
esth => esther
detoni => detonate
gepfluckt => plucked
full => fill; fills
gam => game
hamm => hammer
improvisiert => improvised; improvises
kathol => Catholic; catholic
kleopatra => cleopatra
ii => ii
string => stringer
by => by
borneo => borneo
regnet => rained
dasein => dasein
riga => riga
prasent => present
diskuti => discuss
braun => brown; bronze
computerprogramm => computer programme
trail => trailer
rav => rave
plant => planned
springfield => springfield
radiesch => radishes
gazett => gazette
bush => bush
senil => senile; anile
mini => mini
bp => bps
pinkelt => piddled; tinkled
infiziert => infected; infects
pompeius => pompey
schatzung => rating
reptil => reptilia; reptilian
uberreagi => overreact
josefin => josephine
gesprung => sprung
projekt => projects
elegant => elegant; elegantly
bet => beg
algeri => algeria
tickt => ticks
transplanti => transplant
gottlos => godless; godlessly
mediti => meditate
bizarr => bizarre
km => km
sec => sec
negativ => more negative
irland => ireland
portal => portal
relais => relay
ober => over
clip => clip
uberschatz => overrate
leukami => leukemia
box => box
sank => sank
family => family
thrak => thracian
g => g
ungeniessbar => uneatable; unenjoyable
kambodscha => cambodia
uberall => universally
kanada => canada
rund => rotundly
nemesis => nemesis
schlief => slip
hightech => hightech
nordwart => northward; northwards
lebensform => lifeform
sensor => sensor
reagiert => reacted
landmin => landmine
heat => heat
stalk => stalk
kreb => crab
hermann => herman
prometheus => prometheus
script => script
kaviar => caviar
attackiert => attacked
sitzend => sitting
luis => louisa
ladt => loads
amy => amy
bukar => bucharest
stockholm => stockholm
held => held
resistent => resistant; resistent
dos => dose
transferiert => transfers; transferred
absolvi => absolve
regeneri => regenerate
martini => martini
munst => muenster
motherfuck => motherfucker
legitim => legitimate; legit
mandarin => mandarin
brullt => bawls
fokussiert => focused; focuses; focussed
cornwall => cornwall
limog => limoges
steuerfrei => scot-free
exot => exotic
geschockt => shocked
kron => crown
stationiert => stationed
ubertrumpf => overtrump
trompet => trumpet
bh => bh
wortlos => wordless; wordlessly
hetero => hetero
hera => hera
blutrot => blood red; blood-red
fasziniert => fascinated
edinburgh => edinburgh
skeptisch => sceptical; skeptical; skeptic; sceptic; sceptically
hungrig => hungrily
uncool => uncool
roma => romani; romany
funktioniert => functioned
planung => planning
tropf => drip; drop
marin => maritime; marine
tap => tap
blindheit => blindness
togeth => together
schabig => shabby
asyl => asylum
concha => concha
immun => immune; immun
boost => booster
kohlenhydrat => carbohydrate
vermint => mined
verbarrikadiert => barricades; barricaded
logisch => logical; logically; -logical; logic
argo => argo
installiert => installs; instaled; installed; instals
frustrier => frustrating; frustratingly
lothring => lothringen
angel => angel
eingreif => encroach
optisch => optically
goofy => goofy
uberanstrengt => overstrained; overstrains
guis => guise
zement => cement
colli => collier
lackiert => lacquered; lacquers
steuert => steers
terrorisi => terrorize; terrorise
microsoft => microsoft
tip => tip
pack => pack
tuba => tube
mix => mix
fauna => fauna
lockt => clucks
jakarta => jakarta
geklont => cloned
justi => justify; adjust
distanziert => distant
quitt => quits; quit
einzeln => single
plazenta => placenta
dext => dexter
rostet => rusts
abstrakt => abstract; abstractly; abstractedly; abstruse
circus => circus
olli => ollie
bankrott => bankrupt; bankruptly; bankruptcy
arizona => arizona
basiert => based
jago => iago
beantwort => answer
steinreich => stinking rich
guido => guido
qualifizi => qualify
freigegeb => freed
hiv => hive
gekratzt => grated
konfiguriert => configured; configures
enthusiast => enthusiastic; enthusiastically
ruhelos => restless
rc => rc
tendi => tend; trend
gulasch => goulash
schleud => sling
frequenz => frequency
bevor => before; afore
isabella => isabel; isabella
caracas => caracas
nix => nix
marshall => marshall
konzentriert => concentrated; concentrative
drei => three; trey
konsulti => consult
davy => davy
merlot => merlot
lynch => lynch; lynching
greif => grip; reach
daidalos => daedalus
symbol => symbolic
aktiviert => activated; activates
glitt => glided
gepinkelt => piddled; tinkled
gaia => gaia
terry => terry
alfred => alfred
umschreib => describe
toskana => tuscany
violett => violet; violett
verfein => refine
merkt => remarked
halluziniert => hallucinates; hallucinated
undiszipliniert => undisciplined
spinat => spinach
experimentell => experimental; experimentally
camd => camden
ansprech => appeal
indio => indian
fiesta => fiesta
paarweis => pairwise; paired
kommunismus => communism
unbeschreib => indescribable; indescribably; undescribable; undescribably
morpheus => morpheus
he => hey
investiert => invests; invested
inklusiv => inclusive; inclusive of; included; including; inclusively
exporti => export
adressiert => addressed
bizeps => bicep
hundertprozent => hundred per cent; hundred percent
leda => leda
lol => lol
murmelt => mumbled; murmured; muttered
faktisch => factual; actual; practical; actually
tansania => tanzania
kopenhag => copenhagen
stefan => stephen
korea => korea
posti => position; post
halbtot => half-dead
ge => ge; gee
unwohl => unwell
imperial => imperial
restauri => restore
scheint => shines
oklahoma => oklahoma
gepflanzt => planted
mittl => middle; middling
makeup => makeup
largo => largo
explodi => explode
befall => befall
nanking => nanjing
beneidet => envied
anbind => bind
galant => gallant
unterschatz => underestimate; underrate; undervalue
besiegelt => sealed
true => true
unbesiegbar => unbeatable
humpeln => hobble
gespritzt => sprayed; spritzed
belgi => belgian
pr => pr
anstreb => aspire
nestor => nestor
rasseln => rattle
protestiert => protested; protests
hebra => hebrew
intubi => intubate
idyll => idyllic
intern => internal
provokativ => provocative; provocatively; provoking
ubermudet => overtired
louvr => louvre
black => blackout
ns => ns
jock => jock
regeln => regulate
respektiert => respected
beirut => beirut
bell => bell
wei => wei
zeitlos => timeless
strukturell => structurally
penelop => penelope
post => post
kronos => cronus
zylind => cylinder
null => null; nil
trampeln => trample; tramp
kalkutta => calcutta; kolkata
neutralisiert => neutralizes; neutralised; neutralized
pakistani => pakistani
money => money
lot => lot
emir => amir
japanerin => japanese
saw => saw
stoneheng => stonehenge
diskriminiert => discriminated; discriminates
mailand => milan
bot => bid
intuitiv => intuitive; intuitional; intuitively
harald => harold
jimmy => jimmy
versus => versus
ejakulation => ejaculation
sting => sting
kurd => kurds
uberlagert => overlais; overlayed; overlaid; overlain; overlays
nordkorea => north korea
veraltet => dated
ansprechbar => approachable
schwimmt => swims
angelt => angles
veronika => veronica
delawar => delaware
inspiri => inspire
tick => tick
impliziert => implied; implicit; implies
singt => sings
asa => asa
lena => lena
ubertrieb => overdone
head => head
destruktiv => destructive; destructively
chrom => chromium
cayenn => cayenne
stopp => stop
ratseln => riddle
exekuti => execute
kreisch => scream; screech
festgebund => bound
tommy => tommy
lucky => lucky
entfaltet => unfolded
palo => palo
sandy => sandy
wacklig => shakily
konfronti => confront
gestrandet => stranded
savoy => savoy
signiert => signed; signs
trivial => trivial
proletariat => proletariate
golf => golf
unhorbar => unhearable
blutet => bled
eden => eden
rastlos => restless
cart => carter
parkt => parked
extr => extreme
brutus => brutus
inhali => inhale
albrecht => albert
nordost => northeast
vakuum => vacua
tschernobyl => chernobyl
unkontrolliert => uncontrolled; uncontrolledly; uncontrollably
schutz => shuttle
capa => cape
tramp => tramp
othello => othello
respektabel => respectable
unrealist => unrealistic; unrealistically
honey => honey
monk => monk
modus => mode
kanalisation => sanitation
pepp => pepper
renovi => renovate
beautiful => beautiful
symmetr => symmetrical; symmetric
sickert => trickles
cut => cut
bureau => bureau
erstklass => first-class; first class
registriert => registered
fesselt => fettered
watch => watch
oper => opera
demoliert => demolishes; demolished
jb => jb
khaki => khaki
programmiert => programed; programmed
indianerin => indian
schwirrt => whirrs
visionar => visionary
pervers => more perverse
zwick => twitch
katalogisiert => cataloged; catalogued
olympiad => olympiad; olympics
bosni => bosnia
thems => thames
wow => wow
hasta => hasta
meet => meet
miami => miami
unterschatzt => underrated; underestimated; underrates; undervalued
palastinens => palestinian; palestinians
provenc => provence
motivi => motivate
margaret => margaret
erzieht => educates
bowman => bowman
biochemi => biochemistry
final => final
defianc => defiance
barnabas => barnabas
rei => rei
stock => stick
robust => robust; robustly
kontakti => contact
ludo => ludo
saturn => saturn
chrysl => chrysler
mohammed => muhammad; mohammed
batteri => battery
offensiv => offensive; offensively
neapel => naples
burbank => burbank
getrunk => drunk
britanni => britain; britannia
dm => dm
ultra => ultra
lazarett => lazaretto
mangeln => mangle
denv => denver
davor => before
attila => attila
flitz => flit
johnny => johnny
zero => zero
dns => dna
kiel => kiel
primus => primus
unterschrieb => undersigned
denunziert => denunciated
leckt => leaked; licked
anonymous => anonymous
edda => edda
metall => metal
kitschig => kitsch; kitschy
biopsi => biopsy
minus => minus
via => via
treibt => drifts
option => option
wisconsin => wisconsin
ob => ob
pac => pace
konstruktiv => constructive; constructively; constructional
kreativitat => creativeness
palermo => palermo
charli => charlie
gewandert => wandered
schlummert => slumbers
asia => asia
inning => innings
scotch => scotch
seth => set
mietfrei => rent-free
minor => minor
bologna => bologna
katalogisi => catalogue; catalog
casp => casper
basi => base
telefoniert => telephoned
krim => crimea
isis => isis
daisy => daisy
pie => pie
lorenz => lawrence
ci => ci
regina => regina
respektvoll => respectful; respectfully
tuberkulos => tuberculosis
gras => graze
gehupft => hopped
nas => nose
konfus => confused
rebell => rebel
jodeln => yodel
erwartet => awaited
abermal => after all
charismat => charismatic
ahm => awm
gratis => gratis
agiert => acted
cal => cal
uniform => uniform
ausbreit => spread
nurnberg => nuremberg
zwickt => tweaks
geschuttelt => rattled
shaft => shaft
soundso => so-and-so
elvira => elvira
uberflieg => overfly
chinesin => chinese
lombard => lombard
chic => chic
kontrolliert => controlled; controled
ms => msec
susann => susan
rumani => romania; rumania
sympath => sympathetic; simpatico
passiert => passes; passed
kompatibel => compatible
beig => beige
navarra => navarre
sizili => sicily
dekori => decorate
feiert => feted
solomon => solomon
geschuftet => plodded; slogged
janic => janice
schopf => scoop
hindu => hindu
scorch => scorch
colorado => colorado
flop => flop
teleporti => teleport; teletransport
browning => browning
eva => eva; eve
asthet => aesthetics
perfektioniert => perfected; perfects
rau => raw
pos => pose
multipliziert => multiplied; multiplies
formuliert => formulated; formulates
check => check
protesti => protest
whitehall => whitehall
hipst => hipster
elbisch => elvish
stech => sting; stab; stick; stitch
central => central
wynn => wynn
erhang => hang
positioni => position
verlangert => elongated
benjamin => benjamin
vierhundert => four hundred
beta => beta
manipulativ => manipulative
erreichbar => reachable
jupit => jupiter
prophezeit => prophesied
donnert => thunders
schaukeln => shake; balance
wassertank => water tanks
blablabla => blah blah blah
luzif => lucifer
infrastruktur => infrastructure
festig => fasten
charity => charity
uberbiet => overbid
taktisch => tactical; tactically
botan => botany
dokumentiert => documented
sylvia => sylvia
cm => cm
aram => aram
divers => diverse
viktor => victor
mea => mea
plato => plato
nament => namely
wanda => wanda
tschechoslowakei => czechoslovakia
ontario => ontario
praxis => praxis
tm => tm
phonix => phoenix; phenix
smart => smart
comic => comics
julia => julia; juliet
start => start; start up
lappland => lapland
knet => knead
tweed => tweed
thrill => thriller
versklav => enslave
verbal => verbal; verbally
bruno => bruno
claudius => claudius
pompeji => pompeii
profiti => profit
olen => oil
fe => fe
illinois => illinois
anmerk => mark
denkbar => thinkable
sucr => sucre
eskali => escalate
kenia => kenya
elementar => elementary; rudimentary; elemental; elementally; elementarily
magellan => magellan
indonesi => indonesia
zung => tongue
marokkan => moroccan
nagelt => nails
stephani => stephanie
epi => epi
rehabilitiert => rehabilitates
reib => rub
strebt => strives
norweg => norway
rotterdam => rotterdam
excalibur => excalibur
konsumiert => consumes; consumed
at => at; ate
selbstlos => selfless
schob => shoved
enzym => enzyme
satt => sated; satiated
mentalist => mentalist
heilbutt => halibut
physik => physics
helsinki => helsinki
mega => mega
vatikan => vatican
kaffe => coffee
bermuda => bermuda
kreiert => created; creates
morris => morris
sak => saké
fin => fine
wal => wal
offn => open
gestarrt => stared
felicity => felicity
makrel => mackerel
schelt => scold
wellington => wellington
okay => okay; okey
februar => february
kaltherz => coldhearted
cartagena => cartagena
signi => sign
pick => peck; pick
gesprengt => sprinkled
anno => anno
hakenkreuz => hakenkreuz
morgan => morgan
missouri => missouri
back => bake
profitabel => profitable; profitably
columbo => columbo
siam => siam
who => who
sonn => sun
einhundert => hundred; one hundred
vicomt => vicomte
friedrich => frederic; frederick
friend => friend
industri => industry
godfath => godfather
adopti => adopt; adoption
model => model
kosovo => kosovo
unsensibel => insensitive; nonsensitive; insensitively
duelli => duel
java => java
verrottet => rotted
ion => ion
buddhismus => buddhism
qin => qin
hawaii => hawaii
chinin => quinine
kooperativ => cooperative
klinisch => clinical; clinically
weilt => dwells
leonardo => leonardo
holocaust => holocaust
judy => judy
alberta => alberta
aufgerollt => unrolled
experimentiert => experienced; experimented; experiments
schmeckt => smacked
chinatown => chinatown
tank => tank
halo => halo
stimulier => stimulating; stimulant; stimulative
monch => mönch
verkurz => reduce
teheran => teheran; tehran
morphin => morphine
kreta => crete
irrt => errs
hangt => hangs
polnisch => Polish; polish
studi => study
sheng => sheng
wassermelon => watermelon
puh => poo; pooh
zon => zone
sabotiert => sabotaged; sabotages
kontinui => continuous; continual; continually; continued
krach => crash; crack; crunch
liquidiert => liquidated
passi => pass
wohl => well
vibri => vibrate
tyrannisi => tyrannize; to tyrannise
kommandiert => commanded; commands
demokrati => democracy
violet => violet
karolin => caroline
transferi => transfer
geschmuggelt => smuggled
aden => aden
geschob => shoved
westwart => westward; westwards
unbewacht => unwatched
schluckt => swallows
athiopi => ethiopia
chill => chill
morder => murder
wladimir => vladimir
sudwest => southwestern; southwesterly; south western; south-western; southwest; south-west
zuschreib => ascribe
vorn => fore
sudamerika => south america
cab => cab
ungeschor => unshorn
aga => aga
ubergewicht => overweight
transformiert => transforms; transformed
fixiert => fixed; fixes; fixated; fixates
kokain => cocaine
gefischt => fished
guatemala => guatemala
formuli => formulate
geheilt => healed
ying => ying
lustvoll => lustfully
motor => motors
freedom => freedom
entspring => spring
schaurig => scary
generation => generation
sensation => sensation
vektor => vector
passé => passé
violetta => violetta
dijon => dijon
rar => rare
wann => when; what
dusch => douche
constanz => constance
betat => activate
generiert => generated
item => item
ubermorg => overmorrow
provoziert => provokes; provoked
beschattet => shaded
reguli => regulate
ur => ur
komplexitat => complexity
lt => lt
umhang => hang
valentin => valentine
amerikanerin => american
transparent => transparent; translucent
gescannt => scanned
shorty => shorty
ey => hey
ebn => even
me => me
lyrik => lyricism
frucht => fruit
hiervon => hereof
angebor => inborn
vesp => vesper
balkan => balkans
schu => shu
definiert => defined; defines
demoli => demolish
ras => race; rage; rave
bas => base
espresso => espresso
urban => urban; urbane
new => new
bio => bio
prasentiert => presented
fusion => fusion
kanadierin => canadian
stromt => streamed
reproduziert => reproduces; reproduced
florenz => florence
bindend => binding; tieing
dvds => dvds
mayday => mayday
interpol => interpol
ayutthaya => ayutthaya
muffig => mustily
chief => chief
berst => burst
plymouth => plymouth
dekan => dean
vill => ville
vermitteln => straddle
abcheck => check; to check
unterfang => undertake; undertaken}
nazareth => nazareth
rebelli => rebel
erreich => reach
gelistet => listed
vibriert => vibrates; vibrated
pandora => pandora
wilton => wilton
meteor => meteor
nominiert => nominates; nominated
mc => mc
mason => mason
projizi => project
gepisst => pissed
definitiv => definite; definitely; definitive; definitively
piepst => peeps
geschaufelt => shovelled; shoveled
unnatur => unnaturally
festbind => fasten
phantast => fantastic
vx => vx
entourag => entourage
vertikal => vertical; vertically
anschwell => swell
gamma => gamma
reproduzi => reproduce; reproduces
glamour => glamour
geschwatz => talkative
kuppeln => couple
shunt => shunt
horbar => hearable
anthropologi => anthropology
episch => epical; epic
stiehlt => steals
worub => whereof
zang => tong
panama => panama
gepackt => packed
miliz => police
aristotel => aristotle
kling => clink; clang
ungesund => unsound
iq => iq
josef => joseph
kuba => cuba
detailliert => detailed
griffith => griffith
tomorrow => tomorrow
phosphor => phosphorus; phosphorous
part => part
defini => define; defines
honig => honey
poli => polish
khan => khan; cham
luxemburg => luxembourg
funktionsfah => functioning; functional
scoot => scooter
appetit => appetite
brieftasch => briefcase
gestarkt => starchy; starched
twelv => twelve
ramm => ram
resultiert => results
hiermit => herewith
lino => lino
gurgelt => gargles; gurgles
bel => bel
deportiert => deports; deported
technologi => technology
rennpferd => runner
six => six
cholesterin => cholesterol
dankt => thanks
marschi => march
verlernt => unlearnt
dekolleté => decollete
goldig => golden; gold
rammt => rams
expandiert => expanded
orientier => orientation; orienteering
bulgari => bulgaria
massachusett => massachusetts
geleitet => guided
dynam => dynamic
patricia => patricia
quintus => quintus
konsistenz => consistency
kansas => kansas
che => che
exquisit => exquisite; exquisit; exquisitely
mobil => mobile; movable; moving; mobilized; moveable
stohnend => groaning; moaning
gefeiert => feasted; feted
oval => oval; ovally
integri => integrate
timbuktu => timbuktu
jamaika => jamaica
flack => flicker
nerv => nerve
aufgefullt => refilled
erleichtert => lightens
sudostasi => southeast asia
chronisch => chronically
sirius => sirius
senk => sink
grupp => groups
paradox => paradoxical; paradoxic; paradoxal; paradoxial
gekuhlt => cooled
ro => ro
rasend => raging
opossum => possums
mitbring => bring
bemerkt => remarked
absolut => absolute; absolutely
sonora => sonora
radioaktiv => radioactive; radioactively
leblos => lifeless
david => david
fantasi => fantasise; fantasize
kulturell => cultural; culturally; culture
setz => set
offiziell => official; officially; offical
kinderlos => kidless
stark => stronger
notiert => noted; notes; noticed
rumpelstilzch => rumpelstiltskin
berlin => berlin; berliner
safran => saffron
crack => cracker
posiert => postures; posed; postured
frisch => fresh; freshly
errichtet => erected
compton => compton
adam => adams
konsultiert => consults; consulted
serviert => serves; served
kosmisch => cosmic; cosmical
automat => automatic; automatically; automated; automatical; automaticly
rostig => rusty; rustily
gelandet => landed
parvati => parvati
bracht => brought
tom => tom
marcel => marcel
hypnotisiert => hypnotized; hypnotizes
moral => moral; morally
talon => talon
schwertfisch => swordfish
beatric => beatrice
unberechenbar => unreckonable
geniert => generated
jen => yon
trallert => trolls; trills
religios => more religious
modifiziert => modifies; modified
sevilla => seville
heizung => heating
zwolft => twelfth
nonstop => nonstop; non-stop
schopft => scooped
misch => mix
melk => milk
schien => shined; shone
furz => fart
all => all
korall => coral
harmlos => more harmless
krishna => krishna
tr => tr
sprech => speak
reinig => cleaning
wundert => wondered
lob => lobe
elimini => eliminate
verona => verona
radikal => radical; drastically; radically
anna => anna; anne
filt => filter
wladiwostok => vladivostok
korrigiert => corrected
bereitet => readied
diagramm => diagram
dialekt => dialect
har => harem
konservativ => conservatively
ida => ida
denn => then
finanziell => financial; financially
dein => thine
nero => nero
pluto => pluto
beginn => begin
gesund => sound
bertha => bertha
kraul => crawl
kannibalismus => cannibalism
akt => act
irrelevant => irrelevant; irrelevantly
ups => oops
overall => coveralls
gackert => cackles
popmus => pop
bohr => bore
belfast => belfast
kaukasus => caucasus
uns => ours
interpretation => interpreting
rosmarin => rosemary
honduras => honduras
gesung => sang; sung
absurd => absurd; absurdly
profit => nonprofit
gruppi => group
tunis => tunis
lahm => lame
klarmach => clarify
fm => fm
funktioni => function
rustikal => rustic; rustically
tig => tig
foxtrott => foxtrot
venus => venus
seattl => seattle
zacharias => zachariah
starr => stare
salzburg => salzburg
kriminell => more criminal
ignoriert => ignored
transportiert => transported
journalismus => journalism
organisation => organization
mechan => mechanics
pessimist => pessimistic; pessimistically
ubereifr => overeager
strikt => strictly; strict
fur => for
dinosauri => dinosaur; dinosaurs
uberfluss => superfluous
glas => glassy; glass
kolosseum => colosseum
halt => halt
gemeint => meant
kentucky => kentucky
sattelt => saddles
expandi => expand
lyon => lyon; lyons
klapp => clapper
hab => have
pensioniert => pensioned
gegoogelt => googled
gnus => gnu
authent => authentic; authentical; authentically
spritz => spray
uberschreib => overwrite; override; overstrike
grins => grin
folgend => following
joseph => joseph
over => over
richtig => right
emery => emery
zivilisiert => civilized
groov => groove
stehend => standing; suiting
daphn => daphne
latina => latina
hess => hess
missverstand => misunderstood
guru => guru
ungehindert => unhindered
schmuggelt => smuggled
wandert => wanders
pinocchio => pinocchio
konfrontiert => confronts; confronted
phanomenal => phenomenal; phenomenally
achtzehn => eighteen; eightteen
namenlos => nameless; namelessly
vollig => fully; full
anstatt => instead
potential => potential
ordinar => ordinary
markiert => marked; marks
unterliegt => underlies
opus => opus
kontext => context
orion => orion
konverti => convert
zu => to; too
gordon => gordon
kopi => copy
krabbelt => crawls; scrabbles
siames => Siamese; siamese
stampf => stomp; stamp; tramp; tamp
marmelad => marmalades
mallorca => majorca; mallorca
hallowe => halloween
kipp => tip
komplikation => complication
leon => leon
kennedy => kennedy
ebb => ebbe
professionell => professional; professionally; professional-looking
turn => turn
gros => gross
stamm => stem
programmi => program; programme; programming
egozentr => egocentric
dan => dane
untreu => untrue
ll => ll
mittel => middle
haha => haha
beschreib => describe
furchtet => dreaded
ineffizient => inefficient
turkisch => Turkish; turkish; turk
emmy => emmy
out => out
nachos => nachos
marina => marina
nachtclub => night club; nightspot
technisch => technicality
reserviert => reserved; reservedly; restrained
konig => kingly
thraki => thrace
tunneln => to tunnel
falsch => falser; false
recht => right; straight
dunde => dundee
reduzi => reduce
pladi => plead
blink => blink
meint => opined; meant
jenny => jenny
brandenburg => brandenburg
januar => january
gestresst => stressed
witzig => wittily
april => april
manipuli => manipulate
bann => banner
basier => basing
jordan => jordan
amusant => amusing
freier => freer
fett => fat; fats; fatty
miranda => miranda
tan => tan
patch => patch
suspendi => suspend
paradi => paradise
portugies => portuguese
irak => iraq
buh => boo
konvertiert => converted; converts
stormy => stormy
mietet => rented
en => en
fallt => falls; fells
hung => hunger
main => main
paraguay => paraguay
marrakesch => marrakech; marrakesh
christin => christina; christine
hm => hmm; hm; mhm; hem
marty => marty
jura => jura
zerplatz => explode
phas => phase
high => high
halluzini => hallucinate
tink => tinker
zirkus => cirque
eingraviert => engraved
kiew => kiev
backstag => backstage
koko => koko
unrein => unclean
newcastl => newcastle
unterlieg => underlie
stress => distress
siebent => seventh
steinbock => steinbock (ibex)
schlank => slender
hektisch => hectic; hectically
assimiliert => assimilated
gestreut => strewn
la => la
proteus => proteus
stein => stonen
nachbar => neighbor; neighbour
guerilla => guerrilla war
schramm => scrape
sebastian => sebastian
privat => private
stefani => stephanie
heulend => howling; hooting; bawling
revolutionar => revolutionary
spenc => spencer
einhalb => half
lesbisch => lesbian; Lesbian
iwf => imf
suggeriert => suggests; suggested
sediert => sedated
explodiert => explodes; exploded
sabbert => slavers; slobbers
erfullt => fulfilled; performed
russki => russki
fil => file
roll => roll
niagara => niagara
endet => ended
ruhr => ruhr
ja => yea
kodiert => coded; codes
paar => pair
abel => abel
kratzt => scratched
wartend => holding; waiting
boykotti => boycott
aquivalent => equivalent
mexikan => Mexican; mexican; mexikan
vorwart => forward; onward; forwards; forrard
fond => fond
giraff => giraffe
akzepti => accept; accredit
chines => chink
samson => samson
miet => let
unterschreibt => underwrites
gehindert => hindered
inhaliert => inhales; inhaled
war => were
stacheln => stitch
metz => metz
jesu => jesu
praktisch => more practical
enzyklopadi => cyclopaedia
subjektiv => subjective; subjectively; subjectivity; subject
amusi => amuse
eve => eve
konstant => constant; constantly; consistent
karthago => carthage
jubeln => jubilate
uberhor => overhear
hypnotisi => hypnotize; to hypnotise; hypnotise
temporar => temporary; temporal; temporarily
winseln => whine
stickig => stifling; sticky; stuffily
tokio => tokyo
gesteuert => steered
versklavt => enslaved
piano => piano
ernst => earnest; earnestly
uberbewertet => overvalued
barsch => harsh
nepal => nepal
stoned => stoned
abitur => abitur
schab => shave
ritus => rite
madonna => madonna
judas => judas
rekrutiert => recruited; recruits
marz => march
wat => what
greek => greek
firma => firm
loyal => loyal; loyally
polin => pole
vegetation => vegetation
fair => fair; faire
brud => bruv
plural => plural
mango => mango
argentini => argentine; argentinean; argentineans; argentinian
juli => july
unvorhersehbar => unforeseeable
famos => famous
word => were
parzival => perceval; percival
finanziert => financed; finances
delegi => delegate
spirituell => spiritual; spiritually
codiert => coded; codes
hornis => hornet
verkrampf => cramp
komma => comma
reaktiviert => reactivates; reactivated
schalt => scolded
schwirr => whirr
sara => sara
klingon => klingon
schier => sheer
jalta => yalta
stetig => steadily
dubai => dubai
nordwest => northwestern; northwest; northwesterly; north-western; north-west
loui => louie
mari => mary
physisch => physical; physically; physikalisch
gronland => greenland
pythagoras => pythagoras
assistiert => assists; assisted
licht => light; bright
gedampft => damped
act => act
sensibel => sensitive; sensible
gepresst => pressed
bb => bb
newton => newton
lawrenc => lawrence
symbolisi => symbolize; symbolise; symbol
fif => fife
konstantin => constantine
klettert => clambers
pascal => pascal
zelebri => celebrate
streift => streaked; striped
schanghai => shanghai
hollisch => hellish; hellishly
no => no
informi => inform
shampoo => shampoo
organisi => organize; organise
platin => platinum
kastriert => castrates; castrated
kittel => kittel
elektromagnet => electromagnetically
echo => echo
akkurat => accurate; accurately
korrumpiert => corrupted; corrupt; corrupts
plastisch => plastically
schnuffeln => snuff; sniffle; snuffle
kingston => kingston
wenn => when; whenever
bigfoot => bigfoot
desorientiert => disoriented; disorientated
bitt => bitter
fast => fast; fasting
argumenti => argue; argumentation
gekodert => decoyed
koln => cologne
tu => tu
neutral => neutral; neuter; neutrally
allzu => all too
kontaminiert => contaminated
skalpiert => scalped; scalps
storend => disturbing
sirup => sirup
shining => shining
frachtschiff => freight ship
streut => strews
hupf => hop
amphitryon => amphitryon
bleich => bleak
porto => oporto
ubereilt => overhasty
flanki => flank
schub => shoves
jazzmus => jazz
gap => gap
rhein => rhine
gertrud => gertrude
knack => crack
ibiza => ibiza
roderick => roderick
niagarafall => niagara falls
fummeln => fumble
gestreift => striped; stripy; streaky; streaked; striated
tut => do
welch => which
problemat => problematic; problematical; problematically
camelot => camelot
kabinett => cabinet; kabinett
kamp => kamp
tabu => taboo; tabu
sing => sing
knuddel => cuddly
olympia => olympia
maximal => maximal; maximum; maximally
hemlock => hemlock
stripteas => striptease
effektiv => effectively
para => para
riskiert => risked
legal => legal; legally; legality
synchronisi => synchronize; synchronise; synchronise, sync
trainiert => trained
gewundert => wondered
dresd => dresden
tahiti => tahiti
kapellmeist => kapellmeister
quiekt => squeaks
hob => hove
verfeinert => refines
uberfullt => overcrowded; overfilled
zion => zion
die => the
interferenz => interference
argus => argus
cok => coke
gartn => garden
macho => machismo
desinfiziert => disinfected; disinfects
mac => mace
jonathan => jonathan
lim => lime
variation => variation
insof => insofar
gewettet => betted
bestellt => bespeaks
ignorant => ignorant
kafka => kafka
synchronisiert => synchronizes; synchronised; synchronized
inspiziert => inspected; inspects
elysium => elysium
steckt => stuck
age => age
a => a
oral => oral; orally
debakel => débâcle
hypothet => hypothetical; hypothetically
seitwart => sideways; sideward; sidewards
glory => glory
cod => code
nikolaus => nicholas; nicolas
kurios => curious
bereichert => enriches
pond => pond
gestartet => started; started up
toronto => toronto
sed => sed
tartaros => tartarus
methan => methane
uberreizt => overbid
erwarm => warm
knuddeln => cuddle
kalt => cold
infrarot => infrared; infra-red
ohio => ohio
kalibri => calibrate; calibrating; calibration
hermet => hermetic; hermetical
dokumentation => documentation
telefon => telefon
frei => free; freely
jaul => yowl
bill => bill
schreien => scream; shriek
manif => manifest
fortuna => fortuna
soft => soft
cent => center; centre
gelyncht => lynched
mammut => mammoth
nd => nd
diamant => diamond; diamantine
kanalisi => canalise; canalize
serbi => serbia
anekdot => anecdote
dublin => dublin
schal => shawl
wodka => vodka
georgia => georgia
down => down
madrid => madrid
zivilisation => civilization
quintessenz => quintessence
entflamm => inflame
touché => touché
geheult => howled
absorbi => absorb
marokko => morocco
famili => family
favoritin => favorite; favourite
zahm => tame
verlangt => longed
gefluchtet => bolted
rekruti => recruit
beijing => beijing
schwed => sweden
irr => err
plausibel => plausible; feasible; plausibly
schockiert => shocked
bemerkbar => remarkably
stolziert => stalked; strutted
muff => muff
michael => michael
macao => macau; macao
intravenos => intravenous; intravenously
kompakt => compact; compactly
werft => wharf
josua => joshua
jesus => jesus
pieps => pipe
kreuzweis => crosswise
sendet => sent
maskiert => masked
acht => eighth; eighthes; eighths
antwort => answer; answering
filmt => filmed
miserabel => miserable
unsympath => unsympathetic
vietnam => vietnam; viet nam
sling => sling
thailand => thailand
ottawa => ottawa
bern => bernese
castro => castro
verpackt => packs
unattraktiv => unattractive
offent => open
theb => thebes
col => col
geatmet => breathed
kontrast => contrast
kracht => cracked
dick => thick
quiek => squeak
usbekistan => uzbekistan
piep => peep
tony => tony
schallend => tolling
gluh => glow
hinfort => henceforth
cholera => cholera
innovativ => innovative
dekoriert => decorates; decorated
thor => thor
tombston => tombstone
w => w
lill => lille
madagaskar => madagascar
cujo => cujo
unerreichbar => unreachable; unapproachable
send => send
probl => problem
ritual => ritual
stranguliert => strangles; strangled
flamm => flame
geographi => geography
ingw => ginger
frank => franks
tough => tough
rem => rem
theatral => theatrical; theatric
schmiert => smears
ballist => ballistically
mitt => amidst; mid; middle
assoziiert => associate; associated
achill => achilles
fecht => fight
innerst => innermost
armband => armband
heilbar => healable
pc => pc
saboti => sabotage
hohnisch => cynical
green => green
abseil => abseil
verriet => betrayed
gesunk => sunk; sunken
reflekti => reflect
ddr => ddr
jehova => jehovah
beliz => belize
holland => Hollandic
scheu => eschew
mekka => mecca
wild => wild; wildly
juan => juan
weitgeh => wide; widely
junior => junior
gebund => bound
patriot => patriotic
lobotomi => lobotomy
spekuliert => speculated
neurolog => neurological
umprogrammiert => reprogrammed
bonnet => bonnet
genet => genetical
portsmouth => portsmouth
naiv => naively
skandinavi => scandinavia
mannheim => mannheim
greenwich => greenwich
melanchol => melancholic; melancholy
ungestort => undisturbed
charleston => charleston
kombini => combine; combinate
uberschreit => overshoot
als => as
sofia => sofia
sorglos => careless
trodeln => dawdle
mississippi => mississippi
sizilian => sicilian
uberwund => overcome
monopoly => monopoly
macbeth => macbeth
trommelt => drums
heli => heli
mylord => milord
gesagt => said
action => action
christus => christ; christus
staat => state
bangkok => bangkok
rehabiliti => rehabilitate
pfluckt => picks
styl => style
boston => boston
grimm => grim
moira => moira
drangt => thronged
spang => spring
zickzack => zigzag
heul => howl
ammoniak => ammonia
wilmington => wilmington
barcelona => barcelona
japan => japan
anstarr => stare
cos => cos
monika => monica
imposant => imposing
thanksgiving => thanksgiving
ti => ti
reichstag => reichstag
googeln => google; Google
neufundland => newfoundland
junki => junkie
ag => ag
jersey => jersey
vulkani => vulcan; vulcans
kalibriert => calibrates; calibrated
asi => asia
soziologi => sociology
pan => pan
platziert => placed
jamaikan => jamaican
pharmazeut => pharmaceutically
dora => dora
aktivi => activate
thomas => thomas
background => background
matthaus => matthew
pruft => proved
heult => hooted; howled
migran => migraine
kart => card
wuff => woof; ruff
ok => ok; okey
stu => stu
basel => basel; basle
amazonas => amazon
lov => love
hindi => hindi
auspack => unpack
jugend => young
grundet => grounds
wick => wick
quadrant => quadrant
tragischerweis => tragically
comput => computer
wertlos => worthless; useless; worthlessly
split => split
bow => bow
elizabeth => elizabeth
now => now
aqua => aqua
brugg => bruges
sag => say
burgund => burgundian; burgundy
scharp => scarf
greas => grease
erzieh => educate
nant => nantes
hannov => hanover
grotesk => grotesque; grotesquely
co => co
blaubart => bluebeard
exponentiell => exponential; exponentially
behindert => hindered
belgrad => belgrade
galoppiert => gallops; galloped
agamemnon => agamemnon
vista => vista
stempel => stamper
dies => these
baseball => hardball
besudeln => befoul
europa => europe; europa
independenc => independent
hinbring => bring; to bring
fa => fa; fah
karat => carat
su => su
nervos => nervously
constantin => constantine
produzi => produce
dicht => tight
stripp => strip
montiert => mounts; mounted
lili => lili
identitat => identity
stimuli => stimulate
geklammert => clamped
gewartet => waited
deponi => deposit; depose; deposite
kastri => castrate
roosevelt => roosevelt
beast => beast
engagi => engage
streckt => stretched
montgomery => montgomery
ein => one
verschreib => prescribe
best => best
andock => dock
eskortiert => escorted
wehrlos => helpless
easy => easy
frigid => frigid
agent => agent
gregory => gregory
gefror => frozen
walhalla => valhalla; walhalla
ever => ever
registri => register
chevron => chevron
magi => magier
lagert => lairs
odysseus => odysseus; ulysses
plus => plus
halbi => halve
darwin => darwin
cann => cannes
unterst => undermost
em => em
feminin => feminine; female; effeminate
astronom => astronomical; astronomic
frontal => frontal; frontally
mayas => mayas
untrennbar => inextricable
misstraut => mistrusts
handvoll => handful
sim => sim
wirbelt => swirls; twirls; whirls
kabul => kabul
frivol => frivolous
andreas => andrew
ecuador => ecuador
fokussi => focus
schaufeln => shovel
ruckwart => backwards; backward; rearward
dink => dink
verbarrikadi => barricade
implantiert => implanted; implants
ticktack => tick-tock
kardiologi => cardiology
musst => must
urin => urine
cash => cash
afrika => africa
stereo => stereo
grenobl => grenoble
ml => ml
akzeptiert => accepted
hydraul => hydraulic
latino => latin; latino
zorro => zorro
go => go
neutralisi => neutralise; neutralize
monsignor => monsignor
nigeria => nigeria
stabilisiert => stabilised; stabilized
gepaart => paired
nektar => nectar
vorgewarnt => forewarned
australi => australia
demonstri => demonstrate
ahoi => ahoy
zhou => zhou
kuckuck => cuckoo
sony => sony
spezialisi => specialize; specialise
odessa => odessa
zirp => chirp
kanaan => canaan
herbei => here
blindling => blindly
gerostet => roasted
reap => reaper
sterilisiert => sterilizes; sterilised; sterilises; sterilized
sav => sava
divin => divine
gebroch => brokenly
andromeda => andromeda
nordse => north sea
alternativ => alternate
kooperation => cooperation
io => io
schroff => gruff
minimal => minimal
prothes => prosthesis
antwortet => answers
destabilisiert => destabilised; destabilized
rundum => round; roundly
unbegrundet => unfounded
transformation => transformation; transform
urini => urinate
doctor => doctor
mask => masker
pullman => pullman
istanbul => istanbul
volkslied => volkslied
klickt => clicks
m => m
bolognes => bolognese
theori => theory
export => export
poseidon => poseidon
adieu => adieu
gefaltet => folded
risiko => risk
beelzebub => beelzebub
armageddon => armageddon
katharina => catherine
atlant => atlantic
castor => castor
medusa => medusa
spreiz => spread
marschiert => marches; marched
malaysia => malaysia
tue => do
orpheus => orpheus
el => el
robin => robin
klass => class
faszinier => fascinating; fascinatingly
nos => nose
irrational => irrational; irrationally; irrationality
mon => mon
toleri => tolerate
total => total; totally
defensiv => defensive; defensively
scharlatan => charlatan
frittiert => fried
wimmert => whimpers; whines
poliert => polished; polishes
marguerit => marguerite
vesta => vesta
frankenstein => frankenstein
odin => odin
lax => lax
produktion => production
indiskret => indiscreet; indiscreetly
hf => hf
hierbei => here
truck => trucker
satteln => saddle
alias => alias
ungarn => hungary
champagn => champagne
gebunkert => bunkered
warm => warm
lachend => laughing
hammert => hammerd
verwundet => wounded
tres => tres
geschult => schooled
panth => panther
bisexuell => bisexual; ambisexual; ambosexual
strassburg => strasbourg
duplikat => duplication
monatelang => monthslong
spartan => spartan
kuri => cure
funky => funky
hebraisch => Hebraic; hebraic
hallo => hello; hallo
hip => hip
strateg => strategic
ambitioniert => ambitious
morbid => morbid
hock => hunker
wund => wonder
intelligenz => intelligence
giuliano => julian
germani => germania
tb => tb
handbrems => handbreak
schnuffelt => sniffles; snuffles; snuffs
modisch => modish
python => python
wo => who
pseudonym => pseudonymous; pseudonymously
grimmig => grimly
soso => so-so
katalysator => catalysis
kant => cant
schocki => shock
pickel => pimple
fc => fc
danisch => Danish; danish
ruman => romanian; rumanian
hisbollah => hezbollah; hizbullah
vehement => vehement; vehemently
oha => oh
verstreu => strew
unpunkt => unpunctual
drak => drake
beschmiert => besmeares; besmears; besmeared
intensiv => intensive; intense; intensely; intensively
pinkeln => piddle
tub => tube
manuell => manual; manually
hecheln => heckle; hatchel
britisch => British; british; britannic
feil => file
zirka => circa
geflutet => flooded; overflooded
arabi => arabia; araby
seh => see
bestial => bestial
ipod => ipod
afrikan => African; african
knopf => knot
regim => regimen
mechanismus => mechanism; mechanics
mary => mary
wen => who
walt => walter
pantomim => pantomime
schock => to shock
muss => must
ziti => cite
kg => kg
neurot => neurotic
kooperiert => cooperated; cooperates
schmuggeln => smuggle; smuggling
servic => serve
wolf => wolf
lar => lar
suit => suit
brilliant => brilliant
imiti => imitate
sergeant => sergeant
arnold => arnold
amsterdam => amsterdam
kontinuum => continuum
mein => mine
jogg => jog
dezemb => december
acapulco => acapulco
devon => devonian; devon
aphrodit => aphrodite
arktis => arctic
hungert => hungers
russland => russia
steril => sterile; sterilely
ubernacht => stay overnight; overnight
geblendet => blinded
traumat => traumatic; traumatically
lagos => lagos
lautlos => soundless; soundlessly
ungebund => unbound
dezent => decent
euphor => euphoric
antik => antique
reserv => reserves
aggressiv => more aggressive
richard => richard
artefakt => artifact
addi => add
refrain => refrain
nipp => sip
wisch => whisk
handeln => handle; haggle
capot => capote
monopol => monopole
mojito => mojito
rot => red
louisiana => louisiana
autorisi => authorize; authorise; endorse
geschwor => sworn
athlet => athletic
informativ => informative; informatively
ketchup => catchup
gefurzt => farted
studiert => studied
unbemerkt => unawares
schachmatt => stalemate
komisch => comical; comic
aufstell => install
objekt => object; objekt
gefurchtet => dreaded
mist => mist
servi => serve; serve up
streik => strike; struck; stricken; stricken}
erfull => fill
geschloss => close
spektakular => spectacular
spindel => spindle
yama => yama
bella => bella
daddy => daddy
lernt => learns
franklin => franklin
arrogant => more arrogant
fund => fund
mexiko => mexico
potentiell => potential; potentially
finn => finn
fliessend => flowing; floating
bullshit => bullshit
elia => elijah
gestapelt => stacked
tourismus => tourism
sie => she
besing => sing
indirekt => indirect; indirectly
supermarkt => supermarket
uberanstreng => overstrain
exkommuniziert => excommunicated
produktiv => more productive
thessaloniki => salonika; thessaloniki
sportlich => sporting; sportingly
uberrannt => overrun
atzend => cauterizing
verbittert => embittered; embitters
howl => howl
pflanzt => plants
coop => cooper
lamb => lamb
field => field
nat => nat
trink => drink
phantasi => fantasy
autorisiert => authorized; authorised; authorizes; authored; authorises
bonn => bonn
purpur => purple; purpure
kasachstan => kazakhstan
schmatz => smack
reform => reform
lokalisi => localize; locate; localise; lokalise
will => will
und => and
kommunizi => communicate; commune
lasch => lax
grundlos => groundless
grundwass => groundwater
imag => image
degeneriert => degenerate; degenerately; degenerates; degenerated
matthias => matthew
psychot => psychotic
unklar => unclear
garantiert => warranted; guaranted; guaranteed; guarants; warrants
mariann => marianne
wes => whose
intakt => intact
raub => rob
inoperabel => inoperable
mim => mime
emotional => emotional; emotionally
zensiert => censored
chlor => chlorine
parma => parma
trauma => trauma
exklusiv => exclusive; exclusively
untermau => underpin
mathemat => mathematical; mathematic; mathematically
lima => lima
padua => padua
sumatra => sumatra
iris => iris; irises
lag => lay
elast => elastic
zittert => jittered
lukrativ => lucrative; lucratively
gestoppt => stopped
erblind => go blind
kommandi => command
hurra => hooray; hurrah; hurray
gumbo => gumbo
parkinson => parkinson's
somalia => somalia
klirrt => clangs; clanks
bahamas => bahamas; the bahamas
provozi => provoke
in => in
appelli => appeal
playa => playa
dolor => dolores
vorhersehbar => foreseeable
dokumenti => document; documenting
floor => floor
lokalisiert => localizes; localised; localises; localized; located; locates
tret => tread
heilung => healing
vietcong => vietcong
pfluck => pluck
bestehl => steal
jok => joker
komposition => composing
kapital => capital; capitally
sexualitat => sexuality
konserviert => conserved; conserves
schreit => tread
miau => miaow; miaou
vorderst => foremost; forward
run => run
obszon => obscene; obscenely
sudan => sudan
einquartiert => quartered
platzi => place
sternenbasis => starbase
truffel => truffle
heroin => hero
heart => hearts
ninja => ninja
uriniert => urinates; urinated
philipp => philip
konfisziert => confiscated; confiscates
saphir => sapphire
wagenlad => wagonload
kontra => contra
parallel => parallel
tipptopp => tiptop; tip-top
ba => ba
produkt => product
wehrmacht => wehrmacht
himalaya => himalayas
mala => mala
panisch => panicky; panic; panicly; of panic; panicked
brutal => brutal; brutally; brute
chest => chester
fohl => foal
uberrollt => overruns; overrun
uberrenn => overrun
support => support
blutig => bloodied; bleeding; bloodily
lila => lilac
fliegt => flies
trinity => trinity
laila => leila
kombi => combo
jordani => jordan
ten => ten
restauriert => restores; restored
film => film
gaga => gaga
speziell => special; especially; specially; especial; specific
utah => utah
volum => volume
lola => lola
inspizi => inspect
fallend => falling
feurig => fervidly
tuchtig => doughty
krakau => cracow; krakow
lebend => living; live; lively
uberzog => overcast
leto => leto
hindert => hindered
dilemma => dilemma
inderin => indian
alexand => alexander
installi => install; instal
operi => operate
sy => sy
davenport => davenport
charl => charles
unschatzbar => invaluable; incalculable
schottland => scotland
qualitat => quality
mam => mam
diplomat => diplomatic; diplomatically
intuition => intuition
stopft => stuffs
inspirier => inspiring; inspirational; inspiriting
sarkast => sarcastic; sarcastically
vereitelt => defeated
vorlaut => forward
spatest => latest
sterilisi => sterilize; to sterilise; sterilise
glamouros => glamorous; glamourous
investi => invest
augusta => augusta
posi => pose
sticht => sticks
muh => moo
lauwarm => lukewarm
sieh => see
modeln => model; modeling
bliss => bliss
undenkbar => unthinkable; unthinkably
ismael => ishmael
creed => creed
reflexion => reflection
gerry => gerry
anonym => anonymous; anonym; anon; anon.
matsumoto => matsumoto
help => help
normandi => normandy
taff => taff
bitch => bitch
telepath => telepathically
elb => elbe
messag => message
liverpool => liverpool
kreuzig => crucify
darcy => darcy
duck => duck
softi => softie
zweig => twigs
quasi => quasi
torchwood => torchwood
labil => labile
wein => whiney; whiny
atlantis => atlantis
raptor => raptor
erbring => bring
eingebettet => embedded; interbedded; imbedded
johann => john
kaliforni => california
herzog => herzog
injizi => inject
nervig => nerved
gefund => found; funds
milan => milan
spons => sponsor
stottert => splutters; stammers; stutters
ar => ar
manisch => manic; maniac; manically
verkruppelt => crippled
miss => miss
fotografi => photograph
cran => crane
hotel => hostel
trat => trod
jewel => jewel
kuwait => kuwait
genom => genoms
gescharft => sharpened
radio => radio
hieran => here
existent => existent; extant; existing
vi => vi
farsi => farsi
attacki => attack
pausi => pause
belagert => beleaguered; beleaguers; besieges
unordent => unorderly
maxwell => maxwell
schnupf => snuff
dosis => dose
markus => mark
unsagbar => unspeakable; unspeakably
respekti => respect
komplett => complete; completely
jon => jones
ausschwarm => swarm
piss => piss
operation => operation
schnattert => chatters
strampeln => struggle
geflirtet => flirted
pflanz => plant; place
heran => here
herod => herod
adjektiv => adjective
garanti => guarantee; warrant
gips => gypsum
bayou => bayou
popular => popular
dini => dine
goa => goa
st => st
klingelt => tinkled; jingled
unhygien => unhygienic
finanzi => finance
gibraltar => gibraltar
gefuhllos => callous
humanoid => humanoid; humanlike
obduktion => obduction
brussel => brussels
endlos => endless; endlessly
mikrowell => microwave
halleluja => hallelujah; alleluia; halleluja
knupf => knot
bi => bi
lexington => lexington
erlern => learn
dad => dad
stemm => stem
trott => trotter
kollabiert => collapsed
orienti => orient; orientate
wie => when
hl => hl
sibiri => siberia
kongo => congo
begonn => begun
guy => guy
gratuliert => congratulates; congratulated
anbring => bring
azur => azure
bourgeois => bourgeois
ofen => oven
gaza => gaza
padophil => paedophiles
blendend => blinding; blind; blazing
uberhol => overhaul
fantasiert => fantasised; fantasized
weltbank => world bank
salpet => salpeter
owen => owen
labrador => labrador
bier => beer
warschau => warsaw
eintret => enter
unterhielt => entertained
charlott => charlotte
projektion => projection; projecting
erprobt => approved
singend => singing
edward => edward
vierzehn => fourteen
klammert => clamps; clasps
akupunktur => acupuncture; acupressure
verfrachtet => freighted
detoniert => detonated
saftig => sappily
exekutiert => executed
grac => grace
zitiert => cited
schmal => small
katastrophal => catastrophic; catastrophically; catastrophical
unterzeichnet => undersigned; undersigns; initialed
chen => chen
aufblas => upblow
uno => one
apoll => apollo
columbus => columbus
amman => amman
formiert => formed up
abaddon => abaddon
manifestiert => manifested; manifests
maverick => maverick
angela => angela
vom => from
rosett => rosette
grin => grins
geschaltet => shifted
que => que
arkansas => arkansas
rottweil => rottweilers
psychologi => psychology
molekular => molecularly
lektor => lector
hatch => hatch
knackt => cracks
normann => norsemen
kill => kill
judaa => judea
einpflanz => implant
instabil => unstable; instable; unstably; instably
theseus => theseus
montpelli => montpellier
identifiziert => identified; identifies; he identifies
gerald => gerald
karpf => carp
zigarett => cigaret
beraubt => bereaved
heinrich => heinrich
palazzo => palazzo
mum => mum
maya => maya; mayan
missionar => missioner
oh => oh
pfui => poo
brasilian => brazilian
palm => palm
graf => graph
stasi => stasi
casanova => casanova
zinn => tin
klingeln => jingle
sexist => sexist
salzig => salty; salt; salted; saltily
der => her
sesam => sesame
atlanta => atlanta
schrie => screamed
tragisch => tragically
jerusal => jerusalem
handicap => handicap
bagdad => bagdad; baghdad
peak => peak
rontg => roentgen
stinkig => stinking; stink
architekt => architect
uberbot => overbid
houston => houston
extermini => exterminate
mandschurei => manchuria
angetret => acceded
stotternd => stuttering; spluttering; stutteringly
verkompliziert => complicated; complicates
leipzig => leipzig
fuzzy => fuzzy
regular => regular; regularly
ls => ls
devonshir => devonshire
gebar => bear
kastration => castration
sudwart => southward; southwards
applaudiert => applauds; applauded
southampton => southampton
philadelphia => philadelphia
lokal => local; locally
anubis => anubis
natali => natalia; natalie
einpark => park
datiert => dated
rosig => rosy
spani => spaniard; spaniards
cox => cox
philippin => philippines
hannibal => hannibal
pladiert => pleads; pleaded
trianguli => triangulate
nelson => nelson
mol => mole
apach => apache
shuttl => shuttle
unscharf => unsharp
gill => gill
tendiert => tended; tends; trended
krachz => crackle
auslad => unload
jerry => jerry
unterkuhlt => supercooled; undercooled
casablanca => casablanca
schwell => swell; swell up
camp => camp
minneapolis => minneapolis
kritisi => criticize; criticise
uberhitzt => overheated
impotenz => impotency
diskrediti => discredit
interview => interview
rapp => rap
energi => energy
es => ess
broadway => broadway
ash => ash
yeoman => yeoman
spiritus => spiritus
khmer => khmer
geachtet => regarded
kontrolli => control
moritz => maurice
drift => drift
catch => catch
hilton => hilton
raschelt => rustles
okonomi => economy
juju => juju
pullov => pullover
c => c
passabel => passable
bali => bali
goldfisch => goldfish
lateinamerika => latin america
nona => nona
barbados => barbados
ank => anker
ramadan => ramadan
kompetent => competent; competently
rebekka => rebecca
diszipliniert => disciplined; disciplines
reflektiert => reflective; reflected; reflects; rejected
indi => india
geschluckt => swallowed
geplundert => looted; plundered
patrick => patrick
zurich => zurich
theres => teresa
ptolemaus => ptolemy
ubertret => overstep
opposition => opposition
geschrubbt => scrubbed
unfehlbar => infallible; infallibly; inerrable
gelad => reload
exakt => exact; exactly
wrestl => wrestler
williamsburg => williamsburg
behammert => hammered
goldfing => goldfinger
extravagant => extravagant; extravagantly
rolf => rolf
armeni => armenian; armenians
hindus => hindus
hur => whore
zentn => centner
beowulf => beowulf
prapariert => prepared
samarit => samaritan
pulsi => pulsate; pulse
retriev => retriever
geleert => depleted
balkon => balcony
bewalt => beat
kompromitti => compromise
spezialisiert => specialised; specialized
di => di
otto => otto
portugal => portugal
menelaos => menelaus
taliban => taleban; taliban
kantin => cantina
jd => jd
kuban => cuban
intro => intro
bernhard => bernard
tiberius => tiberius
informiert => informed; informs
chupacabra => chupacabra
effizienz => efficiency
adolf => adolf
degradiert => degrades; degraded
achteinhalb => eight and a half
leviathan => leviathan
toulous => toulouse
fiel => fell
jakob => jacob
klub => club
kollabi => collapse
abenteuerlust => adventurous
hierh => here
aurora => aurora
dominant => dominant; dominantly; predominant
versaill => versailles
zeus => zeus
eliminiert => eliminates; eliminated; exterminated
rosa => rose; rosy
einst => erst
schlurf => slurp
martin => martin
montenegro => montenegro
majestat => majestic; majestically
picknick => picnic
funktionstucht => functional
zhao => zhao
infiltriert => infiltrated; infiltrates
haifa => haifa
drollig => droll
terrass => terrace
uberfordert => overcharges; overcharged; overexerted; overworked
garstig => nastily
breton => breton
lobst => lobster
balthasar => balthazar
clay => clay
tennesse => tennessee
connecticut => connecticut
masch => mascle
wasserdicht => watertight; water-tight
terrorisiert => terrorizes; terrorised; terrorized
unkooperativ => uncooperative
doktor => doctor
soo => soo
zertrampelt => trampled; tramples
lawton => lawton
alban => albanian
publik => public
dolc => dolce
backgammon => backgammon
kapseln => caps
kommenti => comment; comment on; commentate
jos => jos
bambus => bamboo
newport => newport
harry => harry
abba => abba
gestopft => stuffed
tanzch => dance
pk => pk
sch => sch; shh
abschlag => disallow
rapid => rapidly; rapid
laos => lao; laos
cy => cy
schmier => smear
texan => texan; texans
radon => radon
pentagon => the pentagon
fossil => fossil; fossilized
uberford => overcharge
doodl => doodle
masturbiert => masturbates; masturbated
sprint => sprint
ce => cee
katapultiert => catapulted; catapults
geendet => ended
rausch => rush
jurist => juristic; juristical
passiv => passive; passively
sea => sea
spekuli => speculate
kroati => croatia
surpris => surprise
unkonventionell => unconventional; unconventionally
heterosexuell => heterosexual
geschmeckt => smacked
dominiert => dominates; dominated
jim => jim
californication => californication
kapitalismus => capitalism
tyrannisiert => tyrannizes
jammert => yammers
pink => pink
nelly => nelly
z => z
cardiff => cardiff
stabilitat => stability
lucas => lucas
ithaka => ithaca
absorbiert => absorbs; absorbed
prompt => prompt; promptly
nostalg => nostalgic; nostalgically
taxi => taxi cab
pumpt => pumps
surreal => surreal
fertig => readily
abrupt => abrupt; abruptly
explizit => explicit; explicitly
nicht => naught; nought
erin => erin
manila => manila
geplant => planned
schwedisch => Swedish; swedish
grillt => grills
konfiszi => confiscate
bitcoin => bitcoin
rekonstrui => reconstruct
spezial => special
monseigneur => monseigneur
tang => tangier
furwahr => for sure
winselt => whimpers; whines
beauregard => beauregard
flirt => flirt; flit
livr => livre
niederland => netherlands
pennsylvania => pennsylvania
ursula => ursula
mali => mali
taktvoll => tactful; tactfully
tartar => tartar
kompani => company
zwei => two; twain
unzivilisiert => uncivilized; uncivilised; uncivilizedly
regeneration => regeneration
kassiert => cashed
brigadi => brigadier
shun => shun
definition => determination
slam => slam
alarmi => alarm
syri => syria
herein => here
saluti => salute
max => max
hiob => job
multipl => multiple
colombo => colombo
gantry => gantry
spital => spital
tunesi => tunisia
gomorrha => gomorrha
dax => dax
zynisch => cynical; cynic; cynically
potsdam => potsdam
vancouv => vancouver
charisma => charism
streng => stringently
erblindet => blinded
amputiert => amputates; amputated
york => york
screen => screen
salamanca => salamanca
beep => beep
landschaft => landscape
junk => junker
kontraproduktiv => counterproductive; counter-productive; counterproductively
durst => thirst
steinhart => stonehard
einkomm => income
malaria => malaria
nun => now
levi => levi
o => o
ln => ln
identifizi => identify
record => record
ray => ray
schimmert => glimmers; shimmers
balanc => balance
formation => formation
ideologi => ideology
unprofessionell => unprofessional; nonprofessional
amour => amour
i => i
oslo => oslo
lunar => lunar
implanti => implant
nova => nova
grafik => graphics
spin => spin
clev => clever
prugelt => cudgeled
stimuliert => stimulates; stimulated
alaska => alaska
repariert => repaired
magnus => magnus
ablad => unload
schwerlich => scarcely
wackelt => shakes
self => self
sho => sho
brasili => brazil
zombi => zombi
again => again
bristol => bristol
schnaps => snaps
desinfizi => disinfect
bombardiert => bombarded
sol => sol; so
cassius => cassius
nicaragua => nicaragua
ka => kay
intelligent => more intelligent
unterstreich => underscore
fun => fun
douglas => douglas
handwerk => handiwork
existi => exist
xerx => xerxes
aneurysma => aneurysm
hing => hung
jt => jt
her => here
infizi => infect
meng => mingle
blocki => block; blockade; lock
bundel => bundle
pyjama => pajama
fury => fury
knot => knot
rost => rust
geschuttet => slopped
grummeln => grumble
zulu => zulu
cob => cob
philosoph => philosophical
mysterios => mysterious; mysteriously; misterious
hang => hang; dangle; hung
bordeaux => bordeaux
gebadet => bathed
diagnos => diagnosis
mikros => mics
geschor => shorn
neust => newest
reduziert => reduced; reduces
washington => washington
niveau => niveau
injiziert => injected
amor => amor
legendar => legendary
gebessert => bettered
gespickt => spiked
y => y
uberspielt => overplayed
los => loose
melon => melon
mill => miller
komponiert => composes; composed
edo => edo
recherchi => research; recherche
zentral => center; centrally
council => council
fan => fan
anomali => anomaly
interviewt => interviews; interviewed
werth => worth
spring => spring
caesar => caesar
signora => signora
bottom => bottom
smith => smith
demokrat => democratic; democratically; democrat
allmacht => almighty
gab => gave
punktlich => punctual; punctually
schaufelt => shovels
herbert => herbert
kichert => snickers; sniggers
bett => bed
gigant => gigantic; giant
kurzsicht => short-sighted; shortsighted
steck => stick
so => so
punk => punk
con => con
ed => ed
luk => luke
subjekt => subject
festlich => festive; festal; festally; festively
spontan => spontaneous; spontaneously
mahdi => mahdi
sem => shem
assisti => assist
flirtet => flirts
pittsburgh => pittsburgh
salvador => salvador
gewicht => weight
recyceln => recycle; cycle
senior => senior
zubring => bring
wundervoll => wonderful; wonderfully
schwort => swears
alzheim => alzheimer's
aufrecht => upright
brosch => broach
gesendet => sent
louis => louis
lebenslang => lifelong
material => material
stephan => stephen
konsumi => consume; consuming
por => por
distanzi => distance; outdistance
dekadent => decadent; decadently
temperatur => temperature
has => hare
akzent => accent
debatti => debate
turbin => turbine
therapeut => therapeutic; therapeutical
gespart => spared
pension => pension; pensione
verkabeln => cable
angola => angola
faschismus => fascism
saturday => saturday
medina => medina
medea => medea
schwank => shake
gluhend => glowing
liv => live
beginnt => begins
unbekannt => unbeknownst
texas => texas
venezuela => venezuela
brav => brave
toy => toy
uberflut => overflow; overrun
tanzerin => dancer
quart => quarter
nisch => niche
bomb => bomb
unprakt => unpractical
aluminium => aluminium
jota => jota
muscheln => mussel
spanisch => Spanish; spanish; Hispanic; hispanic
grandios => grandiose; grand; grandiosely
branch => branch
gymnasium => gymnasium
angeln => angle; angles
gekoppelt => coupled
cd => cd
brunett => brunette; brunet
beschreibt => describes
inakzeptabel => unacceptable; inacceptable; unacceptably
finnland => finland
barfuss => barefoot
kabel => cable
schwarm => swarm
erkenn => perceive
positiv => more positive
axel => axel
ty => ty
momentan => momentary; momentarily
pelz => pelt
benedict => benedict
victoria => victoria
sedan => sedan
anhalt => halt
warn => warner
zum => to
wackeln => waggle; wiggle
sarah => sarah
unmoral => immoral; immorally; amoral
christentum => christendom
marki => mark
verfracht => freight
greift => grips
indisch => indian; Indic; indic
windsor => windsor
gefilmt => filmed
teur => dearer
wlan => wlan
evakui => evacuate
schwedin => swede
systemat => systematic; systematically; systematical
privilegiert => privileged
diktiert => dictates; dictated
grosst => greatest
emsig => busily
metatron => metatron
rothaar => red-haired; red hair
wasch => wash
bridg => bridge
extrahi => extract
ethnisch => ethnical
rassist => racist
reaktionar => reactionary
rekonstruiert => reconstructed; reconstructs
inspiriert => inspirational; inspired; inspires; inspirited
familiar => familiar; familial; family
windig => windy; windily
kick => kick
mosaik => mosaics
viva => viva
mos => moses
ach => ah
feuerball => thunderball
gesucht => sought
gut => good
reykjav => reykjavík
nummeriert => numbered
hierauf => hereupon
rudi => rudy
goteborg => goteborg; gothenburg
lust => lusty
frustriert => frustrated; frustrates
jungfrau => jungfrau
kupplung => coupling
portrat => portraiture; portrayal
kolumbian => colombian
florida => florida
gr => gr
gesteckt => stuck
weltweit => worldwide
uberflog => overflown
taktlos => tactless; tactlessly
hameln => hamelin
interpretiert => interpreted; interprets
kostet => costs
deck => deck
wollt => would
abzieh => abate
sin => sin
konkret => concrete; concretely
sentimental => sentimental
kost => cost
unkompliziert => uncomplicated
schema => schema; scheme
wc => wc
funktion => function
gala => gala
jericho => jericho
wirbeln => whirl
importiert => imported; imports
temperamentvoll => temperamental; temperamentally
geschwindelt => swindled
geboxt => boxed
problemlos => problem-free
blind => blind; blindly; blank
association => association
translation => translation
fax => fax
zurecht => aright
mach => mach
providenc => providence
platoon => platoon
today => today
epilepsi => epilepsy
onkologi => oncology
gestattet => granted
wash => wash
palastina => palestine
train => trainer
neuseeland => new zealand
pollux => pollux
schott => scot
krabbeln => scrabble; scramble
kantones => Cantonese; cantonese
bring => bring
formt => formed
x => x
quitti => quit
ese => ese
maryland => maryland
klappert => clatters
postiert => posted
do => do; doh
rechn => reckon
queer => queer
bravo => bravo
westeuropa => western europe
short => short
schwan => swan
pragmat => pragmatic; pragmatical; pragmatically
unsich => unsurely
bundeln => bundle
liby => libya
hamilton => hamilton
sowjetunion => soviet union
homosexuell => homosexual; homosexually
gregor => gregory
merced => mercedes
adoption => adoption
holosuit => holosuite
zivil => civil; civilian; civic
quakt => croaks; quacks
gentry => gentry
hast => hast
honolulu => honolulu
italienerin => italian
jack => jack
nachtwacht => nightwatchman
untot => undead
hundert => hundreds; hundredths
piranhas => piranha
majestic => majestic
don => don
habt => have
small => small
komtess => countess
involvi => involve
kolossal => colossal; colossally
vietnamkrieg => vietnam war
arrangi => arrange; array
jennif => jennifer
walz => wallow
thai => thai
you => you
sah => saw
initii => initiate
schwing => swing
strukturiert => structured; structures
piazza => plaza
aktivitat => activity
georg => george
crown => crown
aladin => aladdin
joe => joe
geantwortet => answered; retorted
grantig => grumpily
danemark => denmark
russin => russian
mutiert => mutated
jet => jet
befrei => free
schwankt => sways
sprang => sprang
symbolisiert => symbolizes; symbolised; symbolises; symbolized; symbolled; symbols
twitt => twitter
schnippisch => snappish; snappishly
mindert => minishes
depressiv => depressive; depressively; depressed
misstrau => mistrust
schwindet => dwindles
radius => radius
presto => presto
analogi => analog
was => what
lern => learn; larn
sink => sink; sunk
chapel => chapel
birmingham => birmingham
oe => oe
havanna => havana
reinhold => reginald
uberqu => overcome
bolivar => bolivar
stressig => stressful
hatt => had
telegrafi => telegraph; telegram
gebot => bid
bongo => bongo
gerollt => rolled
sensationell => sensational
kuriert => cured
unbeantwortet => unanswered
emili => emily
datenbank => databanks
areal => areal
behandelt => handled
diagnostiziert => diagnoses; diagnosed
operiert => operated
mexikanerin => mexican
terminal => terminal
manag => manage
rational => rational; rationale; rationally
stehl => steal
lassi => lassie
kapituliert => capitulates; capitulated
sokrat => socrates
leaf => leaf
rachel => rachel
neutron => neutron
frédéric => frederick
student => student
halbweg => halfway; half-way
blend => blind
tricks => trick
attraktiv => attractive; attractively; attracting
organisiert => organized; organizes; organised; organises
walk => walker
tee => tea; tee
shanghai => shanghai
dehydriert => dehydrated; dehydrates
deformiert => deformed
modifizi => modify
q => q
mobilisi => mobilise; mobilize
frankfurt => frankfurt
uberdreht => overreved
universal => universal; over-all
laura => laura
latein => latin
kidnapp => kidnap
beduin => bedouin
nr => nr
peru => peru
plasma => plasm; plasma
captain => captain
sardini => sardinia
brr => brr
zerr => tear
packung => package
mg => mg
geplaudert => prated
lennox => lennox
eskorti => escort
monro => monroe
aufroll => unroll
sorry => sorry
sicherst => safest
bam => bam
biet => bid
canterbury => canterbury
analys => analyzing
laurel => laurel
oscar => oscar
verbiet => forbid
haddock => haddock
enoch => enoch
reaktion => reactionary
aberde => aberdeen
exhumi => exhume
talent => talent
chor => choir
magisch => magic; magical; magically; magicly
jodelt => yodels
wem => whom
prud => prude
gepruft => proved
magazin => magazine
willig => willing; willed; willingly
sexy => sexy
waterloo => waterloo
maschinenraum => machine room
uberzieh => overlay
deaktiviert => deactivated; deactivates
helios => helios
tageslicht => daylight; day light
instinktiv => instinctive; instinctively; instinctual; intuitive
manhattan => manhattan
beschmutz => besmirch; smudge
bolivi => bolivia
schmerzlos => acheless
geplagt => plagued
bombardi => bombard
diana => diana
detroit => detroit
noti => note; notice
mail => e-mail; email; mail
vorherseh => foresee
u => u
italien => Italian; italian
sur => sura
rollt => bowled; rolled
mystery => mystery
basis => basis
buddha => buddha
dov => dover
neo => neo
korruption => corruption
rumpeln => rumble
dobson => dobsonian
olympic => olympic
analysiert => analyzed; analyzes; analysed; analyses
apollon => apollo
bingo => bingo
gepries => praised
asgard => asgard
flasch => flask
orang => orange; oranges
kupf => copper
hastig => hasty; hastily
eduard => edward
stabilisi => stabilize; stabilise; establish
bik => bike
zweihundert => two hundred
verrostet => rusted; corroded
wess => whose
malta => malta
oxford => oxford
bag => bag
re => re
bath => bath
wedeln => waggle; wedel
original => original; orginal; orignal
domini => dominate
wendigo => wendigo
volljahr => full age
vor => before; for
gefickt => fucked
konzession => concession
offnet => opened
harsch => harsh; harshly
voilà => voilà
signalisiert => signaled; signalised; signalises; signalized; signalizes; signalled; signals
geschwung => swung
voll => full; fully
toleranz => tolerance
simpl => simple
lausann => lausanne
weit => wide
paprika => paprika
einstudiert => studied
grusel => gruesome
geologi => geology
om => om
klassifiziert => classified; classifies; classed; classes
atom => atom; atomy
generell => general; generally
pump => pump
kardinal => cardinal
tibet => tibet
spul => spool
frier => freeze
bemerk => remark
horn => horn; cornet
glitch => glitch
schlafend => sleeping
unterschreib => underwrite
separat => separate; separately
dauert => lasted
massiv => massier
existiert => exists; existed
campo => campo
land => land
kommerziell => commercial; commercially; commercial |com.
merlin => merlin
synchron => synchronous; synchronic; synchron; synchronously; synchronal
physikal => physical; physically; physic; physisch
schatt => shade
trend => trend
personal => personal
korean => Korean; korean
janus => janus
trac => trace
scylla => scylla
gay => gay
gebrullt => bawled; squalled
vision => vision
konn => can
glasur => glaze
sic => sic
bonbon => bon-bon
motiviert => motivated; motived; motivates
haiti => haiti
prasenti => present; represent
limitiert => limited
lautstark => outspoken
iron => ironic; ironical; ironicly
suspendiert => suspends; suspended
architektur => architecture; architectural
wirk => work
gepasst => passed
intim => intimate
gefahrlos => harmless
vampir => vamp
unantastbar => indefeasible
tora => torah
geback => baked; bake
erfrisch => refresh
einbring => bring
monogam => monogamous
cambridg => cambridge
nippel => nipple
konzipiert => conceived
praktizi => practise; practice
albert => albert
dyk => dyke
udssr => ussr
kooperi => cooperate; co-operate
deal => deal
tokyo => tokyo
starrt => stares
chisum => chisum
banan => banana
hard => hard
normalisiert => normalized; normalizes; normalised
navigi => navigate
per => per
getestet => tested
gaff => gape
tropisch => tropically
masturbi => masturbate
sierra => sierra
luxurios => luxurious; luxuriant; luxuriously; luxury
prinzipiell => principled
wofur => what for; wherefore
salomon => solomon
sima => sima
aktivist => activism
agn => agnes
bedenkt => bethinks
intellektuell => intellectual; intelligent; intellectually
prominent => prominent; prominently; eminent
unzerstorbar => undestroyable
gorillas => gorilla
amusiert => amused; amuses
sarajevo => sarajevo
untertrieb => understated
happy => happy
medaill => medallion
isoli => isolate
schmeck => smack
worin => wherein
unwurd => unworthy
korfu => corfu
francis => francis
next => next
foul => foul
komm => come
durchlass => to allow
kommunist => communistically
geparkt => parked
uberschattet => overshadows; overshadowed
tas => tasers
koma => coma
haarig => hairy; haired; hairily
uppsala => uppsala
cali => cali
kaputt => kaput
alexandria => alexandria
therapi => therapy
zwink => wink; twinkle
russisch => Russian; russian; russ
fokus => focus
skorpion => scorpion; scorpiones
portland => portland
maggi => maggie
etabli => establish
stinkt => stinks
gelernt => learned; learnt
annulli => annul
illustriert => illustrated
irisch => Irish; irish
shiva => shiva
eton => eton
suboptimal => suboptimal; optimal
halbieren => halve
sicherste => safest
indianisch => Indian; indian
palästina => palestine
dünner => thinner
kassie => cassia
caterer => caterer
kompanie => company
kompromittieren => compromise
schmutzige => smuttily
geflogen => flown
drake => drake
rotten => rotten
besprechen => bespeak
schleifen => sharpen
monitor => monitor
servierte => served
pierrot => pierrot
unterliegen => underlie
kam => came
älter => elder; older
höllisch => hellish; hellishly
arithmetik => mathematics
unterste => undermost
dreckiger => muckier; dirtier
schwirren => whirr
vorausgesehen => foreseen
gestunken => stunk; stink
sauer => sore
identische => identically
wüsten => waste
ungarisch => Hungarian; hungarian
objektive => objectively
pjöngjang => pyongyang
amazon => amazon
kommodore => commodore
schärfste => sharpest
sollten => should
dundee => dundee
ptolemäus => ptolemy
murren => murmur; mutter
genetischen => genetically
marmelade => marmalades
paarweise => pairwise
porter => porter
einpflanzen => implant
praktizieren => practise; practice
sonniger => sunnier
gebären => bear
frigide => frigid
ballistische => ballistically
anschwellen => swell
zelebrieren => celebrate
lehnte => leant
franken => franconia; franks
schatten => shade
selbstlose => selflessly
argentinier => argentine; argentinean; argentineans; argentinian
joggen => jog
füllen => fill; fills
innings => innings
seriös => serious
abladen => unload
exklusive => excluding; exclusive; exclusive of
analyse => analyzing
freitags => Fridays
persien => persia; persian
rose => rosa
hysterische => hysterical
salzburger => salzburg
waten => wade
dezember => december
elementare => elementally; elementary
gestillt => satiated
bizarre => bizarre
festgebunden => bound
charismatisch => charismatic
georgien => georgia
überlastet => overcharged; overload; overloaded; overloads
onkologie => oncology
behandelte => handled
fetter => fatter
tuten => toot
papieren => paper; papery; papier-
liberal => liberal; liberally
olympiade => olympiad; olympics
straßburg => strasbourg
ironisch => ironic; ironical; ironically; ironicly
massiver => massier
qualität => quality
eingetreten => entered
gig => gig
stopfst => stuffed
übereifrig => overeager
komplizierte => complicated
grill => grill; grille
verboten => forbidden; verboten
gestärkt => starchy; starched
twist => twist
kombinieren => combine; combinate
schmidt => schmidt
plante => planned
rest => rest
stufe => storey
arabien => arabia; araby
stottern => stutter; splutter; sputter
dynamische => dynamic; dynamicly
ästhetik => aesthetics
hierfür => therefore; therefor
standard => standard
kritische => critically
ketten => fetter
masche => mascle
größtes => greatest
traumatisch => traumatic; traumatically
kreativ => creative; creatively
englisch => English; angelic; angelical; english
sehe => see
verkrüppelt => crippled
pepper => pepper
kommunizieren => communicate; commune; comunicate
stahlen => stole
vulkanische => volcanically
angetrunken => drunken
hut => hat; hut
adonis => adonis
schizophrenie => schizophrenia
glamourös => glamorous; glamourous
schwanken => shake
kreuzigen => crucify
lange => long
kleben => cleave
passierte => passed
jennifer => jennifer
coke => coke
container => container
loyale => loyally
glätten => flatten
kratzte => scratched
garantieren => guarantee
checken => check
teller => teller
organisierte => organised; organized
märz => march
norweger => norwegian
privilegierte => privileged
entflammen => inflame
vorwarnen => forewarn
elektrischer => electrical
oswald => oswald
jener => yonder
collier => collier
sagen => say
schrieb => scribed
piepen => peep
erbringen => bring
schwindeln => swindle
irritierend => irritating
laute => loudly
realistisch => realistic; realistically; realisticly
rechtes => right
reflex => reflexion
abnormal => abnormal; abnormous; abnormally; anormal
desertiert => deserted
heilen => heal
räuber => robber
pflanzen => plant; place
mobilisiert => mobilizes; mobilised; mobilises; mobilized
bieten => bid
bolivien => bolivia
tube => tube
informierte => informed
magier => magier
glitzern => glitter; glisten
alice => alice
belgien => belgium
absorbieren => absorb
hebräisch => Hebraic; hebraic
reflektieren => reflect; be reflected
formulieren => formulate
sinken => sink; sunk
erfüllt => fulfilled; fulfills
investiere => invest
studieren => study
turbine => turbine
interessieren => interest; be interested in; be interested
skelett => skeleton
gestreifte => striped
ende => end
rapide => rapidly; rapid
plündern => plunder
lynchen => lynch; lynching
strategische => strategic
reiben => rub
senken => sink
sure => sura
finanzieren => finance
weiser => wiser
europäisch => european
explodierte => exploded
heuchlerisch => hypocritically
adelaide => adelaide
suchte => sought
buchen => beechen
offen => opened
schätzung => rating
kreieren => create
gesunken => sunk; sunken
golfen => golf
konsultieren => consult
minsk => minsk
fanatisch => fanatical; fanatic; fanatically; frenetic
unter => under
jaulen => yowl
ostwärts => eastward; eastwards
gärtnern => garden
geschnüffelt => snuffled
destabilisieren => destabilize; destabilise
ergreifend => reaching
werfen => whelp
strukturelle => structurally
innerste => innermost
klammern => clamp
idiotische => idiotically
beige => beige
streiken => strike; struck; stricken; stricken}
judäa => judea
lüstern => lusty
kauen => cam
mutter => mater
ajax => ajax
entdecken => undeck
tinker => tinker
unpersönlich => impersonal; impersonally
eintreten => enter
automatisch => automatic; automatically; automated; automatical; automaticly
landete => landed
hysterisch => hysterical; hysteric; hysterically
cc => cc:
pflücken => pluck
immunität => immunity
rebellieren => rebel
münchen => munich
emotionale => emotional
predator => predator
howdy => howdy
bessern => better
bike => bike
dänisch => danish
strenge => stringently
alarmieren => alarm
biochemie => biochemistry
wärmer => warmer
zentrales => centrically
bitterlich => bitterly
zelten => tent
leviten => levite; levites
rudolf => rudolph
freiburg => freiburg; fribourg
kantor => chanter
frustrierend => frustrating; frustratingly
albanisch => Albanian; albanian
binden => bind; band
ließ => let
erziehen => educate
aufrollen => unroll
agnes => agnes
beatmen => ventilate
pflückt => picks
achter => eighth
überziehen => overlay
elegante => elegant
vorhersehen => foresee
karton => card
hello => hello
synchronisieren => synchronize; synchronise; synchronise, sync
mönch => mönch
dexter => dexter
william => william
salutieren => salute
hörbar => hearable
luxuriös => luxurious; luxuriant; luxuriously; luxury
rasten => rest
leichteste => lightest
vegetarisch => vegetarian
infizierte => infected
steif => stiff
reiner => cleaner
kreditwürdig => creditworthy
korrekt => correct; correctly
rechnen => reckon
sexualität => sexuality
rebellisch => rebellious; rebelliously; rebel
verstreuen => strew
typen => types
rider => rider
psychiatrische => psychiatrically
unterschätzt => underrated; underestimated; undervalued
wiener => viennese
grauer => grayer; greyer
litauen => lithuania
quadrat => quadrate
illustrierte => illustrated
übergewichtig => overweight
überrannt => overrun
metamorphose => metamorphosis
elektronische => electronically
hierher => here; hither
exterminieren => exterminate
formell => formal; formally
stemmen => stem
eingreifen => encroach
heller => heller
analogie => analog
hier => here; herein
hase => hare
dynamisch => dynamic; dynamically; dymanic
karte => card
wehte => wafted
exportieren => export
selten => seldom
rauben => rob
langfristig => long-ranging
streicher => strider
fischen => fish; fishing
beladen => load; loaded; laden
schärpe => scarf
maggie => maggie
dime => dime
bunkern => to bunker
aufleben => enliven
stefanie => stephanie
visuell => visual; visually
boxen => box
mörderische => murderously
härteste => hardest
tanzte => danced
geschmolzen => molten; smelted; softened
überschritten => overshot
kontaktieren => contact
silber => silver
enthusiastisch => enthusiastic; enthusiastically
rhea => rhea
gehangen => hanged
triple => treble
gestohlen => stolen
moralisch => moral; morally
striptease => striptease
denker => thinker
alexander => alexander
tanger => tangier
appellieren => appeal
metaphorisch => metaphorical; metaphoric; metaphorically
methodisch => methodical; methodic; methodically; methodicly; methodological
cleverer => cleverer
bolognese => bolognese
fakultät => faculty
siebte => sieved
nervösen => nervy
schwimmen => swim; swimming
daten => date; data
gao => gao
private => private
banane => banana
therese => teresa
kiffen => kif
historische => historical; historical map
zuschreiben => ascribe
kaltherzig => coldhearted; coldheartedly
videospiele => video game
positionen => positions
aufwachen => awaken
streichen => strike
fassade => facade
suits => suit
esther => esther
glücklichste => luckiest
exhumieren => exhume
ficken => fuck
rekonstruieren => reconstruct
assimilation => assimilation
kommen => come
champagne => champagne
irren => err
bretagne => bretagne
originell => original; originally
demokratie => democracy
rezitieren => recite
feurigen => fierily
stocken => stick
margarete => margaret
homosexuelle => homosexually
überanstrengt => overstrained; overstrains
mitbringen => bring
schule => school
wettete => betted
abchecken => check; to check
überzogen => overcast
für => for
blamieren => blame
singapur => singapore
imitieren => imitate
schmelzen => melt; smelt; melted; melting
muster => master
sarazenen => saracen
versailles => versailles
romantische => romanesque
bemerkte => remarked
fördern => further; foster
überfordern => overcharge; overburden
tirol => tyrol; tirol
unsympathisch => unsympathetic
nordsee => north sea
handbremse => handbreak
dialyse => dialysis
texten => text
vorhergesehen => foreseen
suspekt => suspect
faszinierend => fascinating; fascinatingly
schelten => scold
schlürfen => slurp
zwingend => stringent
streifen => streak; stripe
thrakien => thrace
botanik => botany
volumen => volume
adams => adams
spalten => split
cabe => cabe
grenoble => grenoble
solaris => solaris
spezialisieren => specialize; specialise
auswärts => outward; outwards
twelve => twelve
cäsar => caesar
merkur => mercury
doppelgänger => doppelgangers; doppelgängers
strategisch => strategic; strategically; strategical
unglücklich => unluckily
ungesehen => unseen
primitive => primitiv; primitive
lime => lime
pissen => piss
posen => pose
surprise => surprise
springen => spring
spreizen => spread
syracuse => syracuse
fünfzehn => fifteen
befallen => befall
dieselbe => himself
maine => maine
debattieren => debate
barfuß => barefoot
mörderisch => murder
hypothetisch => hypothetical; hypothetic; hypothetically
psychologie => psychology
vandalismus => vandalism
papier => paper
mächtig => mighty; mightily
spritzte => sprayed
straffen => strain
autorisierte => authorised; authorized
angetreten => acceded
repräsentiert => represented; represents
anthropologie => anthropology
digital => digital; digitally; digit
leber => liver
kolumbien => colombia
polen => poland; poles
mikrowellen => microwave
kidnappen => kidnap
feierte => feted
fällt => falls; fells
grade => grade
babysitten => babysit; baby-sit
vorwärts => forward; onward; forwards; onwards; forrard
kommuniziert => communes; communicated; communicates
festigen => fasten
grinst => grins
trödeln => dawdle
komitee => committee
multiplizieren => multiply; multiplication
tänzerin => dancer
reaper => reaper
sang => sang
chinesisch => Chinese; chinese
projizieren => project
synthetisch => synthetic; synthetical; synthetically
überboten => overbid
fürchten => frighten; affright
bäh => bah
nordwestlich => northwestern; northwest; northwesterly; north-western; north-west
shoppen => shop; shoppen
amerikanisch => American; american
profitiert => profits; profited
erfüllen => fill
wundern => wonder
überschrieben => overridden; overwritten
prüde => prude
unpünktlich => unpunctual
willst => will
kapitulieren => capitulate
technik => technique
schrillen => shrill
retter => redeemer
danken => thank
familie => family
kooperieren => cooperate; co-operate
sirene => siren
lebendiger => livelier
stabilisieren => stabilize; stabilise
schwärmen => swarm
heftiger => testier
rüde => rude
trainieren => train
zoomen => zoom
wichtiger => weightier
synaptische => synaptic
innerer => interior; inner; internal
wassermelone => watermelon
geritten => ridden; bestridden
silverado => silverado
rocken => rock
mieten => let
knoten => knot
schubst => shoves
abbinden => bind
sadistisch => sadistic; sadistically
terrorisieren => terrorize; terrorise
aussortieren => assort
akustik => acoustics
respektierte => respected
habe => have
summa => summa
einlage => enclosed
demonstrieren => demonstrate
collins => collins
komponieren => compose; composition; combine
limitierte => limited
unternehmen => undertake; intend
neuste => newest
romantik => romantic
signieren => sign; designate
pragmatisch => pragmatic; pragmatical; practical; pragmatically
euphorisch => euphoric
zirpen => chirp
gesehen => seen
behandeln => handle
tricksen => trick
dealen => deal
hinbringen => bring; to bring
lecken => lick; leak
beleuchtung => lighting
marguerite => marguerite
alfie => alfie
zwitschern => twitter
antworten => answer; answering
visier => vizard
stephanie => stephanie
herodes => herod
schwede => swede
willens => willing
theoretischen => theoretical
portugiesisch => Portuguese; portuguese
urinieren => urinate
anhalten => halt
rabbiner => rabbi
organisch => organic; organically; organicly; organ
flüssig => fluidly; fluently
unhygienisch => unhygienic
demolieren => demolish
warnen => warn
schokolade => chocolate
sabotieren => sabotage
starten => start; start up
jerusalem => jerusalem
computer => computer
bestens => best
konstanz => constance
lobster => lobster
offizielle => officially
pyramide => pyramid
morgen => morn
livre => livre
newcastle => newcastle
aktuell => actual
batterie => battery
asien => asia
tiefer => deeper
indien => india
mike => mike
ist => is
rottweiler => rottweilers
theorie => theory
rhetorische => rhetorically
auspacken => unpack
verlängert => elongated
luther => luther
telefonieren => telephone
buzz => buzz
elektrisches => electrically
strenger => sterner; stricter
mittleres => middle; middling
freundlicher => friendlier
kalibrieren => calibrate; calibrating; calibration
rollen => roll
hydra => hydra
route => route
schockierende => shockingly
demokratisch => democratic; democratically; democrat
finnisch => Finnish; Finnic; finnish
pädophil => pedophilic; paedophile; paedophiliac; paedophilic; pedophiliac; pedophile; pædophiliac; pædophilic
xerxes => xerxes
dame => dame
faszinieren => fascinate
siehe => see
etablieren => establish
diagnose => diagnosis
injizieren => inject
klappern => clatter
attackieren => attack
spaten => spade
erfroren => frozen
mathematische => mathematically; mathematics
hacken => hack
starren => stare
kreative => creatively
literatur => literature
nordwestlichen => northwestwards
hunger => hunger
chester => chester
unglücklicher => unluckier
sangen => sang
letzter => latter
militärisch => military; militarily; militant; militarism; militar
unterschreiben => underwrite; undersign
scooter => scooter
geschüttelt => rattled
schleimiger => slimier
schnappte => snapped
symmetrisch => symmetrical; symmetric; symmetrically
trotter => trotter
bernie => bernie
cutter => cutter
pathetisch => pathetic
hängt => hangs
kalifornien => california
ununterbrochen => uninterrupted
dichter => tighter
identifizieren => identify
mutigste => gutsiest
überwältigen => overmaster
pudern => powder
brasilianer => brazilian
klaustrophobisch => claustrophobic
can => can
zerren => tear
dreihundert => three hundred
gestreckt => straight; stretched
intubieren => intubate
ap => ap
sibirien => siberia
warmherzig => warmhearted; warm hearted; warm-hearted
inspirierend => inspiring; inspirational; inspiriting
morden => murder
stressen => stress
desertieren => desert
charlotte => charlotte
schockierte => shocked
schreiende => screamingly
fliehen => flee
trichter => crater
mutierte => mutated
richten => straighten
härter => harder
repräsentieren => represent; represents
umschreiben => describe
philosophisch => philosophical; philosophic; philosophically
inhalieren => inhale
together => together
anbringen => bring
gepflückt => plucked
wollen => will; woolen; woollen; woolly
schrubben => scrub
melancholisch => melancholic; melancholy
spektakulär => spectacular; spectacularly
revidieren => revise; review
picknicken => picnic
phrase => phrase
rogers => rogers
minimale => minimal
milwaukee => milwaukee
peugeot => peugeot
fechten => fight
aufstellen => install
unbeständig => unsteady
reicher => richer
suspendieren => suspend
modernste => modernest
hektische => hectically
kurzsichtig => short-sighted; shortsighted; shortsightedly
genetische => genetical
einpacken => pack
interpretieren => interpret
formen => form; forge
providence => providence
basen => base
telemetrie => telemetry
unbestreitbar => unquestionable
brigadier => brigadier
capote => capote
dieses => these
ukrainer => ukrainian
kommentar => comment
melbourne => melbourne
jungen => young
erwachen => awaken; waken
scham => shame
unlogisch => illogical; illogically
schärfsten => sharpest
josefine => josephine
roger => roger
rouge => rouge
runde => rotundly
wärmen => warm
service => serve
sportsgeist => sportsmanship
rekrutieren => recruit
asbest => asbestos
überqueren => overcome
torte => torte
schockieren => shock
dämonische => demonic
guise => guise
kennen => ken
mantle => mantle
hämmern => hammer; hammering
albino => albino; albinism
innerlich => internal; interior; internally
kosmische => cosmic; cosmical
reservieren => reserve
simone => simone
gazette => gazette
track => track
typische => typical
indisponiert => indisposed
schäbiger => shabbier
übernachten => stay overnight; overnight
lose => loose
lüften => lift
vorprogrammiert => preprogrammed
real => real
prostituierte => prostituted
nobelpreis => nobel prize
florin => florin
bronze => bronze
indonesien => indonesia
roy => roy
tippen => tap
kultur => culture
isländer => icelander
solide => solid; solidly
koscher => kosher; kasher
cracker => cracker
definieren => define; defines
magere => meagerly
morse => morse
äthiopien => ethiopia
fünfte => fifth
klingelte => jingled
klonen => clone
diamanten => diamond; diamantine
konservieren => conserve
wagenladung => wagonload
leukämie => leukemia
yankee => yankee
obszön => obscene; obscenely
niger => niger
pausieren => pause
automatische => automated
brandneu => brand new; brand-new
individuelle => individuals
bogen => bow
quieken => squeak
beginnen => begin
hungrige => hungrily
pip => pip
fotogen => photogenic
würdiger => worthier
frischer => fresher
kippen => tip
tuberkulose => tuberculosis
unterbrochen => interrupted
digger => digger
grünen => green
normalisieren => normalize; normalise; nomalize
glücklicher => luckier
klingonisch => klingon
israel => israel
laird => laird
initiieren => initiate
genervt => peeved
stürmen => storm
hen => hen
carrie => carrie
meins => mine
geschrien => cried
metalle => metal
verwundete => wounded
systematisch => systematic; systematically; systematical; symmetrically
gestürmt => stormed
abfüllen => fill
armenier => armenian; armenians
drache => drake
melone => melon
tränken => drench
driften => drift
schocken => to shock
garage => garage
deprimierend => depressing
sodass => so as
atmosphärische => atmospherical
doodle => doodle
realisieren => realize; realise
pcp => pcp
kommend => upcoming; coming
überflutet => overflooded
schockierend => shocking
allmächtig => almighty; almightily
manipulieren => manipulate
reinste => cleanest
göteborg => goteborg
dyke => dyke; dike
übertreiben => overdo
klingonen => klingons
clement => clement
schliefen => slip
schnüffelt => sniffles; snuffles
nürnberg => nuremberg
anker => anker
fotografieren => photograph
single => single
lesbe => lezzer
jingle => jingle
provence => provence
offline => offline; off-line
konsumieren => consume; consuming
innerhalb => internal; internally
mathematisch => mathematical; mathematic; mathematically
grundwasser => groundwater
libyen => libya
beantwortete => answered
romulaner => romulan; romulans
tunesien => tunisia
beweinen => bewail
bündeln => bundle
wirken => work
negative => negatively
gespalten => split
algier => algiers
schwellen => swell; swell up; swollen
umprogrammieren => reprogram
toxikologische => toxicologically
italiener => italian; italians
vulgär => vulgar; vulgarly
schnüffeln => sniffle; snuffle
rosette => rosette
hygienisch => hygienic; hygienically
geboten => bidden; bid
warner => warner
sabbern => slaver; slobber
telefonisch => telephonic; telephone; telephonically
getrieben => driven
einparken => park
sokrates => socrates
nettesten => nicest
amerikaner => american; americans
produzieren => produce
brite => brit; briton
hannover => hanover
victor => victor
blockieren => block; blockade
chatten => chat
phönix => phoenix; phenix
pfeifen => pipe
krone => koruna
gaffen => gape
unterschrieben => underwritten; undersigned
feilen => file
campen => camp
erleuchten => enlighten; light; lighten; brighten
ausdiskutieren => to dispute
bestreben => strive; striven; striven}
mailänder => milanese
achte => eighth; eighthes; eighths
schmuggelte => smuggled
unterziehen => undergo
assistieren => assist
explodieren => explode
killen => kill
komische => comically
klicken => click
strömen => stream
grüner => greener
reichen => reach
nachts => nighttime; nights; night
übertrumpfen => overtrump
bellen => bellow
zigarette => cigaret
maske => masker
heiliger => holier
serbien => serbia
impuls => impulsion
nordamerika => north america
übereilt => overhasty
epische => epical; epic
ziellos => aimless
übertrumpft => overtrumps; overtrumped
dieser => these
erfunden => unfounded
gründete => grounded
deaktivieren => deactivate; inactivate
unterwegs => underway
orange => orange; orange tree; oranges
meinen => mean; imagine
tendieren => tend
daphne => daphne
hysterischen => hysterically
äquivalent => equivalent
pinkelte => piddled; tinkled
alphabetisch => alphabetical; alphabetic; alphabetically
paaren => pair
albanien => albania
verschreiben => prescribe
palästinenser => palestinians
save => sava
mathematik => mathematics
more => more
retriever => retriever
joyce => joyce
schultern => shoulder
james => james
tänzer => dancer; dance
gepumpt => pumped
engagieren => engage
damaskus => damascus
beten => beg
frostig => frosty; frostily
seine => seine
ballen => ball
bomben => bomb; bombing
historischen => historically
sitzen => sit
amputieren => amputate
hornissen => hornet
aussicht => sight
basierend => basing
tutti => tutti
quaken => quack
variieren => variegate
schmieren => smear
belle => belle
lauda => lauda
faschistische => fascistically
masturbieren => masturbate
bukarest => bucharest
lahme => lamely
tanzen => dance; dancing
hunderte => hundreds; hundredths
cassiopeia => cassiopeia
symbolisch => symbolic; symbolical; symbolically
adoptierte => adopted
steinigen => stoning
fiedler => fiddler
appetitlich => appetizing; appetising; appetizingly
date => date
hoffen => hope
überbewertet => overvalued
trailer => trailer
hackte => hacked
neurotisch => neurotic; neurotically
junker => junker
glücklich => luckily
antwerpen => antwerp
exzellenz => excellence
göttin => göttin
samen => sami
bluffen => bluff
blocks => blocks
hämmert => hammerd
dinieren => dine
weißen => whiten
alle => all
hielt => halted; held
lille => lille
pipeline => piping
falten => fold
kroatien => croatia
kicken => kick
hydraulik => hydraulic
gurren => curr
bestellen => tell
spencer => spencer
leuchten => brighten
fließend => flowing; floating
unpraktisch => impractical; unpractical; impractically; nonpractical; unpractically
steinen => stonen
starrte => stared
spit => spit
eliminieren => eliminate
politisch => political; politically; politic
parlament => parlement
greifen => grip; reach
weinend => weeping
schmutziger => smudgier; frowzier; smuttier
karen => karen
geschworen => sworn
nordwärts => northward; northwards
endete => ended
rhetorisch => rhetorical; rhetoric; rhetorically
valentinstag => valentine's
luna => luna
fine => fine
fantastische => fantastic
rechtens => right
erfrischend => refreshing
necken => heckle
trinken => drink; take
artemis => artemis
gebissen => bitten
rath => rath
dokumentieren => document; documenting
beschämend => shaming
undercover => undercover
erreichen => reach
anekdote => anecdote
klingonin => klingon
anomalie => anomaly
komtesse => countess
fantastisch => fantastic
kasten => casing
konfrontieren => confront
messung => metering
siebente => seventh
charmant => charming
dolly => dolly
israeli => israeli
spartaner => spartan
sylvester => sylvester
traumatisiert => traumatised; traumatises; traumatizea; traumatized
warnt => warns
watt => watt; watts
schmecken => smack
kosten => cost
beduinen => bedouin
knackte => cracked
furzen => fart
gottlose => godlessly
traditionell => traditional; traditionally
diese => these
vipern => viperidae
beschworen => sworn
ungenießbar => inedible; uneatable; unbearable; unpalatable; unenjoyable
erklärt => declared; declares
malmö => malmo
aorta => aorta
wiehert => whinnies
symbolische => symbolically
wehe => woe
ältester => oldest
überspielt => overplayed
katholisch => Catholic; catholic; Catholically
warten => wait
elektronisch => electronic; electric; electronically
woher => where
zwölfte => twelfth
bar => bare; bar
rechts => right; right side
artikel => article
koordinieren => coordinate
lausig => lousy; lousily
ethnische => ethnical
kapitol => capitoline
diplomatisch => diplomatic; diplomatically
lauter => louder
diversen => diverse
gebumst => bumped
lausanne => lausanne
fife => fife
webseiten => websites
phantastisch => fantastically; fantastic
neurologische => neurological
kurieren => cure
schämen => shame; ashamed
höhnisch => cynical
japanisch => japanese; Japanisch
alter => elder
offene => open
reykjavik => reykjavík
guam => guam
länger => longer
konzentrieren => concentrate
neue => new
genetik => genetics
interviewen => interview
medium => medium
sizilianer => sicilian
angeboren => inborn
präsentieren => present
reaktionär => reactionary
kalif => calif
rappen => rap
ausschwärmen => swarm
philosophische => philosophically
tango => tango
glühend => glowing
café => café
tätowiert => tattooed
gebacken => baked; bake
verkrampfen => cramp
innen => inner
anstreben => aspire; strive
pantomime => pantomime
mittlerer => middle; middling
schande => shame
trunken => drunken; drunk
erlernt => learned; learnt
freigeben => free
autorisieren => authorize; authorise
kaffee => coffee
regenerieren => regenerate
dinosaurier => dinosaur; dinosaurs
raven => rave
wrestler => wrestler
zapfen => tap
rumänien => romania; rumania
bostoner => boston; bostonian
brüssel => brussels
zittern => jitter
analysierte => analyzed; analysed
hebräer => hebrew; hebrews
harmonisch => harmonious; harmonic; harmoniously; harmonicly; harmonical; harmonically
nippen => sip
katholische => catholically
marokkaner => moroccan
saboteure => saboteur
funktionierte => functioned
knacken => crack; crackle
jordanien => jordan
manövriert => maneuvers; maneuvered
klüger => cleverer
formieren => form
regen => regen
sparen => spare
runter => under
grasen => graze
rückwärts => backwards; backward; rearwards
essbar => edible; eatable
biologisches => biologically
psychotisch => psychotic
stuttgart => stuttgart
spinnen => spin; spinning
chemotherapie => chemotherapy
devonshire => devonshire
erotik => erotica
tropischen => tropically
legende => legend
witziger => wittier
biber => biber
ducken => duck
eigentlich => essentially
agathe => agatha
lieber => rather
tracker => tracker
erhängen => hang
kardiologie => cardiology
identisch => identical; identic; identically
isolieren => isolate; insulate
hängen => hang; dangle; hung
zentrale => centrally
helene => helen
aria => aria
pflügen => plough
ebbe => ebbe
biologisch => biological; biologically; biologic
nisten => nest; nestle
store => store
ingwer => ginger
japsen => yap; japs
sire => sire
rouen => rouen
produktivität => productiveness
inkompetent => incompetent
fette => fatty
danke => thanks; thank
beleuchtet => lighted
erfrischen => refresh; freshen
haben => have
psychisch => psychic; psychological; psychical; physical; psychologically
hindern => hinder
thriller => thriller
teleportieren => teleport
phänomenal => phenomenal; phenomenally
küssen => kiss
elektromagnetische => electromagnetically
valentine => valentine
medizinisch => medical; medicinal; medically; medicinally
mütterlich => maternally
balance => balance
klammerte => clamped; clasped
barbarisch => barbaric; barbarian; barbarous; barbarously; barbarianly; barbarically
auffrischen => freshen
long => long
theoretisch => theoretical; theoretic; theoretically; theoreticly
problematisch => problematic; problematical; problematically
abends => evenings
aufwecken => awake; awaken
halluzinieren => hallucinate
beschreiben => describe
jane => jane
scheuen => eschew; shun
blond => blond; blonde
verbieten => forbid
stoppen => stop
trucker => trucker
ausweiten => to widen
helfen => help
wunderbare => wonderfully
praktische => practically
software => software
grönland => greenland
symbiose => symbiosis
defensive => defensively
way => way
ordinär => ordinary
überreagieren => overreact
faszinierte => fascinated
penelope => penelope
gefunden => found; funds
vergeben => forgive
sympathische => sympathetically
harmlose => harmlessly
helena => helen
bestialisch => bestial
motivieren => motivate
monogamie => monogamy
bastille => bastille
western => western
schriller => shriller
interessanten => interestingly
camden => camden
riskanter => riskier
spektakuläre => spectacular
zone => zone
westen => west
gläsern => glassy; glass
programmierten => programmed
telefone => telephones
scheinen => shine
schaben => shave
steppe => steppe
laden => load; upload; loading
vietnamesisch => Vietnamese; vietnamese
übermüdet => overtired
chile => chile
janice => janice
spulen => spool
brechen => break; breach
antarktis => antarctic; antarctica
industrie => industry
time => time
riskierten => risked
abgebrochen => broken
passen => pass
bohren => bore
missen => miss
schmerzen => smart
gefallen => fallen
psychologisch => psychological; psychologically; psychologic
mailen => e-mail; email; mail
hunderttausend => hundred thousand
motherfucker => motherfucker
dümmer => dumber
georgetown => georgetown
unterschätzen => underestimate; underrate; undervalue
mechanischer => mechanical
sanken => sank
knattern => chatter
ill => ill
drastische => drastically
exotisch => exotic; exotically
belagern => beleaguer
belgier => belgian
kolumbianer => colombian
aktivierte => activated
elbe => elbe
gemeiner => meaner
lernte => learned; learnt
herbringen => bring
gepriesen => praised
kritisieren => criticize; criticise
steiler => steeper
betrunken => drunk; drunken; get drunk
turin => turin
verbarrikadieren => barricade
hugo => hugh
schoß => shot
hopper => hopper
mores => mores
funktionieren => function
markieren => mark
sacken => sack
reparierte => repaired
karibik => caribbean
psychologische => psychologically
koffeinfrei => caffeine-free
paradies => paradise
aaron => aaron
brasilien => brazil
dose => dose
angeschwollen => swollen
louvre => louvre
vibrieren => vibrate; vibration
unrealistisch => unrealistic; unrealistically
niederlande => netherlands
akademische => academical; academics
östrogen => estrogenic
kräftiger => heftier
meistern => master; mastery
muskulös => muscular; muscly
sterilisieren => sterilize; to sterilise; sterilise
untypisch => atypical; nontypical; untypical; untypically; atypic
stampfen => stomp; stamp; tramp; tamp
reichte => reached
zürich => zurich
teuerste => dearest
füllt => fills; fulfills
evakuiert => evacuated; evacuates
wollte => would
schade => shame
distanzieren => distance oneself; distance; outdistance
blasen => blow
ruinierte => ruined
akute => acutely
überlaufen => overflow; overrun
smash => smash
burgunder => burgundian; burgundy
ärgern => anger
reserve => reserves
wales => wales
präsent => present
mimen => mime
mammuts => mammoth
niagarafälle => niagara falls
sichten => sight
dahinten => behind
londoner => london; londoner
jamaikaner => jamaican
garantierte => guaranteed
psychiatrischen => psychiatrical
pumpen => pump
gebrochen => broken; brokenly
schwer => severe
promenadendeck => promenade deck
outen => out
kälter => colder
horten => hoard
ruinieren => ruin
kreuzweise => crosswise
filzen => felt
natalie => natalia; natalie
vordere => former
wäsche => washables
pasta => paste
wanderte => wandered
juristisch => juridical; juristic; juridic; juridically; juristical
neptun => neptune
immens => immense; immensely
überfüllt => overfilled
epilepsie => epilepsy
chicagoer => chicago
wasser => water
recherchiert => researched
kompensieren => compensate; compensate for
investierte => invested
medizinische => medically; medical
iowa => iowa
namenlose => namelessly
sicherer => securer
rammen => ram
unnatürlich => unnatural; unnaturally; nonnatural
gespenstisch => spectral; spectrally
kantine => cantina
ausländer => outlander
streifte => streaked; striped
funktionsfähig => functioning
miauen => miaow; miaou
super => super
persönlich => personal; personally
hypnotisieren => hypnotize; to hypnotise; hypnotise
hoffte => hoped
herzzerreißend => heartbreaking
schlummern => slumber
luise => louisa
befestigen => fasten
jupiter => jupiter
hat => has; hath
kriechen => crawl; cringe; crouch
christoph => christopher
dramatische => dramatically
teuer => dear
trace => trace
carter => carter
filtern => filter; filtrate; to filter
hebe => hebe
enden => end
poetisch => poetic; poetical; poetically
achilles => achilles
ausbreiten => spread
eskalieren => escalate
backstage => backstage
interagieren => interact
japaner => japanese
schnupfen => snuff
alkmene => alcmene
halbwegs => halfway; half-way
beatrice => beatrice
liquidieren => liquidate
bridge => bridge
missverstanden => misunderstood
türkisch => Turkish; turkish
mace => mace
impotent => impotent
schrammen => scrape
finden => find
peter => peter
unterstreichen => underscore
be => bee
skalpieren => scalp
stärken => starch
image => image
fohlen => foal
code => code
ungeschoren => unshorn
telefonierte => telephoned
experimentierte => experimented
versklaven => enslave
branche => branch
kohlenhydrate => carbohydrate
arrangieren => arrange
granada => granada
mächtiger => mightier
weggeben => be given
neutralisieren => neutralise; neutralize
brocken => brake; brocken
walter => walter
genial => genius; genial
budapest => budapest
überrennen => overrun
ignorierte => ignored
elektrisch => electric; electrical; electrically; electronic; by electricity
andocken => dock
vorgeschrieben => prescribed
tritt => treads
existieren => exist; existence
halten => halt
prostata => prostate
marschierte => marched
links => links
chaotisch => chaotic; chaotically
champagner => champagne
senden => send
stammen => stem
kojoten => coyote
koran => koran
akustische => acoustically
selbst => self
grunzt => grunts
reinigen => cleaning
flankieren => flank
transportieren => transport; transfer
vanille => vanilla
wartete => waited
deponieren => deposit; depose; deposite
erstklassig => first-class; first class
heulen => howl
klarmachen => clarify
preisen => praise
spanier => spaniard; spaniards
toulouse => toulouse
kupfer => copper
ukraine => ukraine
römer => roemer
beschmutzen => besmirch
breiter => broader
gesprungen => sprung
flash => flash
skandalös => scandalous; scandalously
informieren => inform
genetisch => genetic; genetically; genetical; genic
schärfen => sharpen
meinte => meant
gebrochene => broken
stoßen => stub
johannesburg => johannesburg
über => over
überrollt => overruns; overrun
makaber => macabre
bremen => bremen
allergisch => allergic; allergically; allergenic
voller => fuller
nostalgisch => nostalgic; nostalgically
schulen => school
goldfinger => goldfinger
trällert => trolls; trills
exemplar => exemplar
klasse => class
sehen => see
annullieren => annul
ausladen => unload
chemische => chemically
zarter => tenderer
illegal => illegal; illegally
pünktlich => punctual; punctually
radieschen => radishes
karate => karate
verschmelzen => smelt
hearts => hearts
befriedigend => gratifying
schamlose => shamelessly
majestätische => majestical
vertiefen => deepen
erwärmen => warm
junkie => junkie
brillant => brilliant; brilliantly
nase => nose
hessen => hesse
christine => christina; christine
recycelt => recycled
zehn => ten
präsentiert => presents; presented
optimal => optimal; optimum; optimally
geblasen => blown
hinterhältig => underhand
geplündert => plundered
dekorieren => decorate
unabdingbar => inalienable; inevitable; unalienable
klassischer => classical
weise => wise; wisely
george => george
pariser => paris; parisian
riskierte => risked
sprechen => speak
meiner => mine
nose => nose
kurs => course
philosophischen => philosophical
katastrophale => catastrophically
planen => plan; plot
kürzeste => shortest
halber => half
jemen => yemen
gruppen => groups
rechte => right
lackieren => lacquer; laquer
natürlich => natural; naturally
nordafrika => north africa
argentinien => argentina
übersee => overseas
packen => pack; package
awesome => awesome
tolerant => tolerant; tolerantly
hollywood => hollywood
zange => tong
energie => energy
restaurieren => restore
rammte => rammed
rehabilitieren => rehabilitate
vancouver => vancouver
organ => organ
majestätisch => majestic; majestically
nuklear => nuclear
observieren => observe
unterzeichnen => undersign
korallen => coral red; coral
reichste => richest
meridian => meridian
worden => were
steuerbord => starboard
westwärts => westward; westwards
rhythmisches => rhythmically
saudi => saudi
leinen => linen
übermorgen => overmorrow
marschieren => march
struktur => structure
involvieren => involve
luzifer => lucifer
tombstone => tombstone
zufrieden => chuffed
schärfer => sharper
riskieren => risk
stopfen => stuff; stop
blutlinie => bloodline
übertreten => overstep
spannen => span
rostiger => rustier
qualifizierte => qualified
flexibel => flexible; flexile; pliable
ungebunden => unbound; independent
rosten => rust
bewegend => budging
privilegierten => privileged
arsen => arsenic
fördert => furthers; fosters
mexikanisch => Mexican; mexican; mexikan
vicomte => vicomte
radikale => radically
anmerken => mark
filter => filter
füllte => filled
betrügen => betray
provozieren => provoke
spritzen => spray; splatter; spatter; spritz
eurydike => eurydice
pausenlos => pauseless
reifen => ripen
unwissend => unwitting
benny => benny
joghurt => yoghurt
umhängen => hang
neuer => newer
religiös => religious; religiously
steifen => stiffen
afrikaner => african
pace => pace
romantisch => romantic; Romantic; romance; romantically
klappen => clap
zusagen => to agree
hechelt => hatcheled; heckled