fini => afgelopen
pub => advertentie; reclame; kroeg; promotie
protéger => beschermen; bewaren; behoeden; bewaken; de wacht hebben; hoeden; waken over; beveiligen; beschutten; verdedigen
britannique => Brits; Brit; Britse
cette => deze; dit; die; dat
perdre => verliezen; kwijtraken; opgeven
fondée => gesticht
explique => uitgelegd
promesses => beloften
quotidienne => alledaags; dagelijks
misent => wedden
note => aantekening
besoin => behoefte; vereiste; nood; noodzaak; plicht; voorwaarde; desideratum; gewenste; verlangen; wens
est => oosten; oost; is; oriënt; oostelijk; oostwaarts
vie => leven; hachje; levend; levensduur; aanzijn; in leven; kost; levenslijd
lance => speer
appelait => riep
utilisateurs => seats
professeur => leraar
résume => overzicht
données => gegevens; data; informatie
mises => updates
relève => aflossing
entreprises => bedrijfsleven; ondernomen
batailler => strijden; vechten; strijd voeren; kampen
nombre => aantal; getal; tal; hoeveelheid
bâti => constructie
télé => televisie; tv; teevee
fermé => gesloten; afgesloten; dicht; toe; Gesloten verzameling; besloten; inwendig
boursière => ganjokrab; klapperdief; kokoskrab; palmendief
gagneraient => voordeel
ce => deze; dat
par => door
des => van de; van het
comme => als; zoals; gelijk; omdat; aangezien; daar; want
car => omdat; aangezien
autres => andere
rouges => rood
usage => gebruik; toepassing; gewoonte; aanwending; bediening; behandeling; benutting; hantering; inzet; manier
mise => kleding; aanwending; beschikbaarstelling; buitenwerkingstelling; opmaak; opwaardering
application => toepassing; ijver; vlijt; naarstigheid
fois => keer; maal; -voudig; eens; beurt; driemaal; een keer; eenmaal; nogmaals
va => zullen
rob => beroven
monde => wereld; aardrijk; aardbol; heelal; aarde; leven; rijksappel; aanloop
cloué => genageld; gespijkerd
promis => beloofd; toegezegd
partie => deel; onderdeel; stuk; gedeelte; wedstrijd; bestanddeel; stem
changements => verandering
estimée => geschatte
lancé => gelanceerd
intéresse => geïnteresseerd
si => als; indien; ja; jawel; of; toch; wel; immers; zeker; ingeval
temps => tijd; weer; poos; periode; weersomstandigheden; weder
utilisateur => gebruiker; gebruikster; eindgebruiker; verbruiker
entier => volledig; heel; vol
bonne => goed; dienstmeid; lekker; aangenaam; dienstmeisje; meid; goede; aangename; geil; heet
vendu => verkocht; corrupt
vos => je; uw; jullie; jouw; ulle
montagne => berg; gebergte; Berg; heuvel
soumis => onderdanig; bottom; weltevreden
commerce => handel; nering
publicitaires => reclame
pourrait => kon
vendredi => vrijdag
aux => de; het; aan de; aan het; naar de; naar het; afluisteren; naar
dépend => hangt af
que => dat; dan
imprimée => gedrukt
correctement => juist; correct; goed; behoorlijk; naar behoren
supprimer => afschaffen; verwijderen; opheffen; schrappen; uitroeien; verdelgen; doorhalen; liquideren; tenietdoen; annuleren
expliquer => verklaren; uitleggen; toelichten; uiteenzetten; beduiden; verhelderen; duidelijk maken; afwikkelen; ontrollen; uitrollen
mèneront => leiden
règlement => verordening
vague => golf
plusieurs => verscheidene; ettelijke; diverse; veel; meerdere; menig; vele; verscheiden
annonceurs => adverteerders
dans => in; binnen; per; te; op; binnenin
généralise => veralgemeent
victime => slachtoffer; dupe; getroffene; offer; moord; opoffering; prooi
autour => havik; om; rond; rondom; eromheen; daaromheen; omheen; ongeveer; in het rond; langs
réseaux => netwerken
très => erg; heel; zeer; bijster; bijzonder; terdege; in hoge mate; wat; aanzienlijk; grotendeels
but => doel; doelstelling; doelwit; honk; doelpunt; bedoeling; oogmerk; wit; goal; reden
alors => dan; toen; destijds; toenmaals; toentertijd
réseau => netwerk; net; elektriciteitsnet; circuit; computernetwerk; rooster; aardgasnet; domein; kabelnetwerk; netwerken
pourraient => kon
dont => waarvan; wiens; waarover; wier; waarvandaan; van wie; diens; waarom; dier; waardoor
du => van de
au => naar; de; het; aan het
dit => verteld; vertelde; vertelden; zogenaamd
à => naar; bij; aan; op; tegen; voor; te; met; tot; in
peuvent => kan
vigueur => sterkte; forsheid; stevigheid; bedrijvigheid; animo; drukte; opgewektheid; stoerheid; tierigheid
numériques => digitaal
conseil => raad; advies; raadgeving; aanmaning; aansporing; vermaan; vermaning; waarschuwing; aanwijzing; raad(gevend lichaam)
extérieur => uitwendig; buitenkant; daarbuiten
aller => gaan; rijden; lopen; gesteld zijn; varen; het maken; verlopen; karren; zich begeven; van stapel lopen
vulnérable => kwetsbaar
protection => bescherming; begunstiging; toeverlaat; aegis; auspiciën; beschermende brillen; beschermheerschap; beveiliging; hoge bescherming
pourtant => echter; toch; niettemin; maar; desondanks
presque => bijna; vrijwel; zo goed als; bijkans; haast; schier; nagenoeg; zowat; welhaast; als
dénoncer => aangeven; verklikken; aanbrengen; klikken; opzeggen; aanklagen; beschuldigen; afkeuren; aan de kaak stellen; aan het licht brengen
revendique => vorderingen
for => fuero
représentent => vertegenwoordigen
confidentielles => vertrouwelijk
depuis => sedert; sinds; vanaf; met ingang van; sindsdien; van voor; uit; van; aangezien
pas => stap
derniers => laatst
entrer => binnengaan; binnendringen; ingaan; binnenkomen; binnenlopen; doordringen; doorstoten; op het station aankomen
voiture => auto; wagen; wagon; rijtuig; automobiel
avoir => hebben; zijn; dragen; erop nahouden; aanhebben; activa; bezit; tegoed
totalement => geheel; helemaal; totaal; volkomen; volledig; finaal; heel
delà => voorbij
premiers => eerste
ainsi => zo; zodanig; aldus; dus; zozeer; op die manier; dusdanig; vervolgens; alzo; dermate
littéralement => woordelijk
de => van; uit; door; vanwege; met; om; aan; voor; jegens; op
désormais => voortaan; in het vervolg; van nu af aan; vanaf nu; nu; aanstaand; in de toekomst; toekomend; toekomstig; vanaf
rejoignant => aansluiting
mouvement => beweging; zet; slag; beurt; gebaar; vertier; zwieping
autre => ander; overig; verder
vilipender => door het slijk halen; minachten; misprijzen; onteren; uitschelden
expiatoire => zoen
savoir => weten; kennen; kunnen; kennis; denken; wetenschap; in staat zijn te; kundigheid; leren kennen; onderzoeken
numérique => digitaal
messagerie => besteldienst; mail
souhaitant => wensen
publicité => reclame; advertentie
plus => meer
assez => genoeg; nogal; tamelijk; voldoende; vrij; basta; aardig; redelijk; een beetje; ietwat
entre => tussen; onder; te midden van; onder ons gezegd en gezwegen; ertussen; tussendoor; tussenin
impact => botsing
bien => goed; zeer; bezitting; landgoed; bezit; boerderij; oké; bijzonder; erg; heel
pilori => schandpaal; kaak
toute => alles; al; alle; allemaal; elk; elke; gans; ganse; heel; hele
ils => zij; ze; hen; hun
exigences => vereisten
raison => rede; verstand; reden; aanleiding; oorzaak; beweegreden; grond
actionnaires => aandeelhouders
argent => zilver; geld; poen; zilveren; cash; contant; contanten; Zilver
dernière => afgelopen; laatste; voorbij; voorbije
loin => ver; verwijderd; weg; heen; over; vandoor; voort; uit; ververwijderd; afwezig
trésor => schat; Schat; beminde; geliefde; juweel; lieveling; schattebout; thesaurus; schatkamer; schatkist
indispensables => essentieel
estiment => schatting
jeudi => donderdag
ces => deze
être => zijn; wezen; worden; schepsel; verkeren; hebben; creatuur; staan; zich bevinden; bestaan
prospère => welvarend; geslaagd; succesvol; welgesteld
géant => reus; reusachtig; enorm; giantisch
membre => lid; lidmaat; ledemaat; penis; lichaamsdeel; deel
faire => doen; maken; zijn
su => geweten
venir => komen; klaarkomen; zijn; aan zijn gerief komen; een orgasme hebben; ejaculeren; kommen; meegaan
où => waar; waarheen; waarvan; waarvandaan; waar ... heen; waar ... naar toe; waarop; wanneer; dat; waarin
celles => die
sciences => kunde
déjà => al; reeds; alreeds; alvast; bereids; nu al; ook al weer; nual; vast; zo goed als
quitter => verlaten; laten varen; achterlaten; in de steek laten; vertrekken; in de steek late; opgeven; beëindigen; weggaan; afsluiten
sûr => zeker; veilig; betrouwbaar; stellig; vast; ongevaarlijk; gewis; vertrouwd; safe; verzekerd
plate => vlet
mains => handen
cela => dat; die; datgene; zulks; zo; det; eraan; het volgende
question => vraag
ça => dat; die; datgene; zulks; Es; det; er; het; hij; id
davantage => meer; meer van; verder
celui => degene; die; dat; gene; diegene; de
tout => alles; al; alle; ieder; heel; allemaal; geheel; elk; bijzonder; erg
appelant => beller
ceux => die
sud => zuiden; zuid; zuidelijk; Zuiden; beneden
jours => dagen
ses => zijn; haar; hun; d'r; de zijne; d’r; ervan; iemands; z'n; z’n
unis => verenigd
arrêtaient => gestopt
semaine => week
économique => spaarzaam
journal => krant; dagblad; nieuwsblad; blad
sans => zonder; gespeend van; ontbloot van; vrij; -loos; verstoken van; zonder te; ex; -vrij
affaires => dingen; spullen; bedrijf; maandbloeding; maandstonden; menstruatie; ongesteldheid; regels; zaak; bezittingen
veille => vooravond; vorige dag; wake; slaapstand; vóóravond; Stand-by; dag voordien; stand-by
travaille => werken
la => het
viabilité => levensvatbaarheid
sur => op; bij; aan; over; ten huize van; boven; omhoog; daarboven; erop; omtrent
patron => baas
boulets => bal
tourmente => bui; onweer; onweersbui; storm
même => hetzelfde; zelfs; dezelfde; zelf; gelijk; identiek; zelfde; dito; eens; vanzelf
aussi => ook; eveneens; daarom; evenzeer; tevens; zo; even; mede; bijgevolg; bovendien
ont => hebben
notamment => onder andere; onder meer; zoal; met name; vooral; opmerkelijk; in het bijzonder
devant => voor; vooraan; daarvoor; eerder; indertijd; voorheen; voorkant; vroeger; weleer; voorzijde
tiré => getrokken
célèbre => beroemd; befaamd; gevierd; alom bekend; vermaard; welbekend; wijdvermaard; roemruchtig; bekend; illuster
soucier => zorgen
pression => druk
lui => hem; hij; haar; aan hem; aan ’m; daaraan; de; eraan; erheen; het
son => zijn; geluid; haar; klank; zemel; gerucht; zemelen; hare; toon; zijne
voitures => auto
médiatique => media
deux => twee; halveren; tweede; tweemaal; tweetal
soit => ofwel; of; afgesproken; akkoord; dat wil zeggen; goed; hetzij; in orde; okee; top
cofondateur => medeoprichter
the => de
se => zich; zichzelf; elkaar
qu => dat
avant => voor; eerder; voordien; vroeger; voorkant; voorzijde; voorheen; boeg; vóór; voordat
effacer => wegvagen; uitwissen; wissen; wegvegen; uitvegen; wegwissen; vegen; afdrogen; afvegen; afwissen
fonctionne => werken
il => hij; het; hem
inverse => tegengesteld; omgekeerd; averechts; omgekeerde; strijdig; tegenliggend; tegenstaand; tegenstrijdig; tegenovergesteld; iets omgekeerds
quant => over
lire => lezen
orgue => orgel; pijporgel
donnant => geven
sa => zijn; haar; hun; de zijne; ervan; iemands
créer => scheppen
consacrant => toewijden
pendant => gedurende; tijdens; terwijl; hangend; in; hanger; onder; voor; staande; tegenbeeld
attendez => wachten
affiche => poster; aanplakbiljet
systématiquement => stelselmatig
majeure => belangrijk
exercent => uitoefenen
parcours => tocht
nos => onze
rassemblement => bijeenkomst; samenkomst; verzameling; congregatie; menigte; reünie; samenscholing; vergadering
législatives => wetgevend
post => bericht
gamins => kinderen
y => daar; ginds; aldaar; daarginds; er; ginder; d’r; ’r; daarheen; daaromtrent
électeurs => keurvorstendom
journée => dag; etmaal; overdag
adjointe => helpster
celle => deze; dat; degene; die; diegene
engagement => verbintenis; verplichting; indiensttreding; inzet; aftrap; gevecht; aanstelling; Face-off; belofte; gelofte
villégiature => vakantie op het platteland; vakantieoord
appliquer => toepassen; aanwenden; aanzetten; leggen; voordoen; zetten; doorvoeren; gebruiken; opleggen; plaatsen
amené => bracht
rassemblées => verzamelde
pouvoir => kunnen; macht; mogen; vermogen; vaardigheid; erin slagen; in staat zijn om; machthebbers; heerschappij; capabel
ai => heb
cas => naamval; geval
rue => straat; blok; wijnruit; steeg; weg
achat => aankoop; koop
notre => ons; onze; de onze; die van ons; het onze
face => gezicht; aangezicht; gelaat; zijde; vlak; toet; kant; kruis; Zijde; aspect
personnes => mensen; volk
allons => gaan
tandis => terwijl; zolang
agir => handelen; doen
mentaux => geestelijk
merci => dank u; bedankt; dank je; dankjewel; dank; dank u wel
maison => huis; pand; geslacht; familie; tehuis; thuis; heem; onderkomen; domicilie; home
je => ik; 'k; hij
décrété => verordende
parole => spraak; woord; spreken; erewoord
ceci => dit; deze; dit hier; dat; die; het volgende; hiermee
suis => ben
blocage => verstopping
quelques => enkele; sommige; enige; wat; een paar; koppel; paar; echtpaar; een; een aantal
passer => voorbijgaan; overgaan
contrebas => beneden
volontaires => vrijwilligers
calculé => opzettelijk; berekend
perdront => verliezen
jusqu => omhoog
pousse => scheut; spruit; schieten
chacun => iedereen; ieder; elkeen; elk; alleman; allen; al; alle; een ieder; iedere
samedi => zaterdag; op zaterdag; sabbat
apprend => leert
droit => recht; rechts; rechtstreeks; loyaal; vandehands; bevoegdheid; direct; rechter-; trouw; getrouw
applaudissons => toejuichen
âge => leeftijd; ouderdom; tijdperk; era; tijd; epoch; tijdvak; epoch ’ m’’; ouderdomsrangschikking; rangschikken naar ouderdom
avec => met; bij; samen met; voor; en; Search by; door; mee; overweg komen; powered by
doré => gouden; goudkleurig; goud; gulden; verguld
rassemblements => bijeenkomsten
rasé => geschoren
mentales => geestelijk
établissements => instellingen
frère => broer; broeder
dix => tien; tientje; tiende; tiental
primaire => elementair; eerstegraads
eu => gehad
jeune => jong; jeugdig; pril; jongere; klein; jongeren; jongeling; vasten
chez => bij; aan; ten huize van; dichtbij; te
quelque => enkele; sommige; enkel; paar; wat; een; een aantal; een paar; enige; sommigen
pop => popmuziek
tuées => gedood
consciente => bewust
priorité => voorrang
participer => deelnemen
américains => us
content => tevreden; blij; vergenoegd; voldaan; verheugd; gelukkig
fixe => onbeweeglijk; stationair; vast; bewegingloos; roerloos; bepalen; star; stil; immobiel; onbewogen
favorable => gunstig; goedgezind; toegenegen; bevorderend; bevorderlijk; welgezind; gelukkig; geslaagd; hulp-; voorspoedig
morts => dode; doden; gestorvenen; overledenen
électorales => verkiezing
toujours => altijd; steeds; immer; altoos; nog; ooit; alsmaar; eeuwig; almaar; constant
foule => menigte; massa; drom; schare; hoop; boel; troep; aandrang; run; stapel
vraiment => echt; werkelijk; inderdaad; waarlijk; naar waarheid; waarachtig; zo; zodanig; heus; daadwerkelijk
sommes => zijn
justice => rechtvaardigheid
gamin => bengel; vlegel; blaag; rekel; snotaap; straatbengel; jochie; kwajongen; joch; jongetje
demain => morgen
extasie => vervoering
humain => menselijk; mens
arriver => gebeuren; aankomen
ma => mijn; m’n; mijne; m'n
auront => zullen
fondateurs => oprichters
était => was
rédigé => opgesteld
accessoires => toebehoren
force => kracht; sterkte; macht; fut; gewicht; power; spierkracht; strength; aantrekkingskracht; effect
veut => wil
plupart => grotendeels; merendeels; overwegend; meest; meeste
largement => ruimschoots; rijkelijk; ruim; volop; in overvloed; wijd; aanzienlijk; op grote schaal
dernier => laatste; laatst; afgelopen; voorbij; achterste; jongstgeleden; jongstleden; laatstgenoemde; voorbije; vorig
différence => verschil; onderscheid; ongelijkheid; verschil neutre; verscheidenheid; onenigheid; afwijking
venue => aankomst; komst
loi => wet; theorema; wetgeving; recht
dizaine => tiental; tientallen; tien
mars => maart; lentemaand
déserté => uitgestorven
vente => verkoop; veiling; veilingverkoop; inkoopactie
déséquilibrés => meppen
stars => sterren
prise => aandrijving; stopcontact; stekker; fitting; greep; houvast; inname; vat; contactdoos; contrastekker
six => zes; zestal
leurs => hun
continuent => voortzetten
élèves => studenten
david => koning david
duré => duurden
siège => belegering; zetel; beleg; stoel; bril; zitplaats; zitting; plaats; zitmeubel; zitvlak
dictrict => talaa
j => d; dag; dagen
déclare => zegt
lieu => plaats; aanleiding; locatie; oord; ruimte; lokaliteit; zetel; plek; geboorteplaats; localiteit
quand => wanneer; als; toen; eenmaaal; eens; dan
peuple => volk; natie; massa
tueries => moorden
tuerie => bloedbad; doodmaken; bloedvergieten
mêlent => mengen
adjacentes => aangrenzend
massacres => moordpartijen
illégales => onwettig
accès => toegang; aanval; heenweg; entree; binnengaan; intrede; offensief; vlaag; attaque; ingang
relèvement => peiling; verhoging
proposent => aanbod
beau => mooi; schoon; knap; fraai; net; aantrekkelijk; prachtig; fijn; bevallig; aantrekkelijke
timide => verlegen
expression => uitdrukking
mar => maart
américaines => us
puissantes => krachtig
adolescent => tiener; puber
appel => roep; beroep; oproep; pleidooi; smeekbede; hoger beroep; in beroep gaan; in hoger beroep gaan; aanhef; aanroepen
fédérale => federaal
départ => vertrek
écran => beeldscherm; scherm; monitor; doek; afschermen; breedbeeld; schut; zaal
outre => over; overheen; aan de overkant van; over ... heen; naast; behalve; buiten; bovendien; leren zak; behalve buiten
partir => vertrekken; weggaan; afgaan; opstappen; zich verwijderen
nous => wij; we
sortira => vrijgegeven
toutes => alle twee de; allebei; beide; al; alle
mesures => maat
peut => kan
marche => mars; trede; tree; treeplank; rit; opstap; tocht; opstapje
fusils => geweren
arme => wapen; gevechtswapen; militaire tak; gewapend
incroyables => ongelooflijk
pleins => vol
attendant => begeleider
été => zomer; zomertijd; geweest; zijn
états => staten
sous => onder; beneden; in
débarrasser => afhelpen
soi => elkaar; ge; je; men; u
proclame => afkondigt
écrit => schriftelijk; geschreven; beschreven; document
arrivent => aankomen
prochaines => volgende
chose => ding; zaak; aangelegenheid; affaire; onderwerp; object; voorwerp; mikpunt; artikel; exemplaar
considère => beschouwt
comptent => tellen
institutrice => lerares; onderwijzeres; schooljuffrouw; leraar
disant => gezegde
maintenant => nu; nou; thans; tegenwoordig; momenteel; huidig; heden; komaan
seront => zullen
jusque => totdat; tot
interdire => verbieden; niet toestaan; ban; in de weg staan; uitsluiten; veroordelen
survient => voordoet
feu => vuur; verkeerslicht; stoplicht; brand; wijlen; dood; doodgegaan; fik; gestorven; heengegaan
milliers => duizenden
après => na; achter; achteraf; over; na verloop van; aan; daarna; vervolgens; nadien; daarop
pancarte => bord; aanplakbiljet; bordje; ondertekenen; poster
jamais => nooit; nimmer; ooit; altijd; immer; steeds
raisonne => redenen
derrière => achter; na; achterwerk; achterste; bips; kont; aan; over; na verloop van; gat
travers => door middel van
fils => zoon; zonen
principale => belangrijkste; voornaamste
stocks => voorraad
voix => stem; inspraak; stemgeluid; stembusgang
survivants => overlevenden
sept => zeven; zevende; rood
fenêtres => windows
simplement => eenvoudig; eenvoudigweg; zonder meer; slechts; gewoon; enkel; louter; net; alleen; maar
rues => straten
doute => twijfel; twijfeling; onzekerheid; onduidelijkheid; ongeloof; betwijfelen; dubben; twijfelen
ans => jaar
diffusé => uitzending
marcheurs => wandelaars
cité => stad; plaats; geciteerd
lois => wetten
an => jaar; jaar oud
déclaration => verklaring
différents => verschillend
liberté => vrijheid; vrijdom; vlotheid; godsdienstvrijheid
parvenus => bereikte
légales => wettelijk
imagination => verbeelding; verbeeldingskracht; fantasie; voorstellingsvermogen; voorstelling; inbeelding
détente => ontspanning; schik; vermaak; afleiding; verstrooiing; verzet; amusement
début => begin; aanvang; ontstaan; start
majeur => belangrijk; meerderjarig; aanzienlijk; middelvinger; aanmerkelijk; ernstig; mondig; voornaam; zwaar; erg
espère => hopen
voter => stemmen; verkiezen; kiezen; balloteren; stemming
courage => moed; dapperheid; durf; lef
heure => uur; stonde; tijdstip; lesuur; spitsuur; tijd; moment; tijd op de dag; keer; maal
siècle => eeuw; centennium
remplace => vervangt
guerre => oorlog; krijg; oorlogvoering; gevecht; conflict; dispuut; kamp; krijgsvoering; oorlogvoeren; slag
enceintes => zwanger
quelqu => iemand
légal => wettig; wettelijk
pays => land; staat; natie; platteland; thuisland; streek; -land; omgeving; vaderland; volk
fille => dochter
voulons => willen
marchez => wandelen
avenue => laan
pâtés => blokken
dépassé => achterhaald; obsoleet; oudbakken; verouderd
élus => gekozen
armée => leger; legermacht; troepenmacht; heerschaar
âges => leeftijden
juste => rechtvaardig
père => vader; papa
noms => namen
nombreux => veel; vele; talrijk; menig
promulguée => afgekondigd
juché => neergestreken
permettre => toestaan; toelaten; gedogen
renforcé => geconsolideerde
jour => dag; etmaal; daglicht; feestdag; opening; kalenderdag; licht; rustdag; snipperdag; vakantiedag
bienvenue => welkom; begroeting; ontvangst; verwelkoming; geen dank; geen probleem; graag gedaan; graag gezien; welkome
moi => ik; me
mot => woord; bewoording; term; codewoord; paswoord; trefwoord
devoir => moeten; plicht; behoren; huiswerk; taak
maladies => ziekten
libre => vrij; los; open; vrije; gratis; losse; onbelemmerd; onbezet; vlot; loslopend
correspondant => aansprakelijk; congruent; verantwoordelijk; overeenkomstig; overeenkomend; overeenstemmend; bijbehorend
moyenne => gemiddelde; gemiddeld; doorsnee; Gemiddelde; medium
chante => zing
pourront => zullen
prendre => nemen; pakken; vatten; aannemen; aanvatten; oprapen; innemen; vangen; afpakken; grijpen
semble => lijkt
sécurité => veiligheid; zekerheid; beveiliging; geborgenheid; borgstelling; geborgen; gerust; rechtszekerheid; safe; veilig
scénarisé => scripted
drills => boormachines
centaines => honderden
progrès => vooruitgang; vordering; voortgang; gevorderdheid
mal => pijn; slecht; kwaad; verkeerd; fout; schade; zeer; zonde; kwade; wee
armes => wapen; wapenschild; blazoen; heraldisch wapen; wapens
exercice => oefening; training; boekjaar; opgave
violence => geweld; heftigheid; agressie; geweldpleging; gewelddaad; gewelddadigheid; dwingen
faveur => gunst; dienst; begunstiging; voor
pratiqués => geladen
engouffrent => stormloop
mitrailleuses => machinegeweren
passé => verleden; verleden tijd; voorbij; afgelopen; praeterium; vervlogen; laatstleden; verdord; verlept; verschenen
porte => deur
ajoute => toegevoegd
vieilles => oud
micro => microfoon
annoncé => aangekondigd
minutes => notulen; proces-verbaal; proces‐verbaal
crâne => schedel; blokken; hoofd; kop; hersenpan
avait => had
elle => zij; ze; haar; het; hij; d’r; d'r; ik; jij; zij zij
écoutent => luisteren
on => men; ze; je; ge; mensen; u
croisade => kruistocht; kruisvaart; Kruistocht
reportage => dekking
trois => drie; derde; drietal
chaque => elk; ieder; elke; iedere; al; alle; alleman; beide; telkens
côté => zijde; kant; zijkant; flank; zij; bij; zijdelings; kust; kustlijn; lateraal
livres => boeken
boulot => job; baan; werk; beroep; geploeter; klus; taak; zwoeg
voisine => buurvrouw; buur; buurman; buren; buuf
tous => alle; alle twee de; allebei; beide; allemaal; allen; alles; iedereen; al; elk
sont => zijn
février => februari; sprokkelmaand; regenmaand; kortemaand; reinigingsmaand; schrikkelmaand; slijkmaand
enfants => kinderen; nakomelingschap; zoons en dochters; afstammelingen; kinders; nageslacht; nageslachten; nakomeling; nakomelingen
vies => levens
sais => raad eens
faites => maken
discours => redevoering; vertoog; oratie; spraak; toespraak; rede; speech; spreken; betoog; verhandeling
victimes => doden en gewonden
près => dichtbij; nabij; ernaast; bij; daarnaast; hiernaast; in de nabijheid; dierbaar; naverwant; nabije
épaules => schouders
renforcés => versterkte
armé => gewapend; bewapend; haan; gevechtsklaar
bout => einde; punt; top; spits; eind; neus; besluit; piek; tip; topje
scolaires => school
assaut => bestorming; aanval; stormloop; charge; offensief; vlaag
vous => jullie; u; je; jij; gij; U; aan je; aan u; ge
pressé => gehaast; jachtig
interdiction => verbod
exercices => boor
contre => tegen; tegenaan; met; jegens; tegenover; aan; op; versus
capitale => hoofdstad; hoofdletter
descend => naar beneden
bientôt => spoedig; weldra; gauw; dra; alras
petit => klein; minuscuul; jong
blanche => wit
clients => klanten
flot => vloed; stroom; bergstroom; golf; vloeistof; leger
h => u; uur
tard => laat; late; later
maîtresse => geliefde
heures => uur
comment => hoe; pardon; hoedanig; wat een; wat voor; wat voor een; wat; excuseer; wablief; op welke manier
découvrir => ontdekken; blootleggen; blootstellen; uitvinden; bespeuren; ontwaren; tot de ontdekking komen; onderzoeken; onthullen; opgraven
laissent => vertrekken
pierre => steen; edelsteen; steentje; edelgesteente; gesteente; rots; kiezel; kiezelsteen; stone; grafsteen
cp => Cp
tu => jij; je
langue => tong; taal; spraak
te => jou; je; aan je; aan jou
élève => leerling; scholier; student; studente; pupil; cursist; schoolkind
énerve => van streek
entrée => toegang
avion => vliegtuig; vliegmachine; kist; toestel; luchtvaartuig; plat vlak; plataan; schaven; straalvliegtuig; verkenner
neige => sneeuw; basterdsuiker; coke; wit; cocaïne; sneeuwbui; sneeuwen; sneewu
cause => oorzaak; reden; zaak; aanleiding; aangelegenheid; affaire; ding; keuze; motief; bron
environ => ongeveer; circa; zowat; een stuk of; plusminus; rond; bijna; omtrent; pakweg; vrijwel
apprises => geleerd
allée => laan; dreef; gang; pad; steeg; doorgang; wegeltje; gangpad
russe => Russisch; Russische taal; Russische; Russisch staatsburger
trop => te; te veel; te zeer; teveel; al te; overdreven; ook
suivre => volgen; opvolgen; bijhouden; beschrijven; bewandelen; gaan langs; voortvloeien; handelen volgens; nasporen; meegaan
jouait => gespeeld
parlait => sprekend
heureusement => gelukkig; gelukkigerwijs; graag
puis => dan; daarna; vervolgens; toen; achteraf; naderhand; volgend; verder
pourrai => kon
non => nee
changent => verandering
bonjour => goedemorgen; goedendag; hallo; dag; goedemiddag; hoi; goeiemorgen; goeiedag; goedenavond; goededag
années => jaar
pourquoi => waarom; hoezo; waarvoor; hoe komt het dat; hoe zo; reden; weshalve; weswege
seul => alleen; enig; louter; eenzaam; verlaten; enkel; allenig; afgescheiden; afgezonderd; uitsluitend
occasion => gelegenheid; gebeurtenis; geval; aanleiding; kans; tweedehands; mogelijkheid
souvent => vaak; dikwijls; veel; gedurig; veelal; menigmaal; veelvuldig; veeltijds; dikwerf; frequent
raconte => vertelt
déroulé => plaats
appelle => telefoontje
disent => zeggen
appréhendais => wantrouwig
existe => zijn
savaient => wist
dure => hard; kalkrijk; moeilijk; zwaar; harde; moeilijke; ruw; zware
peu => weinig; beetje; hapje; hap; zelden; ietsepietsie; ietsepietsje; ietsje; rustig; snufje
dès => vanaf; sedert; met ingang van; sinds; van
dimanche => zondag
matières => inhoud
chaussures => schoeisel
différences => verschillen
oui => ja; jawel; bevestigend
voulais => gezocht
réussi => succesvol; geslaagd
surtout => vooral; voornamelijk; in het bijzonder; inzonderheid; hoofdzakelijk; speciaal; bovenal; allereerst; boven alles; vóór alles
empêchait => verhinderd
récré => nis
mes => mijn; m'n; m’n
difficile => moeilijk; lastig; zwaar; slim; ongemakkelijk; niet van pas komend; ongelegen; storend; gecompliceerd; ingewikkeld
équations => vergelijkingen
parlent => spreken
couramment => vlot; vloeiend
commencent => beginnen
collège => gymnasium; school; universiteit
maths => wiskunde
parce => omdat
m => begrotingstekort
feuille => blad; vel
parents => ouders; ouderpaar; ouder; verwanten
rire => lachen; lach; gelach; uitlachen; giechelen; lachbui
termine => uiteinden
arrivait => gebeurd
jouer => spelen; acteren; speculeren; uitvoeren; voorspelen; afspelen; optreden; agioteren; bespelen; opvoeren
voyage => reis; tocht; trip; toer; uitstapje; trektocht; reizen; excursie; tour; tocht trip
beaucoup => veel; zeer; dikwijls; vaak; veelal; veeltijds; een heleboel; gedurig; menigmaal; terdege
ciseaux => schaar
villes => steden
jeux => Ludi; spel
mêmes => dezelfde
comprends => begrijpen
ensemble => samen; verzameling; set; bijeen
apprendre => leren; bijbrengen; instrueren; onderwijzen; aanleren; scholen; vernemen; ervaren; ondervinden; horen
partout => overal; alom; wijd en zijd; allerwegen; overal waar; overall
avancés => gevorderd
grandes => groot
arrivais => aangekomen
prochain => volgend; aanstaand; komend; aankomend; spoedig; naaste; volgende; medemens; aanstaande; eerstkomend
réélu => herkozen
paire => paar; koppel; duo; stel; span; tweetal; stelletje
vivais => leefden
encore => nog; opnieuw; weer; nogmaals; wederom; alweer; nog steeds; weder; alsnog; van voren af aan
es => bent
exemple => voorbeeld; toonbeeld
enseigne => bord; uithangbord; bordje; schild; kleur; vaandel; vaandrig; vlag
sauf => behalve; buiten; ongerekend; uitgezonderd; veilig; behoudens; uitgenomen
cour => erf; hof; binnenplaats; gerechtshof; plaats; rechtbank; binnenruimte
comprendre => begrijpen; bevatten; snappen; verstaan; beseffen; insluiten; omvatten; vatten; inzien; doorzien
commence => starts
expérience => ervaring
majorité => meerderheid; merendeel; gros; meerderjarigheid; meerderjarig; volwassen
année => jaar; bevordering; jaargang; promotie; klas; begrotingsjaar; boekjaar; jaarcijfer; jaartal; leeftijd
or => goud; gouden medaille; gouden; welnu; guld; Goud
stipule => steunblaadje
équipe => ploeg; team
puisque => aangezien; omdat; daar; doordat; want; vermits; wijl; immers; sinds
fin => einde
professionnel => beroeps
clair => helder; duidelijk
change => uitwisseling
aucune => geen; niemand; nee, niet
accorderait => verlenen
considéré => beschouwd
décidé => beslist; besluitvaardig; resoluut; vastbesloten
choisis => gekozen
crois => denken
réellement => werkelijk; echt; wezenlijk; daadwerkelijk; inderdaad; heus; reëel; waarachtig; waarlijk; warempel
juteuse => sappig
soir => avond
indésirable => ongewenst; bijwerking; neveneffect
mercredi => woensdag; stik
récompense => prijs; premie; beloning; belonen; loon; gratificatie; erkenning; toekenning
reçoit => ontvangt
mardi => dinsdag
alignerait => richten
emery => amaril
meilleure => best
ici => hier; alhier; hierzo; hierheen; hiero; herwaarts; hierin; van hier
conférence => lezing; spreekbeurt
cadeau => geschenk
joueurs => spelers
assoir => zitten
joueur => speler
contrairement => anders
tel => zodanig; zo; zulk; dusdanig; zo’n; zulk een; die; zulke; dergelijk; een of ander
jouera => zal spelen
jeu => spel; speling; game; pak; reeks; set; spelleke; stel; complet; gok
particulière => bijzonder; eigenaardig; apart
coéquipiers => teamgenoten
possible => mogelijk; bestaanbaar; haalbaar; waarschijnlijk; denkbaar
rester => blijven; overblijven; verblijven
souhaitait => gezocht
untel => zo’n
demi => half; helft; biertje
scan => scannen
sacré => sacraal; heilig; gewijd; geheiligd; Heilig; geestelijk; gezegend; onnoembaar; taboe; verdomd
envie => afgunst; nijd; ijverzucht; jaloezie; naijver; jaloersheid; wangunst; dwangnagel; nijnagel; verlangen
joué => wang
coupe => beker; bokaal; cup; drinkbeker; kapsel; snit; bekertoernooi; kelk
saison => seizoen; jaargetijde; herfst; jaargetij; najaar
possibilité => mogelijkheid; optie; bekwaamheid
faut => moet
ajouter => toevoegen; bijvoegen
meilleurs => best
ait => heeft
fleur => bloem; bloesem; crème de la crème; bloei
disputé => betwist
donc => dus; daarom; bijgevolg; aldus; derhalve; ergo; daardoor; zodoende
palmarès => prijzenlijst
tutrice => voogd
intégré => naadloos
réfléchir => nadenken
eux => zij; hen; hun; ze
enfant => kind; wicht; jongeling; jongen; nageslacht; nakomeling; afstammeling; baby; jongere; kinderen
seulement => slechts
repose => berust
là => daar; ginds; ginder; aldaar; daarginds; d’r; er; daarheen; hier; d'r
quitté => links
confondus => verward
rêve => droom; dagdroom; wensdroom; hoop; dromen
adultes => volwassenen
regarder => kijken; bekijken; betreffen; aangaan; kijken naar; blikken; gelden; raken; toekijken; toezien
tête => hoofd; kop; krop; kopbal; koppositie; leider; berichtkop; kaap; koptekst; voorgebergte
bas => kous; laag; lage; onderkant; sok; beneden; bodem; laf; Kous
parle => spreekt
lorsque => wanneer; toen; als; terwijl; dan
rapidement => snel; vlug; gauw; hard; in allerijl; schielijk; prompt; oppervlakkig; vluchtig; gezwind
aimerais => zou
triste => bedroefd; treurig
formés => getraind
parler => spreken; praten; converseren; overleggen; uitspreken; kletsen; roddelen; verklappen; babbelen
entraîne => uitslagen
vit => lul; pik; leuter; penis; piemel; slurf; toeter
venus => van
échanger => ruilen; wisselen; inruilen; inwisselen; uitwisselen; verruilen; omwisselen; handelen; in de plaats stellen van; omruilen
récréation => ontspanning; afleiding; schik; vermaak; verzet; amusement
prisonniers => gevangenen
garçon => jongen; kelner; knaap; ober; vrijgezel; celibatair; joch; knul; huisboy; jongens
noires => zwart
mois => maand; maan; maandbloeding; maandstonden; menstruatie; ongesteldheid; regels; maanden; wintermaand
travailler => werken
permis => vergunning; toestemming; verlof
parfois => soms; bijwijlen; somtijds; wel eens; occasioneel; af en toe; nu en dan; somwijlen; weleens; bij wijlen
maternelle => kleuterschool; kleuterklas; moeder; moeder-
fatigue => vermoeidheid; moeheid; matheid; vermoeienis; lethargie; last; moe; ongemak; vermoeid; vermoeiing
occupe => aanbiedingen
meilleur => beter; best; beste
devenu => worden
aiguiser => scherpen; slijpen; aanzetten; wetten; aanscherpen; scherp maken; verhevigen; spitsen
lundi => maandag
origine => oorsprong; afkomst; herkomst
facile => gemakkelijk; makkelijk; vlot; licht; eenvoudig; moeiteloos; simpel
appelé => dienstplichtige; milicien; heten
rencontré => ontmoeting
joue => wang; kaak; koon
journées => dagen
suite => rij
pierres => steen
prend => neemt
progressé => vooruitgang
passe => zeegat; loper; moedersleutel
avais => had
aimé => dierbaar; bemind; lief; geachte; lieve; duur
aide => hulp; bijstand; assistentie; heul; toedoen; toeverlaat; helper; hulpmiddel; assistent
dois => hebben
ami => vriend; medestander; geestverwant
blanches => wit
découvert => blootgesteld; onafgedekt; onbedekt; ontdekt; onverhuld; open; bloot; deficit
communication => mededeling
consiste => is
fondre => smelten; gieten; versmelten; wegsmelten; samensmelten; dooien; ontdooien; afgieten; gieten van metaal; vloeibaar worden
matin => morgen; ochtend; voormiddag; 's morgens; 's ochtends
arrivée => aankomst; plaats van aankomst; komst; bestemming; finish
autant => zoveel; evenveel; zulk een; zo; zodanig; zozeer; zo’n; zowel; dergelijk; dergelijke
devoirs => huiswerk; huistaak
réussir => slagen; klaarspelen; doorkomen; slagen voor; lukken; erin slagen; bereiken; gemaakt; halen; gelukken
devenir => worden; raken
partager => delen
réponses => reacties
dessous => onder; beneden; daarbeneden; onderkleding; bodem; daaronder; eronder; ondergoed; onderkant; onderdeel
tits => tieten
habitants => mensen
impossible => onmogelijk; onbestaanbaar; uitgesloten; ondoenlijk; onhaalbaar; onuitvoerbaar
quoi => wat; hetgeen; pardon; excuseer; wablief; wat zeg je; wat zegt u; dat; hé; raad eens
utilisent => gebruik
interdits => verboden
communiquer => meedelen; mededelen; berichten
envoyer => verzenden; zenden; sturen; opsturen; doen toekomen; opzenden; uploaden; versturen; e-mailen; mailen
avance => voorsprong; voorbaat; voorschot; vooruitspoelen
ouverts => open
trouve => gevonden
mis => geplaatst
voulu => gewild; bedoeld; bewust; doelbewust; expres; intentioneel; moedwillig; opzettelijk; voorbedacht; welbewust
inscrits => geregistreerd
franceinfo => usainformations
importe => iedereen
regarde => kijk
messages => berichten
habitant => bewoner; inwoner; burger; ingezetene; poorter; stadsburger; bewoner or inwoner
supprime => verwijdert
compris => begrepen; verstaan; inclusief
contenus => inhoud
applications => toepassingen
signale => rapporten
enfermer => opsluiten; insluiten
détraqueurs => dementors
âme => ziel; geest; gemoed; psyche; stapel
naît => is geboren
terrible => verschrikkelijk; vreselijk; schrikaanjagend; ijselijk; vervaarlijk; afschuwelijk; tof; ontzettend; schrikwekkend; gevaarlijk
peuplé => bevolkt
amitié => vriendschap; vriendendienst
insolites => ongebruikelijk
affrontera => gezicht
orphelin => wees; weesjongen; weeskind; ouderloos; weesmeisje
librairie => boekhandel; boekwinkel; boekenwinkel; bibliotheek; boekerij; gereedschapskist
premier => eerste; eerst; eerstgenoemde
anniversaire => verjaardag; gedenkdag; herdenkingsdag; geboortedag; verjaring; jarig; jubileum; jaardag; jaarfeest; verjaardagsfeest
défi => uitdaging; tegenstand; trotsering; verzet; weerstand; uitdagen
bourreaux => tormentors
compte => rekening
mort => dood; overlijden; ondergang; sterfgeval; verderf; verscheiden; overleden; gestorven; heengaan; dode
balle => kogel; bal; kaf; speelbal; baal; ammunitie; bol; munitie; schietvoorraad; graankafje
vrai => echt; waar; juist; gelijk hebbend; gegrond; eigenlijk; heus; waarachtig; echte; oprecht
retour => terugkeer; terugkomst; terugreis; thuisreis; terugtocht; terugweg; wederkeer; wederkomst
traits => features
sorcier => tovenaar; duivelskunstenaar; heksenmeester; tjsoener; toveraar; magiër; heks; tovenares
personnages => tekens
prêtent => lenen
peuplent => bevolken
cape => mantel
créatures => schepselen
angleterre => engeland
apprennent => leren
comptabiliser => rekening
nouvelle => nieuw
chiffres => getal; nummer
destin => lot; noodlot; fataliteit; lotsbestemming; bestemming; fatum; nootlot; Qadar; beschikking; fortuin
invisibilité => onzichtbaarheid
ensorceleur => tovenaar
apparitions => verschijningen
balai => bezem; veger; borstel; brem; koolborstel
apprenant => leerling
parvient => slaagt
sorcellerie => hekserij; tovenarij; toverij; heksernij; heks; toverkunst
sorts => loterijbriefje
livre => boek; pond; Engels pond; Engelse pond; Pond; pond sterling; boeken; kinderboek; kookboek; pound
cancre => domkop; krab; stomkop
durant => gedurende; tijdens; in; onder; staande; terwijl; lopende; voor; over
cet => deze; die
confère => imparts
lancer => werpen; gooien
texte => tekst
sorciers => heksen
animal => dier; beest; dierlijk; dierlijke; dieren
art => kunst
univers => heelal
site => website
ensuite => achteraf; daarna; dan; vervolgens; naderhand; bijgevolg; dus; derhalve; zodoende; nadien
ni => noch; evenmin; of; ook niet
victoire => overwinning; zege
sortilèges => spreuken
prisonnier => gevangene; gedetineerde; gevangen; veroordeelde
score => punt
singuliers => enkelvoud
tomes => volumes
impunité => straffeloosheid; straffeloos
vient => gewoon
introduisent => voorstellen
potter => pottenbakker
jeter => gooien; werpen; spuwen; spugen; keilen; smijten; uitspelen; afvoeren; storten; doen vallen
utilisé => toegepast
permet => toestaat
cités => aangehaald
cœur => hart; harten; kern; klokhuis; beminde; geliefde; lieveling; schat; schattebout; binnenste
maladroit => onhandig; onbeholpen; stuntelig; kluns; knullig; schutterig; stumperig; sukkelig; lomp; plomp
poudlard => zweinstein
quidditch => Zwerkbal
pari => weddenschap; gok; gokken
offre => aanbod; aanbieding
lunettes => bril; beschermende brillen; veiligheidsbril
côtoient => wrijven
enquêtes => onderzoeken
tenue => bestuur; leiding; bewind; gedrag; onderhoud; bestel; heerschappij; houding; manieren; regering
enchanteur => betoverend
volant => stuurwiel; shuttle; stuur; stuurrad; vliegwiel; los; Shuttle; pluimbal; tierelantijn; vederbal
unit => verenigt
sortie => uitgang; afrit; uitweg; besteding; exodus; uitgaaf; uittocht; vertering; uitrit; uitvoer
apprendront => leren
mentions => aantekeningen
torturent => marteling
attraper => vangen; pakken
solide => vast
découvre => vondsten
parure => sieraad; versiering; decoratie; versiersel; tooisel; juwelen; opsmuk
également => eveneens; ook; tevens; even; evenzeer; gelijkelijk; zo; aldus; alzo; effe
privant => ontnemen
règles => menstruatie; maandstonden
troisième => derde
issu => van
oblige => vereist
vif => kwiek; levendig; druk; kras; rap; opgewekt; scherp
débute => starts
lié => gebonden; legato; beslagen; gerelateerd; grens; verwant
immortalité => vuur van de feniks; Onsterfelijkheid; onsterfelijkheid
tome => deel; boekdeel; volume; band
démontrent => tonen
arrêter => stoppen; aanhouden
arrêté => vaststelling; ministeriële regeling; afsluiten; afsluitings-; besluit; staan; wetgeving
contenue => bevatte
remboursés => terugbetaald
meurent => sterven
mondiale => globaal
vendus => uitverkocht
place => plaats; plein; plek; ruimte; lokaal; baan; oord; ambt; betrekking; post
dangereuse => gevaarlijk; gevaarlijke
augmenté => vermeerderd; overmatig
choc => botsing
gros => dik; lijvig; vet; corpulent; dikke; omvangrijk
avertissement => waarschuwing; aanmaning; aansporing; vermaning; vermaan; waarning; voorwoord
sociale => maatschappelijk
moitié => helft; half; wederhelft
rappeler => herinneren; terugroepen; bisseren; naar buiten roepen; ten gevolge hebben; uitlokken; erop komen; reproduceren; terughalen; aanmanen
devrait => moeten
encourage => moedigt
fumer => roken; bemesten; smoren
enregistre => archief
consomment => verbruiken
prix => prijs; premie; beloning; koers; waarde; onderscheiding; vervoerprijs; kosten; onkosten; uitgaven
concernés => betrokken
chimiques => chemisch
écrits => geschreven
traitements => behandelingen
enfin => ten slotte; uiteindelijk; eindelijk; per saldo; tenslotte
fume => roken
seuls => alleen
avaient => had
fumée => rook; damp
aident => helpen
paquet => pak
atteindre => bereiken; behalen; inhalen; halen; raken; treffen; inslaan; reiken tot; teisteren; realiseren
contient => bevat
inciter => aansporen; aanzetten
claire => duidelijk
chimique => chemisch; scheikundig; chemisch product; chemische stof
dépendant => afhankelijk; verslaafd; afhankelijke cel
bureaux => kantoren
substances => stoffen
antitabac => controle
façon => manier; wijze; methode; snit; vorm; wijs
fumeurs => roken
toxique => giftig
meurt => overlijdt
caractères => afdruk
habitude => gewoonte; gebruik; usance; praktijk; aanwensel; automatisme
espace => ruimte
rend => merken
hausse => uitbreiding; verhoging; boom; opslag; plotse stijging; stijging; verhogen
apportant => brengen
tuent => doden
petite => meisje; kindekijn; klein; welp
patchs => pleisters
évitent => vermijden
achètent => kopen
santé => gezondheid; proost; welzijn
cher => duur; dierbaar; kostbaar; lief; prijzig; waard; waardevol; beste; lieve; geacht
conduite => gedrag; gedragingen; leiding; wandel; buis; bediening; beleid; buisleiding; gedragswijze; geleide
acceptable => aanvaardbaar
envers => tegen; aan; bij; naar; op; tot; voor
droits => rechten
lors => gedurende; onder; terwijl; tijdens; voor; bij gelegenheid van; in geval van; staande; dan
gérante => directeur
saurait => kan
appréciation => waardering; raming; schatting; taxatie; waardebepaling; beoordeling
due => verschuldigd
attendus => verwacht
tribunal => gerecht; gerechtsgebouw; rechtbank
normes => standaarden
directe => positief
affaire => zaak; aangelegenheid
paraître => lijken; schijnen; verschijnen; voorkomen; overkomen; toeschijnen; uitkomen; er uitzien; het uiterlijk hebben van; opdagen
remercié => bedankte
éclaté => gebroken
reconnaissant => dankbaar; waarderen; erkentelijk; bedanken
documents => administratie
dire => zeggen; opgeven; praten; spreken; uitbrengen; instrueren; toevertrouwen; vertellen; gezegde; luiden
licencié => afgestudeerde; gediplomeerd; afgedankt; gepensioneerd; licentiehouder
déposé => gedeponeerd
aurait => zou
repris => hervat
devra => zullen
indique => shows
politesse => beleefdheid; hoffelijkheid; wellevendheid; welgemanierdheid; Beleefdheid; opvoeding
côte => kust; rib; zeekust; kustlijn; helling; glooiing; oever; ribbel; ribbe; zeekant
révision => herziening; update; keuring; opknapbeurt
décision => beslissing; besluit; uitspraak; wijzing; maatregel; vaststelling; beslistheid; conclusie; resoluutheid; vastberadenheid
contrevenu => strijd
employeur => werkgever; ondernemer
travaillait => werkte
faisait => was
estime => achting; tel; aanzien; eerbied; ontzag; respect; waardering; hoogachten
limogé => ontslagen
entreprise => bedrijf; onderneming; zaak; firma; initiatief; ondernomen; corporatie; handelsonderneming; maatschappij; nering
refusé => geweigerd
rejetée => verworpen
août => augustus; oogstmaand; Augustus; hittemaand
héritage => erfenis; erfdeel; erfstuk; boedel; versterf; versterving; overerving; erfgoed; nalatenschap; overname
élevés => hoog
honnête => eerlijk; degelijk; eerzaam; fatsoenlijk; loyaal; getrouw; net; trouw; trouwhartig; eerbaar
professionnelle => deskundige; expert
travail => werk
préjuger => vooruitlopen op
impoli => onbeleefd; honds; lomp; onheus; vlegelachtig; grof; onbeschaafd; ongemanierd; bars; knorrig
rejeter => verwerpen; weigeren; afwijzen; braken; kotsen; overgeven; weggooien; wegwerpen
déterminer => belezen; bewegen
violation => schending; bres
reproche => verwijt; berisping; blaam; standje; terechtwijzing; uitbrander; vervijt; verwijten
ultérieure => later
fera => zullen
manque => gebrek; afwezigheid; gemis; tekort; tekortkoming; euvel
irrespectueux => oneerbiedig; astrant; brutaal; onbeschaamd
comportement => gedrag; gedragingen; Gedragswijze; gedragswijze
avisé => pienter; scherpzinnig; schrander; snugger; spits; vernuftig; verstandig; functioneel; praktisch; zinvol
provoque => oorzaken
issue => uitgang; uitweg; afrit; uitkomst; oplossing; uitslag; resultaat
retrouver => terugvinden; hervinden; voorkomen; afspreken
souligne => highlights
environnement => omgeving; milieu; medium; woonomgeving; gebied; natuurlijke omgeving; ruimte; wildleven
employé => werknemer
soutient => ondersteuningen
grossier => grof; ruw; bot; hardhandig; lomp; onbehoorlijk; onbehouwen; onbetamelijk; onfatsoenlijk; onkies
quelconque => enigerlei; een of ander; een of andere; enige; dan; welke ook; een aantal; een paar; enig; enkele
fondateur => oprichter; stichter; grondlegger
mentionne => vermeldt
reprises => gelegenheden
verbalement => mondeling
perception => waarneming
appris => aangeleerd; geleerd
pacifique => vredig; vreedzaam
demandé => aangevraagd; nodig; verplicht
malpoli => onbeschaafd; ongemanierd; grof
attitude => houding
favoriser => begunstigen; bevoordelen; accelereren; bespoedigen; verhaasten; versnellen; beschermen; bevoorrechten; begunstiging; bevoordeligen
population => bevolking; zielental
incendiés => brand
précisé => verduidelijkt
basses => laag
commissariat => politiebureau; politiepost; politie
haut => hoog; luid; verheven
intouchables => onaanraakbaren
égard => ontzag; respect; waardering
concernant => betreffende; aangaande; omtrent; ten opzichte van; met betrekking tot; wat betreft; over; in betrekking tot; t.o.v.
utilisée => gebruikt
chapelet => gebedssnoer; rozenkrans; cascade
constitution => grondwet
membres => ledematen
bâtiments => gebouwen
dizaines => tientallen
tribus => stammen
située => gelegen
ville => stad; plaats; gemeente; nederzetting
crainte => vrees; schroom; beduchtheid; angst; schrik; ontzag; doodsangst; ongerustheid; opwinding
paralysée => verlamd
brûlé => aangebrand; verbrand
forces => macht; troep; droogscheerdersschaar; schaapscheerdersschaar; scharen
assouplissement => versoepeling
socialement => maatschappelijk
suspects => verdachten
émeutiers => relschoppers
liée => verwant
autorités => overheid
perdu => verloren; verdwaald; kwijt; verlaten
interdite => verboden
passant => voorbijganger
exactions => afpersingen
répertoriées => opgesomd
recensés => geïdentificeerd
autrefois => vroeger; eerder; indertijd; eertijds; daarvoor; vooraan; voorheen; eens; ooit; weleer
touchés => aangedaan
défavorisées => kansarme
pouvait => kon
importantes => belangrijk
cheval => paard; ros; knol; paardenkracht; pk; mechanische paardenkracht; metrieke paardenkracht; bok; kruis
annulé => nietig
violences => geweld
responsable => verantwoordelijk; aansprakelijk
circonstances => situatie
dites => zeggen
régulièrement => regelmatig; geregeld
blessés => verwond
vu => gezien; gelofte; terwijl; waarbij
considérées => beschouwd
heurts => botsingen
fermier => pachter; landbouwer; boer
appelés => riep
ferroviaires => rail
société => maatschappij; samenleving; gemeenschap; bedrijf; vennootschap; zaak; gezelschap; firma; genootschap; vereniging
quatre => vier; vierde; viertal
nord => noorden
réalité => werkelijkheid
suprême => opperst; opperste; ultiem; hoogst; oppermachtige; uiterst
médias => massamedia
propriétaire => eigenaar; bezitter; huisbaas; eigenares; bezitster; hospes; baas; bezittelijk; hospita; landheer
routiers => weg
battu => geklopt
ciblé => gericht
manifestations => events
armés => bewapend
cyanhydrique => blauwzuur
investigation => onderzoek; enquête; ontdekking; opsporing; speurwerk; navorsing; research
onusiens => vn
absence => afwezigheid
confirmée => bevestigd
incitant => prikkel; stimulans; stimulering
blancs => witte was
confirment => bevestigen
équipements => uitrusting
ouvertes => open
in => een
témoignent => getuige
agit => is
gêne => hinder; verlegenheid; belemmering; beswar
rebelle => opstandig; ongezeglijk; oproerig
parallèle => evenwijdig
al => lj
conclu => gesloten
aucun => geen; generlei; geen enkel; geen enkele; niemand; enig; geen van beide; nee, niet; niet een; noch
démontrer => bewijzen; aantonen; getuigen
témoins => getuigen
cinq => vijf; vijfde
suédois => Zweeds; Zweedse; Zweeds taal
déluge => zondvloed; cascade; overstroming; wolkbreuk; Zondvloed; overvloed; stortvloed
signalé => gerapporteerd
armées => bewapend
serait => zou
tué => moeras
diffusée => uitzending
disposent => kenmerken
estimant => geloven
raids => overvallen
incendient => verbrand
cornée => hoornvlies
alliée => bevriend; bondgenoot
postées => gepost
examiné => onderzocht
abrités => beschut
présent => tegenwoordige tijd; aanwezig; heden; geschenk; cadeau; tegenwoordig
civile => burger; particulier; burgerlijk
parachever => vervolledigen; aanvullen
prélèvements => heffingen
déclassifiées => vrijgegeven
aériennes => lucht
mentionnent => noemen
oculaires => oog
largués => gedaald
provoqués => veroorzaakt
instants => momenten
rempli => vol; volledig; compleet; gevuld
asphyxie => verstikking
suffocants => verstikkende
rendu => afbeelding; weergave; opbouwen
confiance => vertrouwen; zelfvertrouwen; trouw; Vertrouwen; betrouwbaar; betrouwbaarheid; fiducie
restés => overblijfselen
constitué => bestaande
combattants => strijders
parachevant => het invullen van
sol => grond; bodem; aarde; ondergrond; vloer; fond
opposés => tegenover
dehors => buiten; daarbuiten; uiterlijk; buitenshuis; openlucht; uit; voorkomen
immeuble => gebouw; bouwwerk; perceel; herenhuis; constructie; bouwsel; pand; pand met meerdere verdiepingen; flat; immobiliën
éloigne => weg
cadavres => lijken
présence => aanwezigheid; tegenwoordigheid; bijzijn
donné => gegeven
aérienne => lucht
avions => had
riposté => wraak
recherche => onderzoek; zoektocht; speurwerk; speurtocht; queeste
représailles => vergelding; wraak
dément => gek; waanzinnig; krankzinnig; zot
britanniques => Brit; Britse
allégations => beschuldigingen
défense => verdediging
frappes => strikes
expliquait => uitgelegd
appuient => ondersteuning
contrario => omgekeerd
accusateurs => beschuldigers
établi => werkbank; bank; bok; ezel; rek; schraag; stander; stellage; gevestigd
correspondent => wedstrijd
évoquent => terugroepen
dernières => laatst
environs => buurt
propre => schoon; eigen; rein
réfugiés => vluchteling
survivant => overlevende; langstlevende; overlevend; geredde
recours => appel; beroep; gebruik; genot
certain => zeker; stellig; gewis; vast; vaststaand; verzekerd; bepaald; wis; sommige; degelijk
orientale => oosters
assiégée => belegerd
frappé => getroffen
diffusées => uitzending
syrian => syrisch
cibler => een doel kiezen; een doelgroep bepalen; doel
réuni => een gemaakt; verenigd
brièvement => kort
nationale => rijksweg
corroborent => bekrachtigd door de uitspraken
précédemment => voordien; eerst; eerder; voorheen; vooraf; indertijd; daarnet; daarstraks; voordat; vroeger
pouvions => kon
région => gebied
plausible => aannemelijk; waarschijnlijk
frappés => hit
fondation => stichting
péri => omgekomen
compréhension => begrip; verstehen; bevattingsvermogen; inzicht; toegeeflijkheid; begrijpen; begripsvermogen
préparer => voorbereiden; bereiden; aanmaken; toebereiden; klaarmaken
cutanées => huid
décollent => opstijgen
zones => gebieden
létal => dodelijk
édifice => gebouw
invoqué => aangehaald
gouvernementaux => overheid
vue => zicht; uitzicht; gezichtsvermogen; gezicht; aanblik; blik; schouwspel; kijk; panorama; vergezicht
scrutent => onderzoeken
accéder => aanspreken (van databank); bereiken; toegang; toegang verkrijgen; verkrijgen
seraient => zou
toit => dak; kap; overkapping; dakconstructie
dessus => boven; daarboven; omhoog; erop; bovenkant; daarop; op
récurrente => terugkerend
aéroport => luchthaven; vliegveld; vlieghaven
effacées => verwijderde
entrepôts => magazijnen
double => dubbel; tweeledig; tweevoudig; duplex; dubbelganger; duplicaat; evenbeeld; lookalike; pendant; tegenhanger
degré => graad; mate; trap; booggraad; rang; trede; treeplank; Trap; degree symbol; orde
résistance => weerstand; tegenstand; verzet; tegenweer; tegenkanting; elektrische weerstand; tegenstreven; verzetsbeweging; druksterkte; duurzaamheid
observateurs => waarnemers
acide => zuur; Zuur; citroenzuur; vetzuur; zure; zwavelzuur
précipité => haastig; neerslag; Neerslag; gehaasd; gejaagd
survols => overvluchten
afin => naar
incriminerait => beschuldigen
étages => vloeren
conditions => omstandigheden; voorwaarden
suédoise => Zweedse; Zweeds
lieux => plaatsen
déloger => verjagen
habitations => woon-
mortes => dood
engager => aansporen
localement => plaatselijk
précédé => voorafgegaan
désigne => middelen
cadre => kader; lijst; omlijsting; raam; frame; raamwerk; ambtenaar; beambte; functionaris; kaderlid
traces => spoor
filmé => gefilmd
civils => burgers
forte => luide; hard; harde; luid; geducht; scherp; sterk
composé => samengesteld; verbinding
combat => gevecht; strijd; slag; kamp; treffen; veldslag; worsteling; vecht; krijgsvoering; oorlogvoering
décollage => opstijgen; start
pillés => geplunderd
orales => mondeling
voisin => buurman; buur; buurvrouw; buren; aangrenzend; gebuur; nabuur; naburig; buuf; dicht
commencées => begonnen
informations => nieuws
quarante => veertig
action => aandeel
décollé => unstuck
images => beeldspraak
accusé => beschuldigde; aangeklaagde; beklaagde; gedaagde; verweerder
déterminent => bepalen
témoigné => getuige
enquêteurs => onderzoekers
présumées => afgeleide
quelle => welk; hetwelk
senti => vilt
urbain => stedelijk; stads
agence => agentschap; agentschapsbureau; bureau; kantoor
difficultés => ellende
coup => slag; klap
larguent => verstoten
interroger => uithoren
pu => kon
telles => zodanig
répondent => antwoord
accusation => beschuldiging; aanklacht; tenlastelegging; aangifte; telastlegging
relevés => statements
hypersalivation => speekselvloed
américano => us
exposition => tentoonstelling
précise => accuraat
répétition => herhaling
elles => zij; ze; hen; hun
évaluation => beoordeling
affirment => bevestigen
affirmant => claimen
préciser => vermelden; opnoemen; omschrijven
secouristes => redders
emportés => meeslepen
réel => reëel; werkelijk; daadwerkelijk; echt; waar; eigenlijk; heus; waarachtig; wezenlijk; reële
guidés => geleide
suffocation => verstikking
précipités => neergeslagen
reprend => hervat
chercheur => onderzoeker; zoeker; vorser; navorser; goudzoeker
ennemis => vijanden
nuit => nacht; nachtelijke duisternis; avondje; goedenacht; hotelovernachting; nachtje; nachtrust; overnachting
ciel => hemel; lucht; firmament; paradijs; heelal; hemelgewelf; hof van Eden; tuin der lusten; uitspansel; ruimte
utilisation => gebruik; aanwending; bediening; behandeling; benutting; gewoonte; hantering; inzet; manier; toepassing
femmes => vrouwen
installations => inrichting
échantillons => samples
scellant => robbenjager
attaque => aanval; offensief; vlaag
rapportent => verslag
montrant => tonen
utilisés => gebruikt
suivi => vervolg; bijhouden; tracering; voortgang
échanges => uitwisselingen
reddition => overgave; rekening doen; capitulatie; val
nombreuses => veel
obtenus => verkregen
dépêchés => overhaast
intérieur => binnenste; binnenlands
tourner => draaien; omdraaien; ronddraaien; aandraaien; keren
répandu => algemeen; heersend; wijdverspreid
sentiment => gevoel; emotie; gevoeligheid
mille => duizend
semaines => weken
refusent => weigeren
étions => waren
trente => dertig
sens => betekenis; zin; zintuig; richting; waarneming; gevoel; gewaarwording
scientifique => wetenschapper; wetenschappelijk
négociations => gesprekken
preuves => bewijsmateriaal
poursuit => blijft
casques => helmen
annonce => advertentie; aankondiging; bericht; bekendmaking; mededeling; reclame
empêché => verhinderd
montrent => tonen
respirer => ademen; ademhalen; inademen
finir => beëindigen
vivres => levensonderhoud; voorraad
tôt => vroeg; tijdig; weldra; spoedig; vroegtijdig; bijtijds; op tijd; pril
distinctes => apart
confirmer => bevestigen; bekrachtigen
confirmant => de bevestiging
soumise => ingediend
barils => vaten
observations => opmerkingen
faisceau => bundel; lichtbundel; bijlbundel; cluster; lictorenbundel; spierbundel; straal; schoof; rot(geweren); vaatbundel
inscrit => aangetekend; registrator
oiac => opcw
auraient => zou
effectué => gedaan
raid => inval; overvallen
civiles => burgerlijk
gouvernementale => overheid
human => menselijk
vol => vlucht; diefstal; vliegen; roof; vlieg; beroving; plundering; groep; robbery; schare
observés => opgemerkt
frappe => aanslag; geld slaan; munten; schot
corps => lichaam; lijf; lijk; kadaver; romp; vlees
affirme => zegt
emploi => baan; betrekking; ambt; plaats; werkkring; werk; post; wachtpost; beroep; werkgelegenheid
nouveau => nieuw; opkomend; vers; ander; nieuweling; opnieuw; weer; nieuwe; alweer; een groentje
empruntés => geleend
décompte => afknapper
violations => schendingen
gouvernement => regering
punir => straffen; bestraffen; afstraffen; veroordelen; kastijden; tuchtigen; huisarrest geven; veroordelen tot
utilisées => gebruikt
syriennes => syrisch
missile => raket
arpenté => ondervraagde
responsabilité => verantwoordelijkheid; aansprakelijkheid; toerekenbaarheid
visible => zichtbaar; zichtbare; duidelijk; evident; klaar; zienlijk; opvallend
neuf => negen
présentes => aanwezig
olivier => olijfboom
avantageuses => voordelig
soirée => avond; avondje; nachtje; fuif
retrouvées => gevonden
respiratoires => ademhalings
comptage => tellen
constatée => erkend
indice => aanwijzing; aanduiding
acceptent => aanvaarden
déploie => ontplooit
menées => complot; machinatie; samenzwering
reposent => vertrouwen
tenues => outfits
impliqué => betreffend
gorge => keel; keelgat; strot; kloof; hals; boezem; borst; bergkloof; buste; ravijn
bases => ABC; eerste beginselen
scène => toneel
huit => acht; achtste
accusant => beschuldigen
favorables => gunstig
bombardements => het schillen
couraient => rende
associé => vennoot; compagnon; partner; verbonden
photographies => foto's
sentait => vilt
opposants => tegenstanders
fameux => beroemd; befaamd; alom bekend; gerenommeerd; gevierd; glorierijk; roemrijk; vermaard; welbekend; wijdvermaard
rouvert => heropend
toitures => dak
ambitieux => eerzuchtig
imaginé => fantasierijk; fantasievol; gefantaseerd; ingebeeld
émissions => uitstoot
sculpteur => beeldhouwer
souligné => gemarkeerd
concerne => zorgen
abritait => gehuisvest
importants => belangrijk
déclaré => uitgesproken
protégés => beschermde
classement => classificatie; rang
hors => buiten; uit
monuments => bezienswaardigheid
publique => openbaar
estimé => gezien; hooggeachte
conçue => ontworpen
choix => keuze; keus; optie; verkiezing; keur; keuzemogelijkeheid; keuzemogelijkheid; compilatie; rechtskeuze; verschot
travaux => werken
situé => gelegen; liggend; gesitueerd
devraient => moeten
générale => algemeen
final => definitief; eindelijk
inaugurée => ingehuldigd
bâtiment => gebouw; bouwwerk; perceel; constructie; bouwsel; huis; opstal; schip; aanbouw; bouwindustrie
énormes => enorm
façades => gevels
immeubles => landgoed
époque => tijdperk; tijdsgewricht; periode; era; tijdrekening
ile => eiland
évolutions => ontwikkelingen
carrés => vierkant
jean => spijkerbroek
débats => werkzaamheden
adaptation => aanpassing
arabe => Arabisch; Arabische
inscription => registratie
ouverture => opening
veil => sluier
seine => zegen
nouvel => nieuw; vers; ander; nieuwe
emprise => houden; omvang; vat
expositions => tentoonstellingen
dimensions => afmeting
comprend => omvat
conception => ontwerp
bord => rand; kust; kant; oever
inscrite => ingesloten
forme => vorm; gedaante; figuur
rassemblé => samen
enregistrées => opgenomen
reconnaît => erkent
séquence => opeenvolging; volgorde; Sequens; serie; orde; reeks
fortes => sterk
pointillé => gestippeld; met punten; stippellijn
convié => uitgenodigd
conducteurs => geleiders
maintiendra => onderhouden
sursaut => herrijzenis; verrijzenis; tic
neuvième => negende; none; 9de; 9e; None; negenste
échange => uitwisseling; omwisseling; ruiling; handelen; inwisselen; inwisseling; omruilen; ruil; ruilen; uitwisselen
réunion => vergadering; bijeenkomst; samenkomst; meeting; vereniging; ontmoeting
borne => grens; grenspaal; kilometerpaal; klem; limiet; mijlpaal; mijlsteen
taux => ratio; voet; graad; koers; tarief
émission => uitzending; uitzenden
certaines => sommige
entendent => horen
raviver => aanwakkeren
commencera => beginnen
reconquête => herovering
volonté => wil; zin; wens; wilskracht; verlangen; zullen
destinations => toeristische bestemming
avancées => voorschotten
discussion => bespreking
votés => gestemd
évoquant => roepen
évoqué => vermeld
décliné => gedaald
durcir => stalen; harden; temperen; verharden; verstijven; besmeren; hard maken
sortant => zittend
réaffirmé => herbevestigd
voulue => gewenste
signalait => gerapporteerd
invités => gasten
syndicales => unie
assemblée => vergadering
avons => hebben
urnes => polls
quasi => amper; bijkans; bijna; haast; nagenoeg; praktisch
ores => al
fortement => sterk; terdege; zeer; fors; krachtig; machtig
toutefois => echter; niettemin; daarentegen; desalniettemin; toch; desondanks; niettegenstaande; edoch; maar; nochtans
trafic => verkeer; passage; zwarte handel; bedrijf; gegevensverkeer; handel; smokkel; vrachtverkeer
champs => akker; veld
prématuré => voortijdig; voorbarig; onrijp; ontijdig; onvoldragen
cheminots => railworkers
transports => vervoersnetwerk
lesquels => dewelke; hetwelk; welk; welke
sera => zullen
frapper => slaan
jugeant => oordelen
grève => staking; werkstaking; aanslaan; opvallen; strand; werkonderbreking
indiquait => bepaald
ayant => met
exprimé => uitgedrukt
majeurs => groot
syndicats => vakbonden
trouver => vinden
ajouté => toegevoegd; additioneel
grévistes => stakers
négociation => onderhandeling; dialoog; verhandeling
important => belangrijk; aanzienlijk; ernstig; erg; gewichtig; voornaam; zwaar; aanmerkelijk; zwaarwichtig; beduidend
dédommagements => compensatie
répondu => reageerden
prévue => verwacht
perturbations => verstoringen
achever => beëindigen; afwerken; klaarkomen met; volbrengen; afmaken; voltooien; eindigen; doden; dooddoen; doodmaken
ferroviaire => spoorweg; spoor-
circulation => verkeer
invitation => uitnodiging
remboursements => aflossingen
parmi => onder; tussen; te midden van; middenin; aan; bij; binnen; in; midden; te
prévisions => prognoses
offres => aanbiedingen
compléter => aanvullen; bijwerken
sujets => topics
voyageurs => reizigers
porté => gedragen; deur; geneigd
salariés => personeelsbestand
reviendra => terugkeer
commencé => begonnen
rencontre => ontmoeting; afspraak; colloquium; symposium; rendez-vous; vergadering; samenkomst; bijeenkomst
dur => hard; moeilijk; zwaar; lastig; slim; onzacht; stug; scherp; ongemakkelijk; afschrikwekkend
pacte => afspraak
inflexible => onbarmhartig; onverbiddelijk; meedogenloos; onbeweeglijk; onbuigzaam; onvermurwbaar
île => eiland; enclave; Hebriden; eilanden
trajectoire => baan; kogelbaan
saluant => looft
part => deel; aandeel; stuk; onderdeel; gedeelte; portie
farce => grap; klucht; streek; vulling
menace => bedreiging; dreiging; dreigement
créé => geschapen
défis => uitdagingen
continuer => voortzetten; doorgaan; vervolgen; blijven; duren; voortduren; voortgaan; aanhouden; beklijven; verder gaan met
ue => eu
irrégularités => onregelmatigheden
rétablissement => herstel; genezing; rechtsherstel; recuperatie; terugwinning
alléger => vergemakkelijken; vereenvoudigen; verlichten; verzachten; lichter maken
fut => ton
intérieures => binnenland
citoyens => mensen
précédent => voorafgaand; verleden; voorgaand; vorig; vroeger
large => wijd; breed; uitgebreid; omvangrijk; ruim; uitgestrekt; groot; veelomvattend; breedvoerig; overvloedig
responsables => ambtenaren
interdisent => verbieden
abaissé => naar beneden; omlaag; verlaagd
malheureusement => helaas; ongelukkigerwijs; jammer; jammer genoeg; tot mijn spijt; tot onze spijt; ongelukkig; bij ongeluk; spijtig genoeg
vote => Wotisch; stemming; stem; stembusgang; ballotage; verkiezing; stemmen
totalité => geheel
élection => verkiezing
dirigeant => leider; heerser; potentaat; soeverein; vorst; aanvoerder; aanvoerster; leidend; leidster; despoot
œuvrer => werk
visant => naar
expressément => opzettelijk; uitdrukkelijk; nadrukkelijk
réunit => voldoet
vainqueur => overwinnaar; winnaar; veroveraar; triomferend; zegepralend; zegevierend; winnares
resterait => blijven
électorale => verkiezing
devait => was
élections => verkiezing
soixante => zestig
vont => zullen
propres => eigen
soutenir => ondersteunen
adressé => aangesproken
misère => ellende
principal => voornaamste; belangrijkste; rector; directeur; hoofdzakelijk; hoodfzaak; hoofd-; hoofdzakelijke; voornaam; belangrijkst
tiers => derde; derde partij
appropriées => geschikt
qualifiée => gediplomeerd
iniques => onbillijk
hormis => behalve; buiten; ongerekend; buiten behalf
dangereux => gevaarlijk; hachelijk; link; gevaarlijke; gewaagd; riskant; bedenkelijk; schadelijk; bedreigend; onveilig
contestent => wedstrijd
menaces => bedreigingen
signé => ondertekend
précisions => gegevens
constatons => ziend
dette => schuld; schulden; verplichting; belastingschuld; staatsschuld
rapides => stroomversnelling; Stroomversnelling
pétrolier => olietanker; tanker; olie
condamnations => overtuigingen
tiennent => nemen
vice => ondeugd; ontucht; afwezigheid; gebrek; tekortkoming; beschadiging; defect; euvel; gemis; tekort
effondre => instortingen
lu => lezen
continue => blijft
étrangères => buitenlands
souffrances => lijden
participant => deelnemer; actief; genodigde
gérer => beheren; administreren; besturen; toedienen; leiden; bedienen; hanteren; managen; omgaan met; aanpakken
proches => bloedverwanten; familie; verwanten
nations => volken
félicité => geluk; gelukzaligheid; verrukking
biélorusse => Wit-Russisch; Belarussisch; Witrussisch
assurant => zorgen
bras => arm
auxquels => waartoe
appartenant => in bezit
visés => genoemd
dénoncé => opgezegd
instar => Stadium
scrutin => stemming
planer => zweefvliegen; een glijvlucht maken; zweven; high
réélection => herverkiezing
latine => Latijns
contestée => betwist
quatorze => veertien; veertiende
énoncés => statements
position => houding
union => unie; vereniging; eendracht; verbond; bond; eenheid; verbintenis; saamhorigheid; samenhorigheid
reconnaissait => erkend
reconnaîtrait => erkennen
prévenu => verdachte
série => reeks
nouvelles => nieuws; nieuw; vers; nieuwtje; nieuwigheid; tijding
équitable => rechtvaardig; eerlijk; billijk; acceptabel; fair; gerechtvaardigd; redelijk; schappelijk; correct; onpartijdig
courageux => moedig; dapper; kloek; boud; koen; dapper man; moedig man; braaf; durvend; flink
félicitations => gefeliciteerd
lesquelles => dewelke; hetwelk; welk
renforçait => versterkt
certains => enkele; sommige; enkelen; een of andere; enige
tiendrait => zou
lendemain => morgen; volgende dag
véritable => echt; eigenlijk; waarachtig; absoluut; heus; waar; onvermengd; onvoorwaardelijk; puur; recht
menacé => bedreigd
souhaité => gewenst
ciblés => doelgerichte
textes => teksten
annoncés => aangekondigd
rapporteuse => klikspaan
lorsqu => wanneer
mme => ms
sûrement => zeker; beslist; vast; ongetwijfeld; wel degelijk; bepaald; per se; strikt; volstrekt; vooral
déposés => lezen
repoussée => uitgesteld
rémunération => salaris; vergoeding; loon
tentatives => pogingen
camus => afsnauwen
vérité => waarheid; feit; eerlijkheid; oprechtheid; werkelijkheid; echtheid; bewijs
enfer => hel
révéler => openbaren; ontwikkelen; onthullen; ontpoppen; toevertrouwen; verklappen; bekendmaken; blootstellen; kenbaar maken; ontsluieren
ingérence => inmenging; storing
propositions => voorstellen
intentions => bedoelingen
satisfaisante => bevredigend
inexacte => onnauwkeurig
accusée => gedaagde
cesser => stoppen; ophouden; beëindigen; afmaken; afsluiten; aflaten; besluiten; wijken; uitmaken; uitscheiden
séance => vergadering; zitting
référés => genoemd
bonnes => goed
allégation => bewering; aantijging; beschuldiging
convoquant => bijeenroepen
gauche => links; onhandig; linker-; linkerkant; linker; linkse; stuntelig; scheef; onbeholpen; linker‐
trompeuse => bedrieglijk; bedriegelijk; misleidend
droite => rechts; rechterkant; lijn; rechte; rechtse; recht; rechte lijn; rechter; rechter-; goed
contretemps => ongemak
imputation => aantijging
imposent => nodig
juge => rechter; richter; achten; beoordelen; berechten; oordelen; rechtspreken
fake => namaak
qualifiées => gediplomeerd
souligner => accentueren; benadrukken
constance => beslistheid; bestendigheid
intervenir => ingrijpen; tussenbeide komen
espérer => hopen; wensen; willen; verlangen; hopelijk; verwachten; ernaar uitkijken om; hoop; uitkijken naar; verheugen zich op
craint => angsten
visent => doel
étudiés => bestudeerd
puisse => kan
centaine => honderd
faucillon => sikkel
apparences => verschijningen
impréparation => onvoorbereid
portée => notenbalk; draagwijdte; bereik; reikwijdte; omvang; worp; balk; variabelenbereik; domein; gewicht
file => rij
ordinaire => gewoon
levée => lichting; slag
fondées => gesticht
navette => schietspoel; weversspoel; Werpspoel; werpspoel
précédant => voor
édito => hoofdartikel
diffusent => verspreiding
permettra => zullen
diffusion => verspreiding
saisir => grijpen; aangrijpen; vangen; pakken; confisqueren; bemachtigen; vastgrijpen; vastpakken; vatten; verbeurd verklaren
pavé => wegdek; bestrating; plaveisel; kassei; kinderkopje
atteinte => afbreuk; aanranding; schenden; treffer; verlies
enjeu => inzet
fausses => vals
souhait => wens; verlangen; aspiratie; begeerte; lust; zin; heilwens; sollicitatie; zegewens; zucht
léger => licht; eenvoudig; gemakkelijk; lichtgewicht; lichtzinnig; light; onbelangrijk; triviaal; bleek; briljant
constitue => is
jugé => gevonden
votée => gestemd
confusion => verwarring; onduidelijkheid; wanorde; brij; verwardheid; stoornis; verlegenheid; verstoring; geroep; geschil
reçu => kwitantie; ontvangstbewijs
vers => naar
faciliter => vergemakkelijken; verlichten; vereenvoudigen; aanmoedigen; lichter maken; verzachten
coups => slaan
otage => gijzelaar; garant; gijzeling
épaule => schouder; schoft
entendus => gehoord
visé => betreffend
éléments => items
fuite => lek; vlucht; ontvluchting; ontsnapping; evasie; lekkage; ontkomen; lekken; onderduiken
liés => aanverwant; verwant
hôpital => ziekenhuis
source => bron; wel; welput; kwel; aanvang; begin; bron van rivier; fontein; start; broncode
interdit => verboden
suivait => gevolgd
pénétré => doorgedrongen
blessé => gewond; aangeschoten
instant => moment; ogenblik; oogwenk; seconde; tijdstip; tel; minuutje; poosje; secondje; mum
blessant => weerzinwekkend; kwetsend
premières => eerste
demandant => het roepen
transporté => vervoerde
ouvert => open; open verzameling; breed; openlijk
sache => weten
rentrait => terugkerende
homme => man; mens; heer; vent; kerel; manspersoon; gast; menselijk wezen; jongen; gozer
soins => behandeling; verzorging; zorg
prouver => bewijzen; aantonen; staven; adstrueren; uitwijzen; waarmaken; bekrachtigen; vaststellen; blijken; tonen
surveillait => kijken
répliquer => antwoorden
réponse => antwoord; reactie; repliek; bescheid; dupliek; ontzenuwing; tegenbewijs; terugslag; wederwoord; weerlegging
similaires => soortgelijk
renseignement => informatie; inlichting; bekendmaking; bericht; terechtwijzing; tijding; kennisgeving; mare; verwittiging; mededeling
ordinateurs => computers
local => plaatselijk
nsa => nos
patronne => baas; meesteres
ingérences => inmenging
utilisant => gebruik
ondes => golf
terre => aarde; grond; land; bodem; fond; ondergrond; wereld; aardrijk; voedingsbodem; aardbodem
cherchent => zoek
air => lucht; uiterlijk
us => gebruik; gewoonte
efficacement => krachtdadig; probaat; werkzaam
menée => uitgevoerd
rendre => teruggeven; maken; doen; braken; overgeven; weergeven; kotsen; laten; laten doen; spugen
légale => wettelijk
signe => teken; aanduiding; bewijs; blijk; merkteken; aanwijzing; markering; wenk; symbool; voorteken
nouveaux => vers; nieuw
restent => blijven
déclencher => activeren; beginnen; de eerste stap zetten; de spits afbijten; veroorzaken; initiëren; agiteren; doen ontploffen; in gang zetten; roeren
supériorité => overhand
masquées => verborgen
indiqué => aangewezen
suspendu => hangend; hangende; hangen; ophangen
moyens => draagkracht; geldmiddelen; middelen; middel
surveiller => controleren
prépare => bereidt
centrales => stations
adversaire => tegenstander; tegenspeler; tegenpartij; opponent; tegenstrever; mededinger; antagonist; opposant; oppositie; tegenstand
eau => water; drinkwater; ijswater; spoelwater; water ''s''; water geven; zeewater
tenter => verleiden; proberen; bekoren; verlokken; verzoeken; in verzoeking brengen; pogen; beproeven
sujet => onderwerp
paralysé => lam; verlamd
domaines => gebieden
révélé => onthuld
sensible => gevoelig; barmhartig; emotioneel; merkbaar; ontvankelijk; voelbaar; aanmerkelijk; bemerkbaar; genadig; goedertieren
pratiqué => beoefend
otan => navo
dirige => regisseert
ambiguë => dubbelzinnig
outils => gereedschap; extra; gerei; werktuigen
assure => verzekert
paralyser => verlammen; lamleggen; bevriezen
informatiques => it
perturber => storing veroorzaken; storen; ongerust maken
chargé => aangesteld; beheerder; manager; bedekt; bezet; geladen; verantwoordelijk; zwaar
limites => beperkingen
commandant => majoor
heurte => strikes
ire => woede; boosheid; toorn; verontwaardiging; gramschap
secours => EHBO; eerste hulp; hulp; assistentie; ondersteuning; bijstand; opluchting; redding
devons => moet
occidentaux => westelijk
performants => uitvoerend
gazette => krant; blad; tijdschrift
témoignait => toonden
occident => westen; west
notait => bekend
désactivant => uitschakelen
cybersécurité => computerbeveiliging
adversaires => tegenstanders
guerres => oorlogen
compétences => vaardigheden
budget => begroting
sensibles => gevoelig
brouillage => storing
nécessaires => nodig
provoqué => veroorzaakt
montre => horloge; uurwerk; polshorloge; klok; zakhorloge; tijdklok; klokje
combattre => strijden; vechten; kampen; strijd voeren; bevechten; bekampen; bestrijden; knokken; met; tegen
opère => exploiteert
traité => verdrag; verhandeling; overeenkomst; scriptie
furtives => heimelijkheid
évoluons => ontwikkelen
savent => weten
genre => geslacht; soort; aard; klasse; woordgeslacht
défend => verdedigt
limite => grens; perk
disputer => betwisten; bestrijden; aanvechten; tegenspreken
attribuée => toegewezen
fonctionnement => gang; werking; het functioneren; operatie
prévoit => biedt
logiciel => software; programmatuur; computerprogramma; programma; softwarepakket
pentagone => vijfhoek
reportées => uitgesteld
brièveté => beknoptheid
aggravé => slechter
événement => gebeurtenis
sondés => gesondeerd
heureux => gelukkig; zegenrijk; blij; vrolijk; verheugd; tevreden; zalig; heuglijk; opgeruimd; opgewekt
éclairante => verlichte
reporte => uitgesteld
cesse => voortdurend
remettre => herplaatsen; terugplaatsen
impôts => belastingen
procrastinent => uitstellen
possibilités => mogelijkheden
révèle => onthult
faits => feiten
atteint => aangekomen
obligés => gedwongen
cuisine => keuken; kookkunst; kookgelegenheid; kokerij; gastronomie; kost; kombuis; scheepskeuken; eetcultuur; hundsvot
dépasser => inhalen; uitsteken; voorbijstreven; overgaan; overtreffen; uitblinken; uitspringen; uitstaan
reines => koninginnen
tarder => achter zijn; over tijd zijn; te laat zijn; achterlopen; treuzelen; dralen (met); land doen over; talmen (met)
croit => gelooft
déposée => handelsmerk
prononcent => uitspreken
finit => uiteinden
lutte => worsteling; worstelen; gevecht; geworstel; strijd; conflict; slag; veldslag; Amateur wrestling; kamp
rangement => opslag
commandée => gecontroleerde
amplifié => versterkte
engendre => verwekt
activement => druk
multiplient => vermenigvuldigen
breveter => patenteren; octrooi
véritables => echt
déclarait => bepaald
étonnant => wonderbaarlijk; verbazingwekkend; prachtig; verbazend; verbluffend; verrassend; verwonderlijk; bevreemdend; indrukwekkend
imaginaire => denkbeeldig; fictief
petits => small
ancien => voormalig; oud; oudheid
arrête => hou op; huishoudelijk reglement; stop ermee
cocasse => grappig
rendez => afspraak
vive => pietermannen; lang leve; alert; gevat; spits; hoerageroep; kwiek
disait => zei
mets => gerecht
meilleures => best
notons => noot
retard => vertraging
payer => betalen; voldoen; dokken; uitbetalen; storten; uitkeren; omkopen; vergoeden; bekopen; bekostigen
conscients => bewust
cinquième => vijfde; een vijfde; vijf
fréquemment => dikwijls; vaak; veel; veelal; veeltijds; gedurig; menigmaal; veelvuldig; dikwerf
payé => betaald; betaalde; voldaan
viennent => komst
made => gemaakt
phrase => zin
volontiers => graag; gaarne; bij voorkeur; liefst; liever; met genoegen; eer; veeleer; met; plezier
payait => betalen
aidant => helpend
figaro => beteugelen
canard => eend; woerd; roddelblad; smient; flutkrant; eenden; bout
état => staat; toestand; gesteldheid; situatie; constellatie; stand; land; rijk; natie; status
particulièrement => vooral
citées => aangehaald
tripoter => porren; vingeren; betasten; friemelen; manipuleren; met; prutsen; rommelen
ménage => huishouden; huishouding
maladie => ziekte; aandoening; kwaal; ongezondheid; affectie; ziek
occupations => beroepen
loyer => huur; huurprijs; huren
admettent => toegeven
dispositions => bepalingen
pénalités => sancties
égalé => geëvenaard
démarches => stappen
procrastiner => uitstellen; voor zich uitschuiven; talmen
courses => boodschappen; boodschappen doen; winkelen
revenus => inkomsten
retardent => vertraging
tri => sorteren; sortering
prévu => voorzien
citation => citaat; aanhaling; dagvaarding
fléau => dorsvlegel; vlegel; plaag; gesel; pest; ramp; juk; schrik
tâche => taak; opgave; karwei; klus; opgaaf; werk; job; opdracht; baan; draad
augmente => toeneemt
contraire => tegendeel; tegenpool; tegengestelde; tegenovergestelde; tegengesteld; omgekeerd; tegenovergesteld; dwars; integendeel; onhandelbaar
pénaliser => bestraffen
baisse => besnoeien; besparen; bezuinigen; matigen; dalende; daling; ondiepte; val; verlagen; verlaging
sénèque => seneca
malice => boosaardigheid; Kwaadaardigheid; kwaadaardigheid; sluwheid
bricolage => doe-het-zelf
rentre => opbrengst
appellation => benaming; naam
agriculteurs => boeren
produisent => voorkomen
aliments => voedsel; kost; levensmiddelen
voie => spoor; weg; baan; rijvak; route; spoorbaan; spoorbreedte; rijstrook; spoorlijn; rail
apiculteurs => imkers
utiliser => gebruiken; benutten
conte => sprookje; verhaal; vertelling; kort verhaal; verhaaltje; vertelsel; fabel; volksverhaal
disparition => verdwijning; vertrek; ondergang; verderf; uittocht; vermissing
abeilles => bijen
posé => gesteld
produits => waar; waren
produisaient => geproduceerd
espèces => cash; contanten; baar; geld; contant geld; baar geld
miel => honing; honig
récoltent => maaiing
conséquences => nasleep
ruches => netelroos
toxiques => giftig
astuces => tips
plutôt => liever; nogal; eer; genoeg; tamelijk; veeleer; vrij; basta; bij voorkeur
installée => geïnstalleerd
rencontres => vergaderingen
croient => geloven
ateliers => workshops
appelées => riep
éviter => vermijden; mijden; ontwijken; uit de weg gaan; voorkomen; ontvlieden; ontgaan; ontsnappen aan; schuwen; verhinderen
signifie => middelen
facilement => gemakkelijk; allicht; met gemak; eenvoudig; gauw; gewillig; makkelijk; vlot
poser => plaatsen; leggen; doen
truquées => opgetuigd
collèges => hogescholen
repérer => ontdekken; bemerken; identificeren; opmerken; situeren; vinden
mensongères => vals
salle => kamer; vertrek; zaal; lokaal; ruimte; woonkamer; zitkamer; huiskamer; hal; wachtkamer
inventées => uitgevonden
garde => wacht; bewaker; wachter; behoud
foyers => huizen
piste => startbaan; pad; baan; parcours
confession => biecht; bekentenis; belijdenis; gezindte; ontboezeming; erkenning; Schuldbelijdenis
survenu => plaatsgevonden
découverte => ontdekking; vinding; vondst; uitvinding; doorbraak; detectie
ouverte => open
institutions => instellingen
écartée => verworpen
né => geboren; geboren worden; sneeuw; zwart; baren
faite => hoofd; kop; toppunt; kaap; voorgebergte
domicile => woning; woonplaats
écarter => spreiden; verwijderen; afdanken; ontbinden; ontslaan
âgée => ouderen
conduit => pijp; leiding; buis; pijpleiding; afvoerbuis; buisje; ductus; kanaal
rappelle => recalls
connaître => kennen; bekend zijn met; weten; beleven
suspect => verdachte; verdacht; verdenken
approfondie => diepte
découverts => ontdekt
néanmoins => niettemin; toch; echter; desondanks; maar; daarentegen; niettegenstaande; desalniettemin; nochtans; daarom
shoah => brandoffer
retrouvé => terecht; gevonden
placé => geplaatst
meurtre => moord; doodslag
flagrance => geur
juive => jodin; Jodin; Jood; Joods; joods
rescapée => overlevende
relevant => vallend
relâche => tussenpoos
inconnu => onbekend; vreemde; onbekende
niveaux => levels
retrouvée => gevonden
judiciaire => rechterlijk; gerechtelijk; gerechterlijk
riverain => aangeland; bewoner; oever; aangelande; aangrenzend; aanwonende; kust-
confiée => toevertrouwd
parisien => Parijs
incendie => brand; vuurzee; vlammenzee; brandstichting; inferno
morte => dode; dood; gestorven; overleden; verlept
lumière => licht; schijn; schijnsel; verlichting; zonlicht; daglicht; feniks; helderheid; lichtbron; gat
pouvoirs => bevoegdheden
incendies => brand
recueillies => verzamelde
courantes => gemeenschappelijk
communauté => gemeenschap; samenleving
menacée => bedreigd
couteau => mes; lemmet; messchede
vigilance => waakzaamheid; waaksheid
juives => jewish
femme => vrouw; echtgenote; gemalin; eega; man; gade; vrouwelijk; wijf; dame; juffrouw
service => dienst; afdeling
octogénaire => tachtiger
divorcent => echtscheiding
refuge => toevluchtsoord; asiel; toevlucht; vrijplaats; schuilplaats; heenkomen; reservaat; vluchtheuvel; nest; onderdak
enseignent => onderwijzen
confondues => verward
nourrir => voeden; voeren; voederen; grootbrengen; onderhouden; strelen; eten geven; koesteren; voedsel geven; aaien
changer => veranderen; wisselen; vermaken; wijzigen; kenteren; verkeren; aanpassen; zich aanpassen; omwisselen; omkleden
employés => werknemers
sortir => uitgaan
psycho => psychopaat
sachants => geïnformeerde partijen
burn => brandwond
avancer => vooruitgaan; voorgaan; voorlopen; voorwaarts gaan; oprukken; opschieten; vorderen
éduquer => kweken; opleiden; opvoeden; grootbrengen; dresseren
image => afbeelding; beeld; prent; plaat; voorstelling; plaatje; illustratie; portret; beeltenis; beeldspraak
aimer => houden van; liefhebben
match => wedstrijd
itinéraire => route; tracé; weg; reisplan; traject; koers; reisroute
bancs => klippen
écouter => luisteren; beluisteren; aanhoren; toehoren; toeluisteren; horen; gehoorzamen; afluisteren; naar; oren
relaxer => ontspannen; vrijpleiten
aguerrie => gekruid
aidera => helpen
inconscient => bewusteloos; onbewust; onbewuste; buiten kennis; onoplettend
métiers => bedrijf
devriez => moeten
comprennent => omvatten
capacités => hoedanigheid
forment => formulier
out => uit
remets => plegen
croyance => geloof; geloven; overtuiging; aanvaarding; mening; opinie; belijdenis; dogma; geloofsbelijdenis; grondregel
soupape => ventiel; klep; veiligheidsventiel; afsluitklep
démontre => shows
poil => haar; haarbreed; borstelhaar; lichaamshaar
vaste => enorm; groot; uitgestrekt; uitgebreid; breed; ruim; weids; alomvattend; diepgaand; omvattend
déclic => pal
malaise => katzwijm; ongesteldheid
endroit => plaats; oord; ruimte; plek; lokaliteit; zetel; locatie; verblijfplaats; localiteit; punt
comprise => begrepen; verstaan
avale => zwaluwen
nounou => kindermeisje; oppas; gouvernante; kinderjuffrouw; Kinderjuffrouw
patients => geduldig; zieke
donneurs => schenker
essence => benzine; soort
pourra => zullen
refuser => weigeren; afwijzen
intérêt => rente
relever => herstellen; reconstrueren; herbouwen; reorganiseren; saneren; verhogen; horen onder; leenplichtig zijn aan; vallen onder; weer opstaan
conjoint => echtgenoot; gezamenlijk; echtgenote; gezamelijk; verbonden; verenigd
relaxation => ontspanning
éloignée => afgelegen
décisions => beslissingen
travaillent => werkend
fac => unief; universitair; universiteit
plaindre => beklagen; medelijden hebben; medelijden hebben met; klagen; bejammeren; kankeren
déclinent => achteruitgang
beaux => mooi
désagréable => onaangenaam; naar; akelig; vervelend; verdrietelijk; onplezierig; onsmakelijk; ambetant; onprettig; onverkwikkelijk
effarée => bang
mutualisent => spreiden
unes => elk
actuelle => stroom
victimisée => slachtoffer
retrouve => vondsten
ajoutées => toegevoegd
demande => vraag; aanvraag; verzoek; verzoekschrift; aanvrage; eis
pris => genomen
croire => geloven; menen; agnosceren
foot => voetbal
profession => beroep; bedrijf; broodwinning
évoquer => oproepen; zinspelen; alluderen; allusie maken; naar boven brengen; te voorschijn roepen; ten gevolge hebben; terugroepen
soutiennent => ondersteuning
sentent => voelen
délivre => uitgangen
évidemment => blijkbaar; klaarblijkelijk; duidelijk; vanzelfsprekend; natuurlijk; overduidelijk; uiteraard; allicht; evident; beslist
sentir => ruiken; voelen; geuren; gewaarworden; rieken; aanvoelen; gevoelen
belle => mooi; knap; prachtig; aantrekkelijk; schoon; aantrekkelijke; aanverwant
semblable => gelijkend; gelijksoortig; eender; gelijkvormig; soortgelijk; gelijk; medemens; soortgenoot; vergelijkbaar; broeder
psy => psychiater; psychisch; zielenknijper; zielknijper
préjudiciable => schadelijk; funest; nadelig; ongunstig
téléréalité => realityserie; reality-tv; realitysoap
charge => lading; last; aanklacht; tenlastelegging; belasting; telastlegging; Vulstof; vracht; aanval; capaciteitsbelasting
imposée => verplicht
clés => trefwoorden
méprise => verwisseling
contresens => begripsfout
éd => ed
déséquilibre => onbalans
approches => benaderingen
observe => opgemerkt
métier => beroep; ambacht; vak; werk; handwerk; job
vécu => geleefd
bavards => spraakzaam
savoirs => kennis
senior => bejaarde
psys => krimpt
donnent => geven
look => kijk
plaisir => genoegen
dévié => afgeweken
impulser => stuwen
redonner => terugbetalen; teruggeven; weergeven; herstellen
médiatiques => media
immiscent => interfereren
contraintes => beperkingen
passée => afgelopen; schare; verleden; vlucht; voorbij; voorbije; zwerm
libérer => bevrijden; vrijlaten; loslaten; vrijmaken; verlossen; afhelpen; laten gaan; ontslaan; gratis; liberaliseren
nourricier => voeder
telle => zodanig
vois => zien
éducatifs => onderwijs
plonger => duiken; onderdompelen; onderwaterzwemmen; onder water zetten; ondergaan
donne => delen; deling; scheiding; verdeling
trucs => dingen; spullen; spul
confronté => toegewend
développent => ontwikkelen
routes => wegen
conduire => besturen; leiden; brengen; geleiden
seras => shalt
carburants => brandstoffen
voler => vliegen; stelen; ontvreemden; jatten; gappen; pikken; roven; navigeren
capables => in staat
dégagent => afgeven
science => wetenschap
électriques => elektrisch
diriger => leiden; besturen
nouveautés => nieuwkomers
véhicules => voertuigen
polluent => verontreinigen
automobile => auto
fonctionnent => functie
gazole => diesel; dieselolie
futur => toekomst; toekomstig; toekomend; toekomende tijd; in spe
probablement => waarschijnlijk; allicht; wel; vast; zeker; vermoedelijk
intellectuelle => verstandelijk
propos => bedoeling; doel; plan; strekking; woord; zeggen; toeleg; voornemen; zin; betoog
desquels => waarvan; wiens; wier; van wie
accueillons => welkom
universitaire => academicus; academisch
gage => garantie; borg; onderpand; pand; token; waarborg; belofte; borgstelling; verpanding; vuistpand
offrir => aanbieden; presenteren; schenken; indienen; voorstellen; cadeau geven; vertonen; te koop aanbieden
quinzaine => twee weken; veertien dagen
laisse => hondenlijn; lijn; leiband; riem; Hondenlijn; drietal
recherchant => zoeken
revendiquer => opeisen; eisen; doen gelden; aanspraak maken op; laten gelden; opkomen voor; claimen
fort => sterk; krachtig; luid; hard; straf; fiks; geducht; luide; erg
hybrides => bastaard
voulant => willen
rejoint => toegetreden
concours => wedstrijd
approche => nadering; benadering; aanpak
ancrée => ingeworteld
perçue => waargenomen
boursiers => voorraad
saint => heilig; gewijd; sacraal; geheiligd; heilige
raisons => redenen
durée => tijd; poos; duur; tijdsduur
assumé => verondersteld
adopté => aangenomen
crû => gegroeid
arts => letteren; kunsten; kunstwetenschap
correspond => komt overeen met
assumée => veronderstelt
recueillis => verzamelde
abord => aanneming; aanvaarding; betrekking; binnengaan; entree; intrede; kennismaking; landing; nadering; omgang
politiques => beleid
insertion => dub
limitée => beperkt
empêche => voorkomt
frein => rem; riem; remmen; remmer
certes => wel; zeker; immers; toch; wellicht; en of; inderdaad; weliswaar; jazeker; ook
urbanisme => verstedelijking; stedebouwkunde; stadsontwikkeling
uniquement => alleen; maar; slechts; enig; exclusief; onvergelijkelijk; uniek; enkel; louter
contribuer => bijdragen; meewerken
excellence => voortreffelijkheid; eminentie; uitmuntendheid
abrite => huizen
attractivité => aantrekkelijkheid
ponts => bruggen
aime => houden van
appliquées => toegepast
hautes => lang
maxime => spreuk; grondregel; kernspreuk; zinspreuk
regards => looks
accueille => verwelkomt
deuxième => tweede
formation => opleiding
reconduit => herbenoemd
offrent => aanbod
clairement => duidelijk; overduidelijk; vanzelfsprekend; begrijpelijke; duidelijke
fondamentalement => essentieel
découvrent => vinden
supérieures => hoger
née => geboren
délocalisé => verplaatst
réformes => hervormingen
retraités => gepensioneerden
huis => deur; poort; portier
maintenus => gehandhaafd
préféré => favoriet; lieveling; geliefkoost; lievelings-
alimentent => voeden
normand => Normandisch
progresse => vordert
moyennes => gemiddelden
téléspectateurs => toehoorders
inhabituel => ongewoon
destinée => lot; lotsbestemming; bestemming; fortuin; levenslot; voorland; nootlot; doel; toepassing; beschikking
directrice => rector; schoolhoofd
landes => heide
particulier => bijzonder; afzonderlijk; afgezonderd; apart; los; speciaal; eigenaardig; individueel; karakteristiek; ongebruikelijk
apercevoir => bespeuren; ontwaren; bemerken; merken; opmerken; in de smiezen krijgen; in het oog krijgen; vernemen; zicht
reconnu => beroemd; gerenommeerd; vermaard
résidents => bewoners
prédécesseur => voorganger; voorouder; vorige activiteit
gendarmes => rijkswachters
inquiétudes => zorgen
approcher => dicht bij elkaar brengen; naderen; dichterbijkomen; benaderen; dichtbij komen; naderbij brengen; naderbij komen; nadering
faible => zwak; licht; slappeling; donker; mat; schemerachtig; schemerig; slap; zacht; lapzwans
choisi => select; gekozen; uitstekend
regardé => kijk
rural => landelijk; boers; plattelands
député => gedeputeerde; afgevaardigde; parlementslid; Kamerlid; parlementariër; volksvertegenwoordiger; adjudant; adjudante; kamerlid
village => dorp; plaats; dorpen; gehucht
prochaine => aanstaand; eerstvolgend; komend; medemens; naast; volgend; volgende
volet => luik; blind; vensterblind; fase; klep; deel; sorteerplankje; deelvenster; (onder)deel
réparer => herstellen
arrivés => aangekomen
voulaient => gezocht
soutiens => ondersteuning
exprimera => uitdrukken
repartir => antwoorden; vertrekken
fouillés => doorzocht
regagner => herkrijgen
aube => dageraad
rurales => landelijk
ruraux => landelijk
attendu => verwacht
venu => gekomen
cote => aanhaling; cijfer
faisons => do
opinion => mening
urbains => stedelijk
cadres => staf
feuilleton => soap; soapserie; soapreeks
suivie => gevolgd
égalité => gelijkheid; gelijkspel; draw; gelijkwaardigheid; puntendeling; Gelijkheid; gelijkberechtiging; gelijke stand; gladdigheid; gladheid
cars => auto's
printanier => lente; voorjaars; lenteachtig; lente-; lente‐; voorjaars-; voorjaars‐
préférant => de voorkeur geven
sondages => polls
décrochent => drop
musclée => gespierd
riches => rijk
bouclé => gekruld.; kroes; krullerig; krullig; met neusring
soigneusement => zorgvuldig; voorzichtig; netjes
limitation => beperking; begrenzing
relativement => aardig; tamelijk; vrij; relatief; betrekkelijk; verhoudingsgewijs
orne => versiert
sondage => peiling; enquête; opiniepeiling; onderzoek; rondvraag; enquete; enquêtes; steekproef
curieux => nieuwsgierig
intention => bedoeling
paisible => rustig; kalm; vredig; gerust; stil; bedaard; vreedzaam; vredevol
hugues => hugo
vitesse => snelheid; tempo; vaart; versnelling; vaartje; sprint; gezwindheid; kruissnelheid; radheid; tandwiel
resté => geresteerd
occuper => bezetten; bekleden; beslaan; bewonen; bezig houden; in beslag nemen; inwonen; bezighouden; behartigen; verzorgen
apaiser => sussen; stillen; temmen; kalmeren; tot rust brengen; verslaan; verzoenen; verzachten; bedaren
soleil => zon; zonneschijn; Zon; koperen ploert; zonnebloem; zonnen
entretien => onderhoud
chaînes => keten
accusations => beschuldigingen
second => tweede
donner => geven; schenken; verlenen
retraité => emeritus; pensioentrekker; gepensioneerde
recule => wijkt
vise => doelstellingen
rumeur => gerucht
campagne => platteland
exaspère => ergeren
sait => weten
signent => teken
constituées => gevormde
puissants => krachtig
repousser => afstoten; verjagen; verwerpen; verdrijven; wegstoten; afwijzen; verdringen
visite => bezoek
visait => was
voyaient => zaag
déclarée => gedeclareerd
pivot => spil; draaipen; luns; tap; taats; center; Kreisläufer; roteren; scharnier; spindel
mondial => wereldwijd; wereld-; globaal
transpacifique => trans
perches => baars
permettrait => zou
asiatique => Aziatisch; Aziaat; Azische; Indische; Indiër; Oost-Aziaat; Oost-Azische; aziaat; azische
pourrions => kon
immédiat => direct; onmiddellijk; ogenblikkelijk; prompt; rechtstreeks; live; onmiddelijk; belendend; directe; naburig
désengagement => ontkoppeling
flake => vlok
rassemblait => verzamelde
poussé => vergevorderd
couru => rende
rejoindre => gelijken; lijken; lijken op; herenigen; verenigen; aansluiten; samen brengen; toetreden; vervoegen; afspreken
représentant => vertegenwoordiger; afgevaardigde; gedelegeerde; makelaar; zaakbezorger; zaakwaarnemer; exponent; tussenpersoon; voorbeeld; afgezant
alignés => uitgelijnd
envoyé => gezant; afgezant; gezonden; verzonden
obstacles => barrières
provoquerait => oorzaak
agriculture => landbouw; akkerbouw
envisager => overwegen; beschouwen; voorzien; onder ogen zien; van plan zijn; bedoelen; beogen; intenderen; overpeinzen
pourtour => omtrek; rand; kant
préféreraient => verkiezen
résumé => samenvatting
revenu => inkomen; rente; inkomsten; opbrengst; winst; omzet; het winnen; verdienste
cherche => zoek
promesse => belofte; toezegging; uitloving
tient => houdt
complètement => volledig
imposer => belasten; opdringen; opleggen; verplichten; dwingen; forceren; veraccijnzen; aandoen; aanslaan; aantrekken
suppression => verwijdering; afgelasting; annulering; deletie; eliminatie; intrekken; onderdrukking; schrapping
tricheries => bedrog
revenir => terugkomen; terugkeren; wederkeren; afvallen; wederkomen; weeromkomen; achteruit gaan; teruggaan
encerclement => omsingeling
partagés => gedeelde
bon => goed; juist; lekker; okee; correct; goede; billijk; eerlijk; rechtvaardig; aangenaam
robert => tiet; tieten
vis => schroef
nul => waardeloos; geen; niemand; nietig; gelijkspel; geen enkel; geen enkele; generlei; nietswaardig
accords => overeenkomsten
renégociation => heronderhandeling
réduisait => gereduceerd
préaccord => voorakkoord
syndicat => vakbond
propriété => eigendom; eigenschap; eigendomsrecht; bezit; bezitting; goed; landgoed; boerderij; kwaliteit; allooi
souhaits => groeten
exaspérés => verbitterd
inconditionnels => hardcore
axe => as; spil; spindel; aslijn; middellijn; pen
moribond => stervende
plébiscité => geprezen
allions => gaand
attaqué => aangevallen
trahissait => verraden
préférerait => verkiezen
immédiatement => meteen; dadelijk; aanstonds; zo; schielijk; op staande voet
critique => recensie
cessé => opgehouden
cols => kragen
douze => twaalf; twaalfde; twaal
asie => azië
tentation => verleiding; verzoeking; aanvechting
baisser => zakken; dalen; neerlaten; strijken; laten zakken; vellen; verzakken; wegzakken; zinken; bukken
tollé => verontwaardiging
maltraiter => mishandelen
trahir => verraden; laten merken; in de steek laten; bedriegen; verklappen; aangeven; misleiden; verklikken; ontrouw worden; teleurstellen
accord => akkoord; overeenstemming; overeenkomst; afspraak; samenklank; harmonie; instemming; congruentie; verdrag; goedkeuring
partisans => aanhang
revivre => opleven
défendent => verdedigen
fermiers => boeren
furieux => woedend; doldriftig; verwoed; verbolgen; woest; dol; spinnijdig; razend
scellée => verzegeld
contenait => bevatte
condition => voorwaarde
désengagé => vrij
négocier => onderhandelen; afdingen; marchanderen
milieux => achtergronden
adoucir => lenigen; vergulden; verzoeten; verzachten; afstompen; bot maken; milderen; temperen; verlichten; kalmeren
contraint => gedwongen
ceinture => gordel; riem
griefs => klachten
négocié => onderhandeld
violer => verkrachten; schenden; overtreden; breken; ontheiligen; ontwijden; profaneren; verbreken; afbreken; doorbreken
puissance => macht; vermogen; kracht; heerschappij; mogendheid; rijk; staat; sterkte; capaciteit; hoofdtelwoord
azimuts => rondje
suscite => wekt
croyait => gedachte
trouvé => gevonden; stichten; vond; vonden
expliqué => uitgelegd
rouille => roest; oxydatie; corrosie; oxidatie; rust
onze => elf; elfde
résolvait => opgelost
examiner => onderzoeken
renouvelé => vernieuwd
surprise => verrassing
soviétique => Sovjet-; sovjet-; sovjet; sovjetisch
faudra => zullen
souvient => recalls
traduire => vertalen; overzetten
meme => zelfde
longtemps => lang; lange tijd
pleine => zwanger; drachtig; in verwachting; zwaar; massief; vol
commença => begon
frontière => grens; landsgrens; perk; limiet; Frontier (lijn); rand; buitengrens; grenzen; taalgrens
méditerranée => middellandse zee
renforcement => versterking; bekrachtiging; beloning; versteviging
lanceurs => draagraketten
mers => zeeën
riverains => omwonenden
réels => echt
oubliée => gemiste
climatique => klimatologische
ports => havens
transiter => doorvoer
marins => zeelieden
obtenu => verkregen
abandonnée => verlaten
semblent => verschijnen
clé => sleutel; Engelse sleutel; muzieksleutel; toets; toonsoort
esprit => geest; verstand
mer => zee
bataille => gevecht; veldslag; strijd; slag; kamp; treffen; flap; houw; klap; mep
méditerranéens => middellandse zee
nommée => genoemd
votre => uw; jullie; je; jouw
engins => machinerie
reconnaitre => erkennen; herkennen; toegeven; verkennen
voudra => willen
mère => moeder; mamma; ouder; ma
disputés => betwist
redevenue => teruggekeerd
fallu => nam
erreur => fout; vergissing; abuis; dwaling
accueil => ontvangst; onthaal; aanneming; aanvaarding; receptie; acceptatie; balie; opname; begroeting; groet
yew => taxusboom
histoire => geschiedenis; verhaal
inexpugnabilité => onkwetsbaarheid
batailles => gevechten
basculé => geschakeld
navale => marine-
génois => genua; Genuese
enjeux => uitdagingen
employée => bediende; werknemer; medewerker; aangestelde
renforcée => versterkte
tant => zoveel; zozeer; evenveel; dusdanig; terwijl; zo; dermate; als; zolang
répété => herhaald
rage => hondsdolheid; razernij; woede; dolheid; boosheid
traduction => vertaling
phéniciens => fenicisch
gentiment => vriendelijk; aardig; vriendschappelijk; aangenaam
relâchée => vrijgegeven
répondait => antwoord
enregistré => aangetekend
restée => bleef
propose => aanbiedingen
coulisses => achterplan
reporter => overbrengen
micros => microfoons
matins => morgen
enrichie => verrijkt
vérifier => controleren; checken; aflezen
classeur => ordner; map; werkmap; bestandenlijst; directory; multomap
vérifient => controleren
enregistrement => record
serais => zou
collégiens => studenten
reconnaître => erkennen; herkennen; bekennen; verkennen; constateren; onderzoeken; vaststellen; biechten; toegeven; agnosceren
actualité => iets actueels
pourras => in staat
présente => aanwezig; aanwezige
infos => informatie
poli => beleefd; hoffelijk; heus; galant; welgemanierd; wellevend; beschaafd; glad; gemanierd; aardig
sonnerie => beltoon; ringtone; bel; belsignaal; overgaan
trousse => pennenzak; etui; koffer; passerdoos; uitrusting
clichés => shots
sincère => oprecht; innig; ongeveinsd; openhartig; eerlijk; rondborstig; trouwhartig; zuiver; objectief; rechtschapen
méfiance => wantrouwen; argwaan; achterdocht; schroom
média => communicatiemiddel
relancer => herstarten; heropstarten
traiter => behandelen; onderhandelen; genezen; helen; bewerken; bejegenen; verwerken; voorstellen; verzorgen
valoir => waard zijn; lonen; gelden; verdienen
savons => weten
empoisonné => giftig
dossiers => archief
faisant => making
accorder => stemmen; in overeenstemming brengen; verlenen; rijmen; tot overeenstemming brengen
soutenue => ondersteunde
réunis => samen
intégrons => integreren
sein => borst; boezem; schoot; uier; mamma; mem; pram; tiet; vrouwenborst; buik
affiché => weergegeven
déclenchés => getriggerd
débattu => gedebatteerd
malgré => ondanks; niettegenstaande; in weerwil van; ten spijte van; trots; desondanks; ongeacht; niettemin; ofschoon; spijts
décrié => berucht
proposé => voorgestelde
avenir => toekomst; toekomende tijd; verschiet; toekomstig
frontières => grens
défendu => getand; verboden
confie => toevertrouwt
délais => deadlines
communes => gemeenschappelijk
obtenir => verkrijgen; verwerven; behalen; krijgen; deelachtig worden; buitmaken; halen; nemen; pakken; bemachtigen
résultats => prestatie; voorstelling
peser => wegen; afwegen; het gewicht bepalen; zwaar zijn; zweven; afvragen; belangrijk zijn; gewichtig zijn; hangen
collectivités => gemeenschappen
séjour => verblijf; woonkamer; oponthoud; huiskamer; living; zitkamer; woonvertrek; blijven; logeren; toeven
enlisée => verstrikt
résumer => samenvatten
députés => afgevaardigden
souhaite => wensen
extérieure => buiten-
démesurée => buitensporig
répartition => distributie; ditributie; uitdeling; winstverdeling
commun => gemeenschappelijk; algemeen; gemeen; gezamenlijk; gewoon; gemene; gewone; alledaags; veelvoorkomend; commuun genus
tangibles => tastbaar
échéance => vervaldag; verschijndag; betaaldag; vervaldatum; deadline; einddatum; termijn; vervaltijd; tijdslimiet
arrivé => gebeurd
adressait => aangesproken
allemagne => duitsland
grèce => griekenland
opinions => adviezen
halls => zalen
entrants => inkomend
retards => vertragingen
demandait => gevraagd
matinée => ochtend; morgen; voormiddag
fermés => gesloten
flights => vluchten
vols => vluchten
cependant => echter; maar; niettemin; toch; daarentegen; hoewel; nochtans
panne => motorpech
be => zijn
massés => vergaap
vingt => twintig; twaalf; twintigste
capacity => hoedanigheid
courant => stroom; stroming; loop; gangbaar; actueel; elektriciteit; huidig; spanning; stroomsterkte; voeding
réduit => gereduceerd; verkleind; kamer; reduceren; teruggebracht; verminderd
prévoient => verschaffen
décourager => ontmoedigen
regarding => met betrekking tot
affecté => aangedaan; aangegrepen
entraîné => resulteerde
réparée => gerepareerd
flux => vloed; stroom; aanvoer; gegevensstroom; beek; feed
storing => het opslaan
between => entre
compagnie => gezelschap; vennootschap; maatschappij
reculer => terugdeinzen; achteruitgaan; achteruitlopen; teruggaan; teruglopen; wijken
gagnées => won
remontée => beklimming
repêché => opgesteld
belles => mooi
imposé => onvrijwillig
incliné => geneigd
éliminé => verwijderd
inchangé => ongewijzigd
places => zetels
mauvaise => slecht
top => piep
spatiale => ruimte
martien => Mars-; marsmannetje; van Mars
décolle => neemt af
toi => je; jij; u; jou; ge; gij; jullie; zelf
monter => stijgen; instappen; klimmen
décoller => opstijgen; losweken; starten
casque => helm; koptelefoon; droogkap; hoofdtelefoon
clique => gevolg
secret => geheim; geheimenis; geheimhouding
rouge => rood; blozend
capable => bekwaam; competent
bouton => knop; pukkel; knoop; puist; puistje; drukknop; mee-eter; toets; Knoop; scheut
sons => klanken
insight => aha-erlebnis
attention => aandacht
répondre => antwoorden; beantwoorden; afslaan; pareren; terugslaan; antwoorden op; reageren; terugstoten; bescheid geven; opnemen
inspiré => geïnspireerd
recevoir => ontvangen; krijgen; aannemen; accepteren; genieten; toucheren; verkrijgen; aanvaarden; erkennen; horen
leçon => les; cursus; koers; leergang; route; tracé; traject; contactuur; lesuur; onderwezen kennis
portable => draagbaar; laptop; mobieltje; mobiele telefoon; gsm; notebook; GSM; zaktelefoon; 06; lulijzer
tenu => gehouden; gepast; verschuldigd
insulte => belediging; affront; krenking; scheldwoord; smaad
gire => iwrm
allume => lichten
retrait => inspringing; derving; herroeping; holte; inspringen; kuil; withdrawal
prenez => nemen
voilà => hier; kijk; ziehier; alsjeblieft; alstublieft; ziedaar; hierzo; ziezo; aanschouw; daar
suivant => volgend; aanstaand; volgende; volg-; later; volgens; achterste; daaropvolgens; eerstvolgend; naar
milan => wouw; Wouwen; havik
grave => belangrijk; ernstig; erg; voornaam; zwaar; zwaarwichtig; serieus; stomp; stomphoekig; aanzienlijk
sévères => streng
œil => oog; kijker; Oog; gezichtsorgaan; oculus; oogappel; oor
décidera => beslissen
négociée => onderhandeld
emblée => onmiddellijk
éducation => onderwijs; opvoeding
dispenser => uitdelen; vrijstellen; ronddelen; rondgeven; ontslaan; uitreiken
fière => trots
réattribue => opnieuw toewijst
instauré => gevestigd
doté => met
rentrée => hervatting; terugkeer; terugkomst; come-back; wederkeer; wederkomst; comeback; come‐back; terugkeren
mesure => maat; grootte; mate; maatregel; ritme; tact; meting; beleid; afmeting; versmaat
litiges => geschillen
rangez => winkel
sacs => tassen
éteignez => uitschakelen
ado => jongeling; borst; jongeheer; tiener; jongere
habitudes => gewoontes
permanent => eeuwig; voortdurend; blijvend; doorlopend; ononderbroken
profite => voordelen
entend => hoort
fédèrent => tot een bond verenigen
tirent => schieten
coin => wig; hoek; spie; keil; keg; hoekje; hoekschop; plek; tip
auprès => dichtbij; nabij; daarnaast; naast
lotis => af
chômage => werkloosheid; werkeloosheid; werkloos; arbeidsloos
cotisent => bijdragen
reconnue => erkend
prête => klaar; gereed; klare; tevreden; voorbereid; voorbereide
gagnent => verdienen
généraux => algemeen
bénéficient => voordeel
généralement => doorgaans; gewoonlijk; algemeen; meestal; in het algemeen; in de regel; meestentijds; normaal; normaliter; over het algemeen
essaient => proberen
galopante => ongebreidelde
précarisent => meer precaire
payés => betaald
tombent => vallen
attirer => aantrekken; lokken; trekken; aanhalen; verlokken; verleiden; weglokken; aanlokken; bedriegen; misleiden
situent => zijn
similaire => gelijkend; gelijksoortig; vergelijkbaar; dergelijk; gelijkaardig; overeenkomstig; gelijkvormig; homogeen; lijkend op; soortgelijk
fasse => maken
exception => uitzondering
paternité => vaderschap; schrijverschap
pis => uier; pram; Uier; slechter
sonnette => bel; klok; schel; rinkelbel; heistelling; deurbel
calvaire => doodsangst; agonie; martelgang; doodsstrijd; hevig; kruisweg; kwelling; lijden; lijdensweg; kruisbeeld
assurance => verzekering; zekerheid
congé => vakantie; verlof; ontslag; afmonstering
assurer => verzekeren; waarborgen
fr => beek; inzicht
cri => schreeuw; roep; kreet; Cree
cultivent => groeien
créateurs => scheppers
défendre => verdedigen; verweren; opkomen voor; verbieden; beschermen; niet toestaan; bepleiten; veroordelen; vorstaan
congés => vertrekken
revanche => vergelding; wraak; restituering; terugbetaling; wedervergelding
maternité => moederschap; kraamkliniek
bafouent => spot
jugent => overwegen
épineux => netelig; netelige; gecompliceerd; ingewikkeld; lastig; moeilijk; ongemakkelijk; problematisch; hoofdbrekend
alentours => omgeving; omstreken
dérisoire => armzalig; beklagenswaardig; lachwekkend; meelijwekkend; pietluttig; triviaal; waardeloos
rare => zeldzaam; schaars; ongemeen; karig; kostbaar; schraal; schriel; zeldzame; ijl; weinig
réclamation => klacht; aanklacht; aangifte; aanspraak; accusatie; beklag; beschuldiging; telastlegging; tenlastelegging; vordering
partagée => gedeelde
précarité => onveiligheid
retraite => pensioen; aftocht; pensionering
plier => vouwen
devient => wordt
prélèvement => heffing; orderverzamellijst; tekening; terugnemen; terugtrekken; verwijdering
représente => vertegenwoordigt
guise => goeddunken
maisons => huizen
demandons => vragen
inégale => ongelijk
vagues => golven
inquiétés => bezorgd
manche => mouw; stuurknuppel; bedieningshendel; hals; frame; joystick; set; steel; Inning; Mouw
uni => effen; verenigd; gelijk; glad; sluik; vlak; vlot; zonder moeilijkheden; monochroom
suffi => genoeg
provoquées => veroorzaakt
ferait => zou
affrontés => botsten
restons => blijven
générer => veroorzaken; creëren; fabriceren; maken; produceren; scheppen; vervaardigen; voortbrengen; verwekken; build
opposé => tegengesteld; strijdig; tegenstrijdig; tegenliggend; tegenstaand; tegenovergesteld; omgekeerd; tegendeel; tegenoverliggend; tegenover
réciproques => wederzijds
attentats => aanvallen
encontre => tegen
piètres => arm
gelé => bevroren
déconseille => aanraden
royale => koninklijk
fournir => leveren; afleveren; bestellen; toevoeren; verschaffen; voorzien van
équipes => teams
antécédents => geschiedenis; verleden; voorgeschiedenis
royaume => koninkrijk; rijk; koninkrjik
tensions => spanningen
inquiets => bezorgd
ajoutent => toegevoegd
rejette => verwerpt
laps => interval; tijdsverloop; verloop
déplacement => waterverplaatsing; verplaatsing; beweging; bewegen; ontheemding; reis
engendrer => verwekken; teweegbrengen; veroorzaken; aanrichten; uitlokken; baren; broeden; voortbrengen; ontvangen
demandées => gevraagd
fermer => sluiten; dichtdoen; afsluiten; dichtmaken; toedoen; op slot doen; dichtklappen; dichten; afzetten; beëindigen
fichier => bestand
avez => hebben
souhaitez => willen
joignant => aansluiting
suivante => het volgende; later
libertés => vrijheden
portabilité => draagbaarheid
auquel => waaraan; wie
destinées => voor
lille => rijsel
actu => nieuws
articles => goederen
recevez => ontvangen
pièce => kamer; stuk; muntstuk; munt; vertrek; brok; geldstuk; bonk; eindje; homp
renvoyons => verwijzen