street => straat
fini => eindig
humane => humaan
pub => pub
perdre => verbeuren
center => centrum
note => noot
torrents => torrents
dollars => dollars
polémique => polemiek
système => systeem
usc => usc
administration => administratie
lance => lans
professeur => professor
gouvernements => overheden
jennifer => jennifer
nombre => nummer
apple => appel
régulation => regulatie
analyste => analist
ce => die
par => per
des => der
comme => hoe
ou => of
problématique => problematisch
syracuse => syracuse
car => daar
idée => idee
technology => technologie
analytica => analytica
formes => vormen
application => applicatie
finalement => eindelijk
fois => ooit
point => punt
a => a
qui => wie
partie => Part
ex => ex
temps => tempus
entier => geheel
d => d
wall => wand
congrès => congres
leur => hun
transparence => transparantie
et => en
mettent => zetten
internet => internet
roger => rogier
fait => feit
n => n
commerce => commercie
une => een
e => e
uber => uber
ne => niet
s => s
que => die
capitalisation => kapitaalvorming
rgpd => rgpd
san => san
investisseur => investeerder
groupe => groep
mark => mark
dérives => drifts
pages => pagina's
université => universiteit
règlement => regeling
vague => vaag
tesla => tesla
t => t
north => noorden
brian => brian
dans => aan
social => sociaal
alors => aldus
firme => firma
du => des
mai => mei
au => aan
en => in
galloway => galloway
vigueur => vertier
valley => vallei
manipulation => manipulatie
moins => min
grygiel => grygiel
le => het
signal => signaal
extérieur => extern
protection => protection
pourtant => nochtans
autonome => autonoom
accumule => accumuleert
esclave => slaaf
new => nieuw
depuis => vermits
pas => pas
deletefacebook => deletefacebook
entrer => inkomen
voiture => voertuig
avoir => bezitten
totalement => compleet
cambridge => cambridge
europe => europa
millions => miljoen
experts => experts
auto => auto
twitter => twitteren
doit => moet
scott => scott
littéralement => letterlijk
milliards => miljard
européen => Europees
absolument => absoluut
autre => andere
critiqué => kritiek
numérique => numeriek
elon => olgens
whatsapp => whatsapp
publicité => publiciteit
plus => plus
bourse => beurs
impact => impact
l => l
personnelles => persoonlijk
un => een
google => google
raison => ratio
silicon => silicium
argent => argent
fortune => fortuin
secteur => sector
compliquer => compliceren
technologiques => technologisch
ces => die
géant => gigant
pour => voor
membre => element
faire => bedrijven
acton => acton
groupes => groepen
réservation => reservatie
mcnamee => mcnamee
su => su
spécialiste => specialist
privée => privé
personnalités => persoonlijkheden
enderle => enderle
ca => ca
plate => plat
question => kwestie
thiel => thiel
francisco => francisco
mais => maar
critiques => critici
peter => peter
c => c
etats => staten
technologie => technologie
facebook => facebook
économique => economisch
karen => karen
zuckerberg => zuckerberg
modèle => model
journal => courant
technologique => technologie
californie => californië
veille => vigilie
musk => muskus
doivent => moet
la => de
les => de
financière => financieel
individus => individuen
sociaux => sociaal
patron => patroon
reste => rest
via => via
ligne => lijn
york => york
commencer => beginnen
organisation => organisatie
tech => tech
amazon => amazon
pression => pressie
university => universiteit
se => ge
il => ie
spacex => spacex
ci => ci
lire => lire
orgue => orgaan
midi => middag
universelles => universeel
créer => creëren
olson => olson
école => school
affiche => affiche
systématiquement => systematisch
département => departement
kilomètre => kilometer
étudiante => student
grand => groot
objectif => objectief
parcours => parcours
nos => ons
politique => politiek
gonzales => gonzales
post => post
alexandria => alexandrië
wilson => wilson
actif => actief
officielle => officieel
mandat => mandaat
conclut => concludeert
transforment => transformeren
ai => ai
cas => casus
achat => aanschaf
changement => verandering
agir => ageren
merci => merci
je => jij
compacte => compact
columbia => columbia
silence => stilte
communiqué => communiqué
parole => parool
avorté => geaborteerd
blocage => blok
passer => passeren
emma => emma
direct => direct
révolution => revolutie
américaine => Amerikaans
contrôle => controle
automatiques => automatisch
télévisions => televisies
lago => lago
frère => frater
primaire => lineair
pop => pop
wadler => wadler
priorité => prioriteit
participer => participeren
content => content
laquelle => dewelke
points => punten
tribune => tribune
main => hand
justice => justitie
humain => humaan
pancartes => plakkaten
arriver => arriveren
long => lang
grâce => gratie
hiver => winter
accessoires => accessoires
brandit => zwaait
progressifs => progressief
différence => differentie
colorado => colorado
hôtel => hotel
douglas => douglas
papa => papa
mars => mars
vente => auctie
jersey => jersey
brosowsky => brosowsky
vietnam => vietnam
théâtre => theater
kasky => kasky
trump => troef
neveragain => neveragain
croisement => kruising
john => john
washington => washington
ultraprofessionnelle => ultraprofessionnelle
hui => hui
emmett => emmett
mon => mijn
peuple => peupel
débat => debat
walters => walters
personnellement => persoonlijk
timide => timide
show => show
expression => expressie
grosse => gros
adolescent => adolescent
parkland => parklandschap
leaders => leiders
électoral => electoraal
départ => start
carton => karton
leader => leider
gonzalez => gonzalez
partir => starten
nous => ons
marjorie => marjorie
toutes => alles
manalapan => manalapan
historique => historisch
marche => markt
afp => afp
international => internationaal
rien => niets
débarrasser => debarrasseren
écrit => geschrift
vidéos => videos
pennsylvania => pennsylvania
active => actief
internationale => internationaal
cours => cursus
naomie => naomie
voix => vorm
déclaration => declaratie
gens => mensen
aujourd => aujourd
écoles => scholen
logo => logo
détente => detente
début => debuut
anna => anna
mi => mi
jeunes => jeugd
courage => courage
génération => generatie
vivre => leven
étudiants => studenten
podium => podium
légal => legaal
fille => meisje
installé => geïnstalleerd
avenue => avenue
floride => florida
confrontés => geconfronteerd
mères => moeders
armée => armee
juste => juist
père => pater
nombreux => numereus
permettre => veroorloven
manifestation => manifestatie
johnnie => johnnie
moi => mij
devoir => dienen
correspondant => corresponderend
pencinenga => pencinenga
servent => serveren
contrôles => controls
enregistrer => registreren
grands => groot
capitole => capitool
exclame => exclaims
ouvertement => onverholen
progrès => progress
balles => bullets
listes => lijsten
ecole => ecole
exercice => exercitie
violence => violentie
cameron => cameron
lycée => lyceum
emblématique => emblematisch
amendement => amendement
bump => buil
novembre => november
porte => portier
shooter => schieten
micro => micro
français => Frans
crâne => cranium
organisée => georganiseerd
on => op
échos => echo's
reportage => rapport
virginie => virginia
moore => moore
apogée => apogeum
sont => bent
lindsay => lindsay
nra => nra
columbine => columbine
conformément => conform
président => president
assaut => attaque
pensez => denken
vous => jou
interdiction => interdict
lafayette => lafayette
contre => contra
capitale => kapitaal
référence => referentie
hogg => hogg
lobby => lobby
bientôt => binnenkort
installées => geïnstalleerd
petit => nietig
stoneman => stoneman
blanche => blanke
donald => donald
jannie => jannie
panneau => paneel
matière => materie
maîtresse => minnares
gestes => gebaren
professeurs => professoren
intégrer => integreren
maman => mammie
tu => u
langue => langue
te => te
entrée => entree
étais => was
yé => yé
russe => russisch
classes => classes
seule => alleen
moscou => moskou
non => neen
musique => muziek
activités => activiteiten
occasion => occasion
russie => rusland
famille => familie
football => voetbal
ailleurs => elders
priviète => priviète
maître => meester
anglais => Engels
perdue => verloren
as => aas
france => frankrijk
classe => klasse
moment => moment
fa => fa
vladimir => vladimir
collège => college
sou => sou
m => m
feuille => folie
grande => groot
camarades => kameraden
paris => parijs
russes => russisch
poutine => poutine
ensemble => ensemble
filipovskaïa => filipovskaïa
paire => even
mettre => zetten
ton => toon
es => is
exemple => exempel
font => font
cour => koer
nina => nina
expérience => experiment
majorité => majoriteit
euros => euros
officiellement => officieel
or => or
équipe => equipe
fin => fijn
lfp => lfp
professionnel => professioneel
unai => unai
clair => klaar
championnat => kampioenschap
presse => pers
ben => ben
minimum => minimum
sport => sport
coach => coach
offensif => offensief
titre => titel
emery => emery
seconde => seconde
conférence => voordracht
arfa => arfa
cadeau => cadeau
club => club
moindre => minder
joueur => gokker
effectif => effectief
vendre => verkopen
hatem => hatem
caen => caen
minute => minuut
possible => potentieel
rester => resteren
demi => demi
psg => psg
conflit => conflict
coupe => kop
saison => Saison
interrogé => ondervraagd
finale => finale
ajouter => aanbouwen
immense => immens
ligue => liga
espagnol => Spaans
sg => sg
champion => kampioen
fleur => fleur
donc => dan
direction => richting
risque => risico
prime => premie
entraîner => trainen
diego => diego
rédac => redac
réfléchir => reflecteren
mexique => mexico
seulement => alleen
sophie => sophie
chinoise => Chinees
écrire => schrijven
bas => bas
étudier => studeren
cortès => cortes
triste => triest
parler => dialect
vit => vit
goban => goban
mexicain => Mexicaans
mascotte => mascotte
passion => passie
récréation => recreatie
me => me
avril => april
coréens => Koreaanse
veux => willen
travailler => arbeiden
skype => skype
footballeur => voetballer
permis => permissie
coréen => Koreaans
mieux => liever
octobre => oktober
luciano => luciano
greuil => greuil
origine => begin
correspondance => correspondentie
encercler => omcirkelen
corée => korea
télévision => televisie
go => go
suite => suite
académie => academie
culture => cultuur
passe => pas
séoul => seoel
kiba => kiba
tactiques => tactiek
interne => intern
aide => aide
ami => amice
contacte => contact
armando => armando
bois => bos
tennis => tennis
communication => communicatie
plateau => plateau
territoires => territoria
devenir => gebeuren
partager => verdelen
publier => publiceren
fabrice => fabrice
choquants => schokkend
p => p
planète => planeet
questions => kwesties
communiquer => communiceren
avance => avances
écoute => schoot
snapchat => snapchat
mattatia => mattatia
vidéo => video
photos => foto's
junior => junior
interviewé => geïnterviewd
journalistes => journalisten
contrôler => controleren
publiés => gepubliceerd
fantastiques => fantastisch
radcliffe => radcliffe
azkaban => azkaban
magiques => magie
hermione => hermione
espionner => bespieden
stéréotype => stereotype
cumule => cumuleert
k => k
premier => premier
émotions => emoties
première => première
aventures => avonturen
saga => saga
compte => conto
objet => object
dumbledore => dumbledore
objets => objecten
retour => return
matérialise => materialiseert
horcruxe => horcrux
cape => cape
succès => succes
héros => held
nouvelle => novelle
arrive => arriveert
daniel => daniel
infographies => infographics
auteur => auteur
magie => magie
cricket => cricket
sorcellerie => wichelarij
intrigue => intrige
mener => leiden
cet => dat
watson => watson
ron => ron
fantastique => fantastisch
lancer => lanceren
noire => negerin
animal => animal
pratique => praktijk
uniformes => uniformen
date => datum
positives => positief
univers => universum
site => site
victoire => victorie
score => score
lecteurs => readers
rowling => rowling
artefact => artefact
lord => lord
voldemort => voldemort
gallimard => gallimard
weasley => weasley
granger => granger
shopalike => shopalike
grint => grint
offre => offerte
existence => bestaan
patronum => patronum
magique => magisch
albus => albus
attraper => vatten
solide => solide
rupert => rupert
expecto => expecto
totem => totem
règles => regel
scolaire => schools
reliques => relikwieën
vif => vief
harry => harry
tome => tome
tabac => tabak
nicotine => nicotine
million => miljoen
arrêter => arresteren
ministre => minister
mondiale => mondiaal
selon => volgens
paquets => pakketten
choc => schok
gros => groot
médicament => medicijn
sociale => sociaal
parvenir => bereiken
fumer => dampen
morand => morand
euro => euro
personne => persoon
substance => substantie
neutres => neutrale
fumée => walm
paquet => pakje
chance => kans
cigarettes => sigaretten
inciter => ophitsen
dépendant => dependent
dose => dosis
quel => welk
janvier => januari
toxique => toxicum
secondes => seconden
couleur => kleur
neutre => neutraal
habitude => habijt
coûte => kosten
espace => bestek
pastilles => pellets
réduire => reduceren
santé => santé
consommation => consumptie
absorber => absorberen
cigarette => sigaret
acceptable => acceptabel
répétitif => repetitief
envers => jegens
client => klant
expressif => expressief
radio => radio
publiée => gepubliceerd
appréciation => appreciatie
récemment => recentelijk
guillaume => guillaume
tribunal => tribunaal
directe => recht
document => document
devyn => devyn
affaire => affaire
française => Frans
tendance => tendens
servir => bedienen
qualités => kwalificaties
francophones => frans
audition => auditie
agressivité => agressiviteit
sorte => soort
révision => revisie
serveur => kelner
rey => rey
culturelle => cultuur-
canada => canada
mainguy => mainguy
milieu => midden
voir => zien
respect => respect
audience => audiëntie
vulgaire => vulgair
talents => talenten
code => code
performance => performance
professionnelle => professioneel
travail => arbeid
directs => direct
julien => julian
interpréter => interpreteren
industrie => industrie
plainte => klacht
montrer => tonen
agressif => agressief
intégration => integratie
rejeter => afkeuren
déterminer => determineren
restaurateur => restaurateur
dispute => dispuut
restauration => restauratie
collègue => collega
canadien => Canadees
plaidé => pleitte
manque => manco
irrespectueux => respectloos
canadienne => Canadees
qualité => kwaliteit
organisme => organisme
bc => bc
effet => effect
discrimination => discriminatie
retrouver => herstellen
hôtelière => hotel
restaurant => restaurant
collègues => collega's
employé => employé
standards => standaarden
cousineau => cousineau
verbalement => verbaal
perception => perceptie
professionnelles => professioneel
colombie => colombia
fuck => fuck
vancouver => vancouver
attitude => attitude
population => populatie
castes => kasten
haut => hard
bombay => bombay
gujarat => gujarat
jets => jets
bus => bus
axes => as
police => politie
rishi => rishi
kumar => kumar
constitution => constitutie
organisé => georganiseerd
publics => publiek
pradesh => pradesh
bihar => bihar
réaction => reactie
shukla => shukla
passant => passant
rajasthan => rajasthan
inde => india
abusivement => abusievelijk
discriminations => discriminatie
attaques => aanvallen
centre => centrum
dalit => dalit
responsable => responsabel
meerut => meerut
auteurs => auteurs
caste => kaste
démocratisé => gedemocratiseerd
pendjab => punjab
locaux => lokaal
général => generaal
automatique => automatisch
etat => staat
étaient => waren
ouest => westen
district => district
indiens => indiaas
fermier => meier
richesse => rijkdom
organisations => organisaties
uttar => uttar
madhya => madhya
milliard => miljard
nord => noord
symbole => symbool
réalité => realiteit
delhi => delhi
dalits => dalits
médias => media
arrestation => arrestatie
locales => lokaal
ordre => orde
blocages => blokkades
théorie => theorie
absence => absentie
news => nieuws
chiffre => cijfer
inspecter => inspecteren
in => in
contexte => context
gêne => gêne
rebelle => rebels
parallèle => parallel
journaliste => journalist
quarantaine => quarantaine
démontrer => demonstreren
opérations => operaties
évacuer => evacueren
agents => agenten
récente => recent
hypersécrétions => hypersecretie
facture => factuur
cornée => cornea
contrôlent => controle
présent => present
munitions => munitie
chlore => chloor
identifiés => geïdentificeerd
activité => activiteit
fabrication => fabricatie
asphyxie => asfyxie
rendu => rendering
bellingcat => bellingcat
techniques => technisch
cheikhoun => cheikhoun
islam => islam
meurtrière => moordenaar
sol => sol
évacuation => evacuatie
présence => presentie
boulangerie => bakkerij
recherche => research
dément => dement
rapport => rapport
analyses => analyseert
provoquer => provoceren
stratégiquement => strategisch
défense => defensie
globale => globaal
géolocalisation => geolocatie
ong => ong
jaych => jaysh
shuhada => shuhada
environs => omgeving
propre => proper
recours => regres
évoluer => evolueren
sites => websites
organophosphorés => organofosfor
avancé => geavanceerd
scénario => scenario
nationale => nationaal
publiques => publiek
opèrent => opereren
relative => relatief
région => regio
posteriori => posteriori
fondation => fundering
partis => partijen
préparer => prepareren
spécifiquement => specifiek
létal => letaal
smart => Smart
sentry => sentry
brûlures => brandwonden
services => diensten
public => publiek
network => netwerk
légitimer => legitimeren
syrienne => syrisch
décrivant => beschrijven
populations => populaties
publié => gepubliceerd
ultime => ultiem
panique => paniek
opposition => oppositie
conclure => concluderen
américain => Amerikaans
documentation => documentatie
rendue => gerenderd
inspecteurs => inspecteurs
égide => aegis
inutile => nutteloos
stratégique => strategisch
engager => aanmanen
madjid => madjid
salafistes => salafisten
mécanique => mechanica
gouvernementales => overheid
définitive => definitief
terme => term
nasales => nasaal
régime => regime
caractéristique => karakteristiek
impliquent => impliceren
fabriqués => gefabriceerd
type => type
composé => composiet
enclave => enclave
caps => caps
situation => situatie
bachar => bachar
rebelles => rebellen
informations => informatie
capitulation => capitulatie
filmées => gefilmd
produit => product
nature => natuur
assad => assad
zerrouky => zerrouky
action => actie
syria => syrië
franco => franco
alerte => alarm
base => basis
quelle => dewelke
terreur => terreur
cylindres => cilinder
problèmes => problemen
urbain => urbaan
agence => agency
coup => houw
cbs => cbs
laboratoires => laboratoria
jazira => jazeera
interroger => ondervragen
analysés => geanalyseerd
accusation => accusatie
gaz => gas
exposition => expositie
tactique => tactiek
répétition => repetitie
évaluation => evaluatie
préciser => specificeren
lepick => lepick
appareils => apparatuur
militaire => militair
collectif => collectief
ghouta => ghouta
poches => pockets
agent => agent
tactiquement => tactisch
chercheur => verkenner
installations => installatie
attaque => attaque
létales => dodelijk
bombardement => bombardement
stade => stadion
damas => damast
intérieur => intern
syrien => Syrisch
quête => queeste
tourner => wenden
sentiment => sentiment
mille => mijl
examen => examen
accalmie => kalmte
sens => verstand
salafiste => salafistische
symptômes => symptomen
train => trein
réduction => reductie
annonce => annonce
respirer => respireren
analyse => analyse
finir => eindigen
intense => intens
confirmer => vormen
appareil => apparaat
sources => broncode
douma => doema
kilomètres => kilometer
raid => raid
stratégie => strategie
plan => plan
corps => corps
décompte => deceptie
odeur => geur
gouvernement => gouvernement
hélicoptères => helicopters
radar => radar
neuf => nieuw
olivier => olijf
syrie => syrië
chaos => chaos
doumayr => doumayr
rights => rechten
offensive => offensief
sarin => Sarin
indice => index
correspondants => correspondenten
sin => sin
nom => naam
sana => sana
khan => kan
cyanoses => cyanosis
attesté => geattesteerd
scène => scène
associé => geassocieerd
chronologie => chronologie
total => totaal
coût => kost
ambitieux => ambitieus
strasbourg => straatsburg
historiques => historisch
françois => françois
concerts => concerten
mètres => meter
présidence => presidentschap
classement => klassement
parlement => parlement
classés => geklasseerd
hall => hal
architecte => architect
publique => publiek
institut => instituut
palais => paleis
final => finaal
norme => norm
phase => fase
rénover => renoveren
architecture => architectuur
audiovisuel => audiovisueel
culturelles => cultuur-
époque => epoche
camembert => camembert
gaulle => gaulle
programme => programma
stahly => stahly
jean => jeans
adaptation => adaptatie
arabe => arabisch
décor => decor
inscription => inschrijving
singularité => singulariteit
ouverture => ouverture
galerie => galerij
bar => bar
continuité => continuïteit
projet => project
seine => sleepnet
ronde => ronde
bernard => bernard
œuvres => oeuvre
bureau => bureau
sibyle => sibyle
conception => conceptie
bord => boord
studio => studio
forme => fysiek
henry => henry
acoustique => akoestisch
ministère => ministerie
salons => salons
cabinet => toilet
séquence => sequens
publiées => gepubliceerd
consultation => consult
sébastien => sebastian
aura => aura
abonnement => abonnement
précis => precies
elisabeth => elisabeth
billets => biljetten
réunion => reünie
borne => gebonden
vicherat => vicherat
émission => emissie
veulent => willen
raviver => herleven
secrétaire => secretaris
alternatifs => alternatief
normal => normaal
flamme => vlam
mobilisation => mobilisatie
discussion => discussie
thalys => thalys
élisabeth => elisabeth
seules => alleen
ter => ter
tarifaires => tarief
perturbé => verstoord
valérie => valerie
assemblée => assemblee
quasi => quasi
eurostar => eurostar
prématuré => prematuur
sncf => sncf
qualifier => kwalificeren
circuleront => circuleren
référendum => referendum
unsa => unsa
modes => modes
frapper => kloppen
b => b
adjoint => adjunct
transport => transport
reconquérir => heroveren
trouver => aantreffen
sénat => senaat
transilien => transilien
réforme => reform
principes => principes
commission => commissie
cartes => kaartspel
circuler => circuleren
trains => treinen
mariani => mariani
cfdt => cfdt
circulation => circulatie
invitation => invitatie
tgv => tgv
compléter => completeren
commerciale => commercieel
porté => poort
mobilisés => gemobiliseerd
rer => rer
rencontre => reünie
cgt => cgt
présidente => president
intercités => interlokaal
pacte => pact
directeur => directeur
mathias => mathias
trajectoire => traject
rail => rail
pécresse => pécresse
sanctions => sancties
européenne => Europees
croisés => gekruiste
chtchetinine => chtchetinine
part => Part
rajoy => rajoy
pékin => pekin
farce => farce
brésil => brazilië
fut => vat
précédent => precedent
respecter => respecteren
centrale => centrale
respecté => gerespecteerde
boycott => boycot
présidentielle => presidents-
vénézuélien => venezolaans
numéro => nummer
transaction => transactie
capacité => capaciteit
totalité => totaliteit
élection => electie
uniennes => uniennes
résultat => resultaat
interfax => interfax
maduro => maduro
populaire => populair
espagne => spanje
lima => lima
partenaires => partners
démocratie => democratie
internationaux => internationale
kang => kang
pompeo => pompeo
alexandre => alexander
soutenir => steunen
vénézuélienne => venezolaans
misère => misère
venezuela => venezuela
cuba => cuba
européens => europese
caractère => karakter
hormis => hormis
caracas => caracas
démocratiques => democratisch
nicolas => nicolas
latino => latijn
concurrent => concurrent
liste => lijst
élémentaires => elementair
amérique => amerika
résolution => resolutie
loukachenko => loekasjenko
processus => proces
bras => bras
vénézuéliens => venezolaans
pence => penny
soutien => steun
relations => relaties
planer => glijden
économiques => economisch
actifs => activa
latine => latijn
décret => decreet
niveau => niveau
embargo => embargo
position => positie
union => union
chine => china
kremlin => kremlin
proclamé => geproclameerd
applaudi => applaus
candidats => kandidaten
brut => ruw
série => serie
mike => mike
félicitations => felicitatie
cabello => cabello
diosdado => diosdado
concurrents => concurrenten
légitimité => legitimiteit
diplomatiques => diplomatisch
autoritaire => autoritair
salvador => el salvador
mariano => mariano
politiquement => politiek
moutchou => moutchou
amendements => amendementen
emmanuel => emmanuel
luc => luc
insoumise => insoumise
législatif => legislatief
information => informatie
socialiste => socialist
moteurs => motoren
chef => chef
saulignac => saulignac
rémunération => Remuneration
socrate => socrates
elsa => elsa
grip => greep
déstabilisation => destabilisering
nyssen => nyssen
obligations => obligaties
virale => virale
définition => definitie
république => republiek
macron => macron
hervé => hervé
séance => seance
naïma => naïma
fausse => fout
adoption => adoptie
plateformes => platforms
viral => viraal
souligner => beklemtonen
constance => constantheid
intervenir => interveniëren
françoise => francoise
arsenal => arsenaal
organique => organisch
parti => partij
communiste => communist
file => file
judiciariser => judicialize
ordinaire => ordinair
juillet => juli
diffusion => diffusie
républicains => republikeinen
pavé => plavuis
juin => juni
décrète => decreten
etc => enz
candidat => kandidaat
platon => plato
mélenchon => mélenchon
reçu => reçu
vers => vers
crs => crs
u => u
individu => individu
carcassonne => carcassonne
footing => jogging
enquête => enquête
trèbes => trèbes
hôpital => hospitaal
super => super
interdit => interdict
blessé => geblesseerd
préfecture => prefectuur
ouvert => geopend
aude => aude
supermarché => supermarkt
répliquer => repliek
dominants => dominant
expérimentent => experimenteren
national => nationaal
satellites => satellieten
rogers => rogers
hyten => hyten
alliance => alliantie
local => lokaal
gps => gps
pose => pose
air => air
us => us
ultra => ultra
cyberattaques => cyberaanvallen
distribution => distributie
mission => missie
infrastructures => infrastructuur
salisbury => salisbury
cyberespace => cyberspace
supériorité => superioriteit
stratcom => stratcom
nucléaires => nucleair
ioulia => ioulia
commandement => commando
malveillant => kwaadwillig
investissements => investeringen
irak => irak
surveiller => surveilleren
autorité => autoriteit
agression => agressie
tenter => trachten
sujet => subject
innervant => innerverende
technophiles => techies
séminaire => seminarie
article => artikel
curtis => curtis
sergueï => sergei
afghanistan => afghanistan
domine => domineert
hyperconnectée => hyperconnectée
volent => vliegen
propagande => propaganda
paralyser => paralyseren
problème => probleem
attribue => attributen
commandant => commandant
renchéri => renchéri
édition => editie
militaires => militair
déstabilisatrices => destabiliserende
spécifiques => specifiek
résistants => resistant
notpetya => notpetya
disposer => disponeren
heather => heide
gazette => Gazette
amiral => admiraal
allié => geallieerd
budget => budget
hackage => hackage
atlantique => Atlantisch
associe => associates
michael => michaël
manuel => handboek
implication => implicatie
soldats => soldaten
scaparrotti => scaparrotti
traité => traktaat
skripal => skripal
systèmes => systemen
genre => genre
déstabiliser => destabiliseren
limite => limiet
disputer => disputeren
asymétrique => asymmetrisch
pentagone => pentagoon
événement => evenement
thévenoud => thévenoud
champions => kampioenen
filles => meisjes
record => record
excuses => excuseer
remettre => terugzetten
coûter => kosten
marque => merk
jechange => jechange
déclarent => verklaren
paradoxal => paradoxaal
info => info
ballonad => ballonad
minima => minimum
dépasser => passeren
enchaîné => geketend
tarder => talmen
rapporte => rapporten
influence => invloed
diplômé => gediplomeerd
thomas => thomas
technologies => technologie
ier => ier
ouvrage => werk
rolland => rolland
opinionway => opinionway
imaginaire => imaginair
po => po
assister => assisteren
ancien => antiek
cocasse => komisch
réelle => reëel
diane => diana
vacances => vakantie
étude => studie
administrative => administratief
retard => achterstand
stress => stress
tâches => taken
cantine => kantine
fréquemment => frequent
eyrolles => eyrolles
administratives => administratief
phrase => frase
méditer => mediteren
éditions => edities
canard => canard
philosophe => filosoof
voient => zien
phobie => fobie
ménage => menage
duval => duval
procrastinateurs => procrastinators
sportives => sport-
smartphone => smartphone
machinalement => machinaal
procrastination => procrastinatie
procrastinateur => procrastinator
naturellement => natuurlijk
digitaux => digitaal
gaël => gael
star => ster
pénaliser => penaliseren
phénomène => fenomeen
adminstrative => adminstrative
bricolage => Bricolage
urgence => urgentie
efficace => efficiënt
appellation => appellatie
pesticides => pesticiden
gizard => gizard
septembre => september
utiliser => uitmelken
insectes => insecten
chinois => Chinees
cultures => culturen
néonicotinoïdes => neonicotinoïden
tonnes => tons
dakota => Dakota
insecticides => insecticiden
disparu => verdwenen
yves => yves
quelles => welk
pousser => duwen
gabriel => gabriel
plutôt => liefst
anglaise => Engels
havez => havez
organisés => georganiseerd
krempf => krempf
creil => creil
spécialistes => specialisten
facilement => lichtelijk
poser => poseren
antoine => antoine
garde => bewaarder
piste => piste
arrondissement => arrondissement
appartement => appartement
découverte => discovery
criminelle => crimineel
domicile => domicilie
officiel => officieel
écarter => scheiden
orienter => oriënteren
hypothèse => hypothese
exactes => exact
mobile => mobiel
meurtre => moorden
inconnu => ongekend
portés => versleten
policiers => politie
organe => orgaan
antisémitisme => antisemitisme
brûler => branden
dpj => dpj
communauté => community
vigilance => vigiliteit
fsju => fsju
crif => crif
consistoire => consistorie
service => servies
antisémite => antisemiet
xie => xie
bnvca => bnvca
spcj => spcj
parquet => parket
mode => mode
analysent => analyseren
sortir => verlaten
socratique => socratische
avancer => avanceren
thérapie => therapie
normative => normatief
éduquer => onderwijzen
aimer => beminnen
match => match
caricature => karikatuur
psychothérapie => psychotherapie
gloubi => gloubi
émotion => emotie
carte => kaart
penser => denken
boulga => boulga
phile => phile
maldonne => maldonne
tranquillisants => tranquillizers
définissent => definiëren
pur => puur
malaise => malaise
patient => patiënt
pédagogie => pedagogie
hygiéniste => hygiënist
dérive => drift
commentent => commentaar
jacob => jakob
couples => koppels
essence => essentie
refuser => afkeuren
intérêt => interest
faute => fout
existentiel => existentiële
passive => passief
tranquillisant => tranquillizer
discipline => discipline
psychothérapeutique => psychotherapeutische
situations => situatie
paniqués => paniek
prescrire => voorschrijven
autonomie => autonomie
directivité => directiviteit
complexe => complex
hyper => hyper
stratégies => strategieën
montessori => montessori
demande => gevraagde
frustration => frustratie
oger => oger
caresser => aaien
croire => honoreren
profession => professie
dénature => denatureert
divan => Divan
psychologue => psycholoog
armelle => armelle
projets => projecten
séances => sessies
psychothérapeute => psychotherapeut
sentir => betasten
spécialités => specialiteiten
belle => bevallig
pleux => pleux
assumer => aannemen
didier => didier
maria => maria
odile => odile
accompagnement => accompagnement
coaching => coaching
thérapies => therapieën
artilleur => artillerist
publie => publiceert
émotionnel => emotioneel
thésis => thesis
métier => stiel
manient => handvat
plaisir => plezier
amener => brengen
psychiatres => psychiaters
applis => apps
arbitrage => arbitrage
rôle => rol
conduire => voeren
suisse => Zwitsers
chauffeur => chauffeur
salon => salon
circulent => circuleren
pollution => pollutie
voler => zeilen
science => kennis
diriger => dirigeren
litres => liter
genève => genève
garer => parkeren
jullien => jullien
automobile => automobiel
électricité => elektriciteit
gazole => gasolie
rouler => rollen
futur => futurum
diminuer => verminderen
présidents => presidents
élite => elite
universitaire => universitair
couvre => covers
journalisme => journalistiek
offrir => offeren
ecoles => scholen
conférences => conferenties
revendiquer => verdedigen
doctorale => doctoraal
géographique => geografisch
iep => iep
fort => fort
mélanger => mengen
création => creatie
ensam => ensam
concours => concours
exclusivement => exclusief
statut => statuut
approche => aantocht
normales => normaal
pôle => pool
sociales => sociaal
saint => sint
adopté => geadopteerd
internationales => internationaal
sélectivité => selectiviteit
critères => criteria
sélective => selectief
profils => profielen
figurant => figurant
nationaux => nationaal
établissement => etablissement
polytechnique => polytechnische
frédéric => frederick
mion => mion
insertion => insertie
instituts => instituties
frein => afremmen
perspective => perspectief
subtilité => subtiliteit
former => vormen
universités => universiteiten
urbanisme => urbanisme
dauphine => dauphin
contribuer => contribueren
études => studie
croiser => kruisen
excellence => excellentie
spécialisations => specialisaties
cycles => cycli
supérieur => superieur
fondamentales => fundamenteel
recrute => rekruten
cycle => cyclus
conservatoire => conservatorium
innovation => innovatie
maxime => Maxime
diversité => diversiteit
soazig => soazig
formation => vorming
minimale => minimaal
management => management
fondamentalement => fundamenteel
nevé => neve
marqueur => markering
fronts => fronten
marquer => aanduiden
jacques => jacques
film => film
transformation => transformatie
berd => ebrd
longs => lang
tour => toren
inhabituel => ongebruikelijk
directrice => directeur
manifester => manifesteren
renson => renson
réformisme => Reformisme
edouard => edward
lrem => lrem
bloqué => geblokkeerd
reconnu => herkend
km => km
zadistes => zadistes
campagnes => campagnes
mémorisation => memorisatie
commenté => commentaar
jaurès => jaurès
essentielle => essentieel
interpeller => interpelleren
entretiens => interviews
csg => csg
edwy => edwy
philippe => filips
réparer => repareren
populaires => populair
séniors => senior
immigration => immigratie
hier => gisteren
regagner => herwinnen
aube => albe
pernaut => pernaut
filtrés => gefilterd
jt => jt
françaises => frans
bourdin => bourdin
extrême => extreem
inter => inter
interview => interview
bfmtv => bfmtv
opinion => opinie
plenel => plenel
feuilleton => feuilleton
atypique => atypisch
complexité => complexiteit
rmc => rmc
limitation => limitatie
hollande => holland
morin => morin
vosges => vogezen
décembre => december
facs => facs
curieux => curieus
dame => dame
intention => intentie
pen => pen
apaiser => pacificeren
asile => asiel
entretien => interview
chloé => chloe
mediapart => mediapart
marine => marine
donner => aangeven
retraité => rustend
adresser => adresseren
elabe => elabe
rumeur => rumoer
campagne => campagne
protectionnisme => protectionisme
repousser => wegduwen
alliés => Geallieerden
servirait => serveren
australie => australië
cio => cio
visite => visite
lighthizer => lighthizer
actes => acties
sénateur => senator
brunei => brunei
mondial => mondiaal
désindustrialisés => deindustrialised
ouvriers => arbeiders
renaître => reïncarneren
arnaud => arnaud
chili => chili
potentiels => potentieel
richard => richard
enregistrés => geregistreerd
george => george
bush => bush
travailleurs => arbeiders
obama => obama
omc => wto
agriculture => agricultuur
ratifié => geratificeerd
rust => roest
particuliers => particulieren
leparmentier => leparmentier
forum => forum
zélande => zeeland
isolement => isolement
résumé => resumé
promesse => promesse
kudlow => kudlow
complètement => volkomen
suppression => suppressie
sabre => sabel
sénateurs => senatoren
canadiens => canadees
davos => davos
option => optie
belt => belt
vis => vijs
bilatérales => bilaterale
trumka => trumka
nul => nul
hillary => hillary
malaisie => maleisië
manière => manier
syndicat => syndicaat
candidate => kandidaat
intérêts => interesse
régionaux => regionaal
turnbull => turnbull
bleus => blauw
multilatérales => multilateraal
larry => larry
lettre => letter
immédiatement => onmiddellijk
coalition => coalitie
introduisait => introduceerde
provisoire => provisoir
malcolm => malcolm
critique => kritiek
conseiller => consulent
ouvrir => openen
arizona => arizona
w => w
nebraska => nebraska
clinton => clinton
clauses => clausules
compliquées => gecompliceerd
mexicains => mexicaans
tpp => tpp
tentation => temptatie
revivre => herleven
australien => Australisch
furieux => furieus
incarnait => incarneerde
alena => alena
barack => barack
jeff => jeff
démocrate => democraat
condition => conditie
sasse => sasse
singapour => singapore
commerciales => commercieel
négocier => negotiëren
midwest => midwesten
ceinture => ceintuur
pratiques => praktijken
afl => afl
japon => japan
rouille => Rouille
exportateurs => exporteurs
pérou => peru
examiner => examineren
républicain => republikein
surprise => surprise
hmeimim => hmeimim
baltique => baltisch
furent => waren
romains => romeins
assuré => assertief
hussein => hussein
traduire => translateren
urss => ussr
perses => perzisch
venant => van
garantir => garanderen
crimée => krim
lee => lee
installation => installatie
garantit => garanties
suez => suez
egyptiens => egyptenaren
grecs => grieks
démographique => demografisch
vladivostok => vladivostok
obsession => obsessie
vénitiens => venetiaanse
détroit => straat
clé => clé
esprit => spiritus
pôles => polen
méditerranéenne => mediterraan
afrique => afrika
ethiopie => ethiopië
tunisie => tunesië
votre => jouwe
garantie => garantie
visionnaire => visionair
énigmatique => enigmatisch
ère => era
flotte => vloot
tartous => tartous
canal => kanaal
géopolitique => geopolitiek
alaouite => alawieten
mère => mam
dynastie => dynastie
bosphore => bosporus
egypte => egypte
saddam => saddam
attali => attali
com => com
erreur => blunder
construction => constructie
concert => concert
libanaise => libanees
maroc => marokko
carthaginois => Carthaags
bateaux => boten
histoire => historie
ottomans => osmaans
kwan => kwan
golfe => golf
métaphore => metafoor
rage => rabies
traduction => translaat
conflits => conflicten
quart => kwart
asselot => asselot
enregistré => geregistreerd
reporter => transporteren
céline => celine
stressant => stressvolle
vérifier => verifiëren
enregistrement => registratie
estelle => estelle
aphatie => aphatie
oise => oise
actualité => actualiteit
transformée => getransformeerd
discussions => discussies
jingle => rinkelen
partenaire => partner
souhayla => souhayla
thèmes => thema's
faure => faure
yasmine => yasmine
michel => michaël
média => media
spéciales => speciaal
cool => cool
tables => tafels
exceptionnel => exceptioneel
berlin => berlijn
relancer => herleven
consensus => consensus
traiter => aanpakken
convergence => convergentie
crises => crises
refonder => hervonden
harmonisation => harmonisatie
quotas => quota
accorder => schenken
tente => tent
financer => financieren
laisser => laten
catégoriquement => categorisch
mobiliser => mobiliseren
pologne => polen
externe => extern
italie => italië
solidarité => solidariteit
dublin => dublin
débloquer => deblokkeren
résumer => resumeren
européennes => europese
financement => financiering
incluant => inclusief
investissement => investering
dispositif => dispositif
termes => termen
adopterait => adopteren
hongrie => hongarije
ambition => ambitie
rwsverkeersinfo => rwsverkeersinfo
klm => klm
verhol => verhol
beide => beide
passagers => passagiers
cependant => desondanks
panne => panne
résorber => absorberen
zijn => zijn
verkeersinformatie => verkeersinformatie
opérationnels => operationele
rijkswaterstaat => rijkswaterstaat
bloquée => geblokkeerd
vrij => vrij
néerlandaise => nederlands
schiphol => schiphol
importante => important
décourager => ontraden
afritten => afritten
amsterdam => amsterdam
affecté => geaffecteerd
https => https
incoming => inkomend
outbound => outbound
gegeven => gegeven
kanten => kanten
update => -update
reduced => gereduceerd
qnhtbthgfe => qnhtbthgfe
van => Wan
will => wil
op => op
flux => flux
is => is
gedeeltelijk => gedeeltelijk
compagnie => compagnie
aan => aan
co => co
ha => ha
rédaction => redactie
lucas => lucas
atp => atp
reculer => aanhouden
progressions => progressies
rafael => rafael
budapest => boedapest
tsitsipas => tsitsipas
nadal => nadal
millman => millman
dominé => gedomineerd
marco => marco
tenant => aanhanger
cecchinato => cecchinato
opération => operatie
pouille => pouille
rome => rome
inchangé => onveranderd
mauvaise => kwaad
publication => publicatie
top => Top
stefanos => stefanos
finaliste => finalist
robot => robot
martien => marsbewoner
décode => decodeert
nasa => nasa
schéma => schema
caltech => caltech
alignement => aligneren
photo => foto
monter => monteren
décoder => decoderen
oublie => oublie
planètes => planeten
clique => kliek
simule => simuleert
secret => discreet
rouge => rode
jpl => jpl
capable => capabel
attention => attentie
bruno => bruno
soussirat => soussirat
suspension => suspensie
castelsarrasin => castelsarrasin
discret => discreet
blanquer => blanquer
sanction => sanctie
milan => milaan
tarn => tarn
éducation => educatie
dispenser => verdelen
aya => aya
manon => manon
sms => sms
téléphones => telefoons
règle => regel
bilan => balans
vincent => vincent
positif => positief
idéal => ideaal
portables => portable
coralie => coralie
garonne => garonne
cpe => cpe
prades => prades
privé => privé
permanent => permanent
récentes => recent
autrice => auteur
alarme => alarm
organisateurs => organisatoren
principe => principe
organiser => organiseren
mobilisées => gemobiliseerd
créent => creëren
initiative => initiatief
lancent => lancering
financier => financieel
smic => smic
incipit => Incipit
payetonauteur => payetonauteur
littérature => literatuur
jeunesse => jeugd
exception => exceptie
sellers => selling
sonnette => belletje
assurance => assurantie
congé => congé
assurer => assureren
mécanismes => mechanismen
compensatoires => compenserende
bailly => bailly
cri => cri
fluctuants => fluctuerende
best => best
halte => halte
créativité => creativiteit
pourcentage => procent
éditeurs => uitgevers
charte => handvest
professionnels => professioneel
auteursencolère => auteursencolère
administratif => administratief
présenter => presenteren
rénovation => renovatie
spécificités => specificiteiten
écrivains => schrijvers
assimilés => geassimileerd
écrivent => schrijven
effectivement => effectief
illustrateurs => illustratoren
contactés => gecontacteerd
retraite => retraite
inclus => inclusief
samantha => samantha
plier => plooien
guise => guise
contacts => contacten
hooligans => hooligans
susceptible => susceptibel
fans => fans
marseille => marseille
diplomates => diplomaten
racisme => racisme
terroristes => terroristen
alarmés => gealarmeerd
fournir => voorzien
compétition => competitie
tugendhat => tugendhat
croisées => kruis
tom => tom
risques => risico's
antibritannique => anti-britse
espion => spion
homophobie => Homofobie
court => kort
londres => londen
pic => specht
modifiée => gemodificeerde
cnil => cnil
identité => identiteit
photocopie => fotokopie
fichier => file
postales => post
bayard => bayard
tsa => tsa
inscris => inschrijven
groupebayard => groupebayard
auquel => aan wie
adresse => adres
cedex => cedex
informatique => informatica
sort => lot
mail => e-mail