solo => solo
alla => finally
rispettiva => respective
ottimizzi => optimize
prezzi => prices
istruzione => instruction
queste => these
mattina => morning
polo => pole
democratico => democratic
valori => valuables
classe => class
circolata => circulated
l => l
conservatori => conservative
anno => an
e => e
fatto => fact
spesa => expense
uguale => equal
ai => ai
nonna => nana
segno => sign
comunicare => communicate
recente => recent
ambiente => ambiance
ne => any
princìpi => principles
eccezioni => exceptions
spazio => space
primario => prime
questo => those
sono => are
in => in
parte => part
divise => divided
miei => mine
pantaloni => pantaloon
medaglia => medal
per => for
pressione => pressure
bravo => bravo
anche => and
unito => united
mi => me
non => not
italiano => Italian
o => o
avere => have
carattere => character
scuole => schools
ha => have
tutti => tutti
riporta => reports
quando => than
particolare => particular
a => a
jeans => jeans
una => one
scoperto => uncovered
novara => novara
aspetto => aspect
dinamiche => dynamics
vita => life
promuovere => promote
distribuito => distributed
regno => reign
le => it
italia => italy
un => an
servissero => serve
tratta => draft
sociale => social
bene => fine
si => yes
serie => series
epoca => epoch
politici => politicians
pratica => practice
tempo => tempo
certa => certain
guardaroba => wardrobe
egualitario => egalitarian
certe => certain
istituto => institute
faccia => face
ritorno => return
private => private
la => la
medie => medium
scuola => school
marca => march
ricordo => reminder
durante => during
fila => file
barbara => barbara
still => still
photo => photo
distrazioni => distractions
invece => instead
lunga => long
usa => usa
scatenare => activate
due => deuce
was => was
lista => list
assente => absent
adam => adam
two => two
add => add
scrive => writes
twittato => tweeted
no => no
knowing => knowing
has => has
chat => chat
someone => someone
smiles => smiles
done => done
funeral => funeral
irriterà => irritate
preferito => preferred
dubbio => dubious
make => make
barack => barack
com => com
taken => taken
lol => lol
hamilton => hamilton
funerale => funeral
kindness => kindness
grappolo => grape
trova => trova
decisamente => decidedly
raro => rare
t => t
st => st
sarcastici => sarcastic
bush => bush
mantenere => maintain
lady => lady
long => long
on => on
s => s
concentrati => concentrates
things => things
do => do
first => first
social => social
presenti => present
contrario => contrary
not => not
during => during
evitare => evade
americano => American
conversazione => conversation
respect => respect
americane => american
trump => trump
realdonaldtrump => realdonaldtrump
quiet => quiet
nella => inside
gentleman => gentleman
riproduzione => reproduction
martin => martin
photos => photos
time => time
ti => to
with => with
yeah => yeah
sapere => realize
can => can
quale => equally
this => this
formale => formal
domanda => demand
ampio => ample
diplomat => diplomat
texas => texas
cracked => cracked
which => which
cinque => cinque
what => what
list => list
sicurezza => security
tweet => tweet
who => who
misslaneym => misslaneym
realizzato => realised
dispositivo => dispositif
tatto => tact
occasione => occasion
people => people
istituzioni => institutions
virale => viral
annunciato => announced
uscita => escape
these => these
you => you
donald => donald
ricostruire => reconstruct
aprile => April
fa => fa
esponenti => exponents
breve => brief
michelle => michelle
rispetto => respect
re => ray
adamcbest => adamcbest
and => and
to => to
yippeekimyay => yippeekimyay
way => way
laney => laney
questa => these
smile => smiley
volumes => volumes
questi => these
everything => everything
would => would
famiglia => family
of => of
sabato => sabbath
tiedrich => tiedrich
best => best
presentarsi => present
five => five
ancora => anchor
confessa => confesses
ex => ex
obama => obama
al => an
confronto => confrontation
kimexander => kimexander
pop => pop
fare => make
nemmeno => even
jefftiedrich => jefftiedrich
chi => chi
eleganza => elegance
warm => warm
celebrazione => celebration
treats => treats
from => from
valanga => avalanche
leader => leader
c => c
jeff => jeff
him => him
twitter => twitter
gentiluomo => gentleman
half => half
houston => houston
stato => state
persone => people
detesterà => detest
find => find
melania => melania
one => one
presidente => president
pic => pic
motivo => motif
cesca => cesca
modo => mode
elegante => elegant
romanticismo => romanticism
contrasti => contrasts
real => real
causa => cause
evento => event
grace => grace
speaks => speaks
network => network
follow => follow
after => after
chiesa => church
provato => proven
all => all
pubbliche => public
bob => bob
era => era
far => face
that => that
hate => hate
attuale => actual
quiz => quiz
upsets => upsets
moglieseduto => moglieseduto
know => know
at => at
utilizzato => utilized
years => years
president => president
formare => form
isolamento => isolation
imminente => imminent
neuronali => neuronal
mentre => meantime
depressione => depression
autore => author
messaggi => messages
livelli => levels
francisco => francisco
dolore => dolor
smartphone => smartphone
interpretato => interpreted
ansia => anguish
acquisiscono => acquire
primo => prime
pericolo => peril
università => university
sondaggio => sounding
predatore => predator
vibrazioni => vibration
studio => study
semi => seeds
continuamente => continuously
proteggevano => protected
simile => similar
cervello => cerebellum
push => push
connessi => connected
pubblicato => published
oppiacei => opiates
mail => e-mail
spiega => explains
tasking => tasking
attacco => attack
uso => use
neurologiche => neurologic
condotto => conduit
comunicazione => communication
neuroregulation => neuroregulation
incapaci => incapable
connessioni => connections
alleviare => relieve
linguaggio => language
meccanismi => mechanisms
informazioni => information
professore => professor
peper => peper
interazione => interaction
studenti => students
risultato => result
informati => informed
educazione => education
sentire => sense
condizione => condition
sempre => evermore
oppioidi => opioids
corpo => corpse
senso => sense
dipendenza => dependence
abuso => abuse
verso => verse
ignorare => ignore
post => post
san => san
proprio => proper
qualifiche => qualifications
totale => total
pesca => peach
seghezzi => seghezzi
avanzata => advance
europa => europe
costituito => constituted
genere => genus
contratti => contracts
caso => case
gruppo => group
termine => term
diffusione => diffusion
futuro => future
mercato => market
statistica => statistics
licenza => license
qualità => quality
niente => none
agenzia => agency
distanza => distance
ricorso => recourse
media => media
maniera => manner
livello => level
prevale => prevails
massima => maxim
ultimo => ultimate
over => over
rari => rare
punti => points
quanti => quanta
sesso => sex
commercio => commerce
prospettive => perspectives
campo => camp
significativo => significant
fondazione => foundation
idea => idea
circa => circa
dimensione => dimension
emersione => emersion
francesco => francis
cosa => case
vari => various
lavoro => labour
nucleo => nucleus
infatti => indeed
occupazione => occupation
turismo => tourism
adapt => adapt
condizioni => condition
capire => realize
principale => principal
soltanto => solely
programmare => program
sanità => sanity
reddito => revenue
crescita => rise
minore => minor
agricoltura => agriculture
secondo => second
sta => is
segnale => signal
distacco => distance
dati => data
contratto => contract
esclusiva => exclusive
minimo => minimum
presenza => presence
europea => European
economico => economic
produttive => productive
corso => course
settori => sectors
polarizzando => polarizing
base => base
economiche => economic
coinvolge => it involves
maggiore => major
poveri => poor
fino => fine
titolo => title
durata => duration
riservata => reserved
coinvolgono => involving
generale => general
terzo => tierce
inferiore => inferior
comune => common
importanti => important
milioni => millions
dividerli => divide them
analisi => analysis
direttore => director
nero => Negro
vista => view
possibilità => possibility
basso => bass
gruppi => groups
manifattura => manufacture
settore => sector
determinato => determined
farci => make us
esperto => expert
tre => three
tendono => tend
formazione => formation
sovranista => sovereignist
macron => macron
nazionali => national
consecutiva => consecutive
ministro => minister
membro => member
procedura => procedure
party => party
nome => name
ragioni => reasons
polonia => poland
controllo => control
parlamento => parliament
merkel => merkel
seehofer => seehofer
conciliazione => conciliation
sovranazionale => supranational
entrare => enter
complotti => plots
cruciali => crucial
pena => penalty
nazionale => national
claude => claude
politico => politician
jean => jean
esistenza => existence
opporsi => oppose
adottato => adopted
modello => model
rientrare => re-enter
malta => mortar
sistema => system
minaccia => menace
riflette => reflects
protetto => protégé
corte => court
austriaco => Austrian
europee => european
garantire => guarantee
disintegrazione => disintegration
interno => internal
legalmente => legally
sin => sin
territoriale => territorial
reformists => reformists
specifiche => specific
destra => dexter
scarse => scarce
reagito => reacted
sentenza => sentence
spitzenkandidaten => spitzenkandidaten
attrazione => attraction
bavaresi => bavarian
implosione => implosion
politica => politics
giudiziario => judicial
abitanti => inhabitants
persistenza => persistence
alliance => alliance
spregiudicato => unprejudiced
probabile => probable
pis => pis
flussi => flows
preminenza => eminence
freedom => freedom
rifugiati => refugees
difendere => defend
dicembre => december
condotta => conduct
significato => significance
popolare => popular
europei => europeans
drasticamente => drastically
carica => charge
organizzazione => organization
european => european
consideri => consider
alkotmánybírósága => alkotmánybírósága
ricetta => receipt
vittoria => victory
popolazione => population
riunione => reunion
partiti => parties
sovranità => sovereignty
testa => testa
enf => enf
fpö => fpö
democratici => democrats
desiderato => desideratum
autoritarismo => authoritarianism
capacità => capacity
interpretata => interpreted
nazionalisti => nationalists
ungherese => Hungarian
influenza => influence
incontenibili => uncontainable
sovranismo => sovereignism
partei => partei
siriane => syrian
migratori => migratory
lega => league
conclusione => conclusion
costituzionale => constitutional
ue => ue
terza => terce
europeo => European
qualificata => qualified
combina => combines
virtù => virtue
isolare => isolate
consenso => consensus
seggi => seats
elezioni => election
sovraniste => sovraniste
consistita => consisted
debolezza => debility
elettorale => electoral
islamiche => islamic
horst => horst
tradizionalmente => traditionally
destinato => destined
scegliere => select
dopo => soon
nullificare => nullify
componenti => components
decisione => decision
partito => party
conservatives => conservatives
basi => base
tant => tant
autorità => authority
fidesz => fidesz
rilocazione => relocation
dio => dio
sociali => social
leadership => leadership
nations => nations
finanzieri => financiers
magyarország => magyarország
innovativa => innovative
recuperare => recover
integrazione => integration
maggioranza => majority
libertà => liberty
carta => card
commissione => commission
risorse => resources
logica => logic
unico => unique
effetto => effect
europe => europe
conseguenza => consequence
affiliazione => affiliation
illiberale => illiberal
unione => union
divisioni => divisions
cristiano => Christian
fronte => front
viktor => viktor
definita => defined
voti => votes
applicare => apply
rafforzato => reinforces
ottenendo => obtaining
punto => point
violazione => violation
esclusivamente => exclusively
entrismo => entryism
persegue => pursues
visione => vision
produrre => produce
interessi => interest
europeiste => europeanist
potere => power
cdu => cdu
immigrazione => immigration
empiriche => empirical
creato => creation
altamente => extremely
componente => component
governo => government
diritto => directly
orban => orban
angela => angela
ufficiali => official
sfera => sphere
invasi => invaded
aggrega => aggregates
unità => unit
freiheitliche => freiheitliche
strategia => strategy
significativa => significant
contro => counter
indipendente => independent
governativo => governmental
secessione => secession
contrasto => contrast
cruciale => crucial
denunciato => denounced
alleata => ally
entrata => entry
sovranisti => sovranisti
infrazione => infraction
rimanendo => remaining
österreichs => österreichs
pensare => ponder
successo => success
russa => russian
campagna => campaign
russia => russia
ungheresi => hungarian
lepenista => lepenist
accoglienza => acceptance
guidato => guided
aggregazioni => aggregations
csu => csu
giustificazioni => justifications
denuncia => denunciation
principio => principle
d => d
tradizionale => traditional
indubbia => undoubted
domenica => Dominicus
nazionalista => nationalist
stabilito => established
giustizia => justice
esito => issue
costi => costs
insomma => sum
tema => theme
schema => scheme
segmentazione => segmentation
cuore => core
coalizione => coalition
politiche => policies
marzo => march
improbabile => improbable
visto => visa
ossessiva => obsessive
difficilmente => with difficulty
governative => governmental
centro => center
ricongiungere => reconnect
modificare => modify
juncker => juncker
flynn => flynn
fine => finish
carne => chassis
higher => higher
condotte => conducted
capo => cape
stati => states
scritto => written
hotel => hotel
disonesto => dishonest
michael => michael
so => so
comey => comey
memorie => memoir
video => video
tv => tv
investigativo => investigative
fiamme => flames
fondanti => founding
incompetente => incompetent
ostruzione => obstruction
trasmessa => transmitted
attaccarlo => attack
steel => steel
possibili => possible
attesa => attended
cenno => mention
gran => great
possibile => possible
procuratore => prosecutor
materiale => material
cristopher => cristopher
certamente => certainly
recentemente => recently
storia => story
principe => prince
robert => robert
possesso => possession
palla => ball
james => james
moralmente => morally
inadatto => inapt
sgradevole => disagreeable
prigione => prison
risponde => responds
presunto => presumed
maggio => may
intervista => interview
russiagate => russiagate
speciale => special
anti => anti
fbi => fbi
incontri => encounters
detto => ditto
letto => bottom
continua => continuous
loyalty => loyalty
quattro => quartet
mueller => mueller
prova => proof
suggerendo => suggesting
urinavano => urinated
tycoon => tycoon
paragonare => paragon
dossier => dossier
pubblicizzare => publicize
definito => definite
porre => pose
consigliere => councillor
verità => verity
foresta => forest
sollevare => relieve
uniti => united
mano => hand
prostitute => prostitutes
seriale => serial
fango => fango
urinano => urinate
chiese => churches
esperti => experts
sentimentale => sentimental
nota => note
documento => document
cominciare => commence
team => team
richiesta => request
materia => matter
situazione => situation
mostrare => demonstrate
online => online
prodotto => product
usare => use
menlo => menlo
inserimento => insertion
ingegneri => engineers
design => design
governativi => government
spiegato => explained
rispondere => respond
provvedimento => provision
riguardo => regard
facile => facile
permesso => permission
tutore => tutor
park => park
comuni => communes
analytica => analytica
società => society
scelto => select
importante => important
rilevanti => relevant
facoltativo => facultative
completamente => completely
ufficiale => official
policy => policy
esterne => outer
regolamento => settlement
azioni => actions
esperienze => experiences
limitata => limited
regolatori => regulators
andare => fare
contributo => contribution
gdpr => gdpr
partner => partner
versione => version
opportunità => opportunity
resto => rest
cerca => search
profilo => profile
continuare => continue
rivedere => revise
ricerca => research
religiose => religious
limitazioni => limitations
pubblicità => publicity
tipo => type
persona => person
conto => count
rispettare => respect
annuncio => announcement
investire => invest
cambridge => cambridge
genitore => genitor
basate => based
protezione => protection
riunito => reunited
includere => include
trovao => trovão
diverse => different
piattaforma => platform
costruire => construct
designer => designer
migliorare => ameliorate
adattarsi => adapt
globale => global
facciale => facial
facebook => facebook
obblighi => obligations
tecnologia => technology
opinioni => opinions
legali => legal
personalizzata => personalized
dedicato => dedicated
compiere => complete
privacy => privacy
scandalo => scandal
iscriversi => inscribe
definitivamente => definitely
differenza => difference
marketing => marketing
inefficace => ineffective
previsioni => prediction
considerare => consider
valore => value
schiena => behind
dollari => dollars
tossica => toxic
staw => staw
intensificazione => intensification
soggettiva => subjective
pezzo => bit
risolvere => resolve
mollare => release
qui => hither
troppo => too
investimento => investment
deluxe => deluxe
prevedere => foresee
perseverare => persevere
permanenti => permanent
impossibilità => impossibility
origine => origin
fatalmente => fatally
avversi => adverse
fallimenti => failures
fatica => fatigue
posizione => position
sola => sole
precedenza => precedence
evidenti => evident
attitudine => aptitude
dritta => direct
apparentemente => apparently
elementi => element
condurre => conduct
individuali => individual
errore => error
stime => estimates
esempi => examples
citati => cited
posizioni => positions
futuri => future
tardi => tardily
costoso => costly
decidere => decide
direzione => direction
mancanza => absence
commitment => commitment
sensazione => sensation
rovina => ruin
oggettiva => objective
energie => energies
escalation => escalation
comportamento => deportment
rivelano => reveal
perseveranti => persevering
articolo => article
contemporaneo => contemporary
dichiarare => declare
immotivato => unmotivated
decisioni => decisions
rapidamente => rapidly
fiaschi => flasks
bella => belle
inspiegabile => inexplicable
vietnam => viet nam
via => via
mcdonald => mcdonald
relazione => relation
cecità => cecity
tenere => give
correttamente => correctly
inglese => English
conflitto => conflict
replicare => reply
costo => cost
evidenza => evidence
psicologicamente => psychologically
sbagliato => mistaken
difficile => difficult
pestifere => pestiferous
spesi => spent
onere => onus
realizzare => realize
porta => door
adrian => adrian
appartamento => apartment
enorme => enormous
destinazioni => destinations
discuterne => discuss
gentrification => gentrification
legislatori => legislators
schuetz => schuetz
inclusi => included
aeroporto => airport
costruzione => construction
corelogic => corelogic
locali => locals
opposizione => opposition
restare => stay
rimedio => remedy
hi => hi
griffin => griffin
area => area
moltitudine => multitude
realizzazione => realization
ristoranti => restaurants
sindaco => sindaco
regolamentazioni => regulations
boom => boom
senatore => senator
democrazia => democracy
vicinanze => locality
segregazione => segregation
max => max
assunto => assumed
limitano => limit
sb => sb
offrendo => offering
antecedente => antecedent
salario => salary
esercitato => exercised
complessi => complex
pagano => pagan
montata => mounted
migrazioni => migration
progetto => project
bloccarne => blocking
prestigiosa => prestigious
epiche => epic
capitale => capital
trasformazione => transformation
blu => blue
minima => minim
camera => camera
rimane => remains
commerciale => commercial
recarsi => depart
putnam => putnam
prassi => praxis
specialità => specialty
quanto => quantum
valley => valley
times => times
complesso => complex
economia => economy
insolito => uncommon
berkeley => berkeley
regolamenti => regulations
ordine => orderliness
burlingame => burlingame
deprimente => depressing
dream => dream
sacramento => sacrament
numero => number
lungo => long
lievitati => leavened
consiglieri => councilors
cospicuo => conspicuous
meccanico => mechanic
equiparabile => comparable
canone => canon
messico => mexico
fornire => furnish
laboratorio => laboratory
nato => innate
zonizzazione => zonation
apple => apple
micro => micro
ambizioso => ambitious
servizio => service
dreadlock => dreadlock
trovare => discover
victor => victor
jesse => jesse
p => p
trarre => derive
salari => salaries
proposta => proposal
esplosivo => explosive
impiegati => employees
incredibile => incredible
complessità => complexity
karen => karen
discusso => discussed
palo => pale
legislatura => legislature
voce => voice
denunciare => denounce
traduzione => translation
fondi => funds
quartiere => quarter
afro => afro
locale => local
regioni => regions
campus => campus
vive => live
weekend => weekend
moderni => modern
iniziato => initiate
seattle => seattle
storico => historian
decennio => decade
individui => individuals
new => new
accessibilità => accessibility
sanders => sanders
strenua => strenuous
trasferito => transferred
prezzo => price
vallco => vallco
sicuramente => surely
wiener => wiener
centesimi => cents
posteriore => posterior
centri => centers
esplicitamente => explicitly
cento => cent
collera => choler
sviluppo => evolution
shiller => shiller
iniziativa => initiative
battersi => battle
roma => rome
bambino => baby
tenda => tent
camper => camper
soluzione => solution
arreguín => arreguin
arrivato => arrival
controlli => controls
minuscolo => minuscule
risposta => response
prospettiva => perspective
intervento => intervention
settanta => seventy
aspiranti => aspiring
anna => anna
strade => roads
est => east
intitolato => entitled
necessità => necessity
alto => alto
york => york
lavorare => labour
salone => salon
entità => entity
aree => areas
medio => medium
paolo => paul
mercati => markets
forma => form
grado => grade
municipali => municipal
innovative => innovative
nazione => nation
barrera => barrera
basta => basta
meditando => meditating
poteri => powers
statale => state
indici => indices
silicon => silicon
jenny => jenny
law => law
seduto => seated
chapple => chapple
beneficio => benefit
pressioni => pressures
rischio => risk
anch => anch
esacerbato => exasperated
penuria => penury
guadalajara => guadalajara
autorizzazione => authorization
drastiche => drastic
proprietaria => proprietress
brookings => brookings
jennifer => jennifer
legislativo => legislative
raddoppiarci => raddoppiarci
perso => bemused
offre => offers
abitativo => inhabited
precedente => precedent
ndt => ndt
university => university
proprietario => proprietor
diretti => direct
piani => plans
presentare => present
allontanare => alienate
restrittive => restrictive
trasferissero => trasferissero
esposizione => exposition
iniziative => initiatives
opera => opera
impossibile => impossible
vivere => live
canoni => rents
stipendio => stipend
necessario => necessary
accessibili => accessible
promettendo => promising
residenti => residents
curry => curry
obiezione => objection
limited => limited
disegno => design
deciso => determined
esperta => expert
integrante => integral
californiani => californian
febbraio => February
financial => financial
gente => guy
colletti => collars
monitorate => monitored
vantaggio => advantage
autobus => autobus
attività => activity
rothstein => rothstein
insediamenti => settlements
città => city
arrivare => arrive
america => americas
camion => camion
opportunista => opportunist
produttività => productivity
eludere => elude
internazionale => international
upper => upper
glaeser => glaeser
edward => edward
esigenza => essential
alzato => elevation
crescere => increase
bernie => bernie
fosse => fissure
locazione => location
sostenere => sustain
reso => rhesus
dinamismo => dynamism
aggiunto => enclosed
nevada => nevada
messogli => messogli
lealtà => loyalty
harvard => harvard
eterogenea => heterogenous
crisi => crisis
tanjuatco => tanjuatco
california => California
offerte => offers
mega => mega
bissanti => bissanti
incontrollato => uncontrolled
proposte => proposals
accantonato => cantoned
viva => alive
grigio => grizzly
tecnologico => technological
ultra => ultra
proibitive => prohibitive
cocktail => cocktail
atto => act
turno => turn
disposizione => disposition
processo => process
limitando => limiting
dimensioni => dimensions
urbane => urban
impulso => impulse
appartamenti => apartments
autorizzati => authorized
zero => zero
permanente => permanent
machale => machale
americani => american
bay => bay
hoarders => hoarders
costruite => constructed
chilometri => kilometres
borghesia => bourgeoisie
noto => noted
imporre => impose
xx => xx
boston => boston
destinazione => destination
progressista => progressive
residenziale => residential
ross => ross
reazione => reaction
google => google
tech => tech
moretti => moretti
dipartimento => department
consiglio => counsel
municipale => municipal
piano => plane
costretto => constrained
segnare => score
sorta => sort
albero => arbor
tempi => times
polvere => powder
densità => density
leora => leora
considera => considers
americana => American
cambio => cambium
deleteria => deleterious
comunità => community
questione => question
utilizzare => utilize
responsabile => responsible
reeves => reeves
trasferirsi => transfer
berkele => berkele
costa => coast
residenza => residence
strada => street
scott => scott
mazda => mazda
adeguato => adequate
cupertino => cupertino
pendolare => pendular
ricchezza => richness
zareen => zareen
residente => resident
esistenti => existing
enormemente => enormously
interesse => interest
anello => annulus
kent => kent
fallita => failed
stretto => strait
regolamentazione => regulation
abbordabili => affordable
automobile => automobile
giardino => garden
richard => richard
stanford => stanford
bordo => border
sponsorizzata => sponsored
espansione => expansion
assoluta => absolute
accesso => access
concessionario => concessionaire
avveniristico => futuristic
conta => count
cittadinanza => citizenship
chicago => chicago
traffico => traffic
professoressa => professor
sospettosi => suspicious
color => color
decenni => decades
problema => problem
contea => county
middle => middle
rapido => rapid
massimo => maximum
enrico => heinrich
proibitivi => prohibitively
impatto => impact
mio => mine
zona => zone
gola => gullet
khan => khan
invalidare => invalidate
finalizzata => finalized
david => david
aula => aula
interne => internal
vi => vi
autorizzare => authorize
disparità => disparity
mateo => mateo
case => case
regione => region
finalizzati => finalized