restriction => beperking; begrenzing; keten; voorbehoud
they => zij; ze; men; hen; hij; hun; die
cellular => mobiele telefoon; mobieltje; GSM; mobiel; gsm
you => jij; je; u; jullie; gij; ge; men; gulder; aan je
what => hetgeen; welk; wat voor; welke; hoe; hé
regime => stelsel; bewind; staatsvorm; bestuur; bestuursvorm; gouvernement; heerschappij; overheid; regering
changes => veranderingen
cell => batterij; kerker; mobieltje; cachot; element; gevangenhuis; gevangenis; afdeling; 06
evidence => bewijs; teken; bewijsmateriaal; getuigenis; aanwijzing; adstructie; bewijsstuk; getuigenverklaring; blijk; certificaat
hope => verwachting; uitzicht; verwachten; verlangen; begeren; eerzucht; trek hebben in
caused => veroorzaakt
better => verbeteren; amenderen; beter worden; breken; corrigeren; emenderen; op een hoger plan brengen; wijzigen
daily => dagelijks; dagblad; alledaags; daags; dagdagelijks; krant; alle dagen; blad; courant; dagelijkse
side => kant; zijkant; zij; minder belangrijk; flank; partij; ver; zijdelings; bladzijde
restricted => beperkt; begrensd; eindig; bekrompen; besloten; gesloten
recommended => aanbevolen; raadzaam
however => echter; niettemin; maar; daarentegen; toch; eender hoe; nochtans; evenwel; desalniettemin; desondanks
choose => kiezen; uitkiezen; verkiezen; uitlezen; uitpikken; uitzoeken; aanwijzen; tonen; aanduiden; aangeven
flies => gulp
reduction => korting; vermindering; afslag; verlaging; afname; inkrimping; verkleining; daling; aftrek
thought => gedachte; idee; overweging; denken; begrip; denkbeeld; inval; oordeel; overleg; voorstelling
meal => maaltijd; bloem; eten; gort; grut; grutten; gerecht
a => een; per; binnen; in; te; bij; enig; iemand; naar
careful => zorgvuldig; voorzichtig; behoedzaam; zorgzaam; grondig; omzichtig; aandachtig; doortastend; prudent; nauwkeurig
idea => denkbeeld; gedachte; begrip; bedoeling; ingeving; plan; benul; opvatting; voorstelling
fewer => minder; min
during => tijdens; in; terwijl; onder; staande; voor; lopende; hangend; ondertussen
advertisement => reclame; aankondiging; bericht; annonce; ruchtbaarheid; promotie; openbaarheid; publiciteit
why => waarom; waarvoor; nou; wel; hoezo; hoe zo; weshalve; waardoor; hoezo?; waarom?
ate => oog
seemed => scheen; schenen
also => ook; eveneens; tevens; evenzeer; mede; evenals; onder andere; onder meer; zoal; alsmede
show => tonen; vertonen; aanduiden; laten zien; voorstelling; wijzen; aantonen; uitwijzen; demonstreren
push => duwen; duw; aanduwen; stoten; dringen; stoot; drang; zet; douwen; douw
happens => gebeurt
your => uw; je; jullie; ulle; jouwe; uwe; jij
be => zijn; wezen; worden; zich bevinden; bestaan; verkeren; liggen; plaatsvinden; staan; zitten
reference => verwijzing; getuigschrift; aanbeveling; certificaat; teken; verklaring; adstructie
sleep => slapen; slaap; maffen; pitten; onderbrengen; te slapen leggen; slaapstand; rusten; sluimeren
night => nachtelijke duisternis; nachtrust; overnachting; avondje; hotelovernachting; avond; duisternis; vanavond
research => onderzoek; speurwerk; nagaan; onderzoeken; uitvissen; uitzoeken; exploreren; speurtocht; vorsen
this => deze; dit hier; de; het; aanstaande; dat
libido => geslachtsdrift; lust
an => een; bij; binnen; in; met; naar; op; per; te
humans => mensen
study => bestuderen; studeerkamer; leren; onderzoek; onderzoeken; studiezaal; bestudering; exploreren
eat => vreten; gebruiken; bikken; consumeren; nuttigen; opvreten; beffen; nassen
those => die; dat; datgene; zulks; dat daarginds; diegenen; gindse; zij; die ... daar; die ... daarginds
to => naar; tegen; aan; voor; bij; om te; met; om
was => waren; werd
at => bij; op; in; dichtbij; nabij; apenstaartje; om; naar
food => eten; spijs; etenswaar; voeding; gerecht; voedingsmiddel; kost; levensmiddelen
as => aangezien; omdat; zo; zoals; want; terwijl; wijl; daar
around => rondom; om; ongeveer; langs; omheen; omtrent; zowat; circa; plusminus
the => het; aan de; aan het; naar de; hoe; des te; naar het; ’t; aarde
university => academie; unief; academisch; hogeschool
found => stichten; funderen; grondvesten; baseren; vestigen; oprichten; gronden; rechtvaardigen; terecht; tot stand brengen
even => gelijk; gelijkmatig; vlak; zelfs; gelijke; gelijkmaken; effen; paar; avondstond
center => centrum; middelpunt; midden; concentreren; hart; kern; as
scarce => karig; schraal; zeldzaam; kostbaar; ongemeen; nauwelijks; mager; spichtig
second => tweede; moment; ondersteunen; tel; bijvallen; herkansing; ondersteuner
read => lezen; ontvangen; luiden; horen; gelezen worden; aflezen; uitlezen; voorlezen; uitkrijgen; citeren
lot => perceel; kavel; partij; noodlot; boel; erf; portie; kans
effects => goederen
important => belangrijk; ernstig; erg; voornaam; aanzienlijk; gewichtig; zwaar; zwaarwichtig; aanmerkelijk; geruim
big => groot; omvangrijk; volwassen; grote; aanzienlijk; flink; aanmerkelijk; belangrijk; fors; zwaar
wanted => begeerd; gewenst; gewild; gezocht
feeling => gevoel; emotie; voorgevoel; gewaarwording; zin; besef
very => erg; heel; zeer; bijster; bijzonder; dezelfde; echt; hetzelfde; uiterst; zelfde
drop => waterdruppel; zakken; afnemen; weglaten; achterwege laten; afbreken; afgelasten; afleggen; afschaffen
which => welk; welke; hetwelk; die; dewelke; dat; hetgeen; wie; wat; waarmee
longevity => levensduur
requires => vereist
showed => getoond; gewezen; toonde; toonden
have => hebben; krijgen; zijn; moeten; erop nahouden; genieten; ontvangen; toucheren; bezitten; gebruiken
time => tijd; keer; maal; tijdperk; tijdstip; poos; uur; duur; klokken; chronometreren
of => van; over; voor; bij; uit; -e-; -en-; -s-; aan; met
small => klein; nietig; minuscuul; luttel; gering; karig; min; jong; miniem
metabolism => stofwisseling
everyone => iedereen; elkeen; allemaal; elk; allen; ieder; alleman; iegelijk; al; iedere
cent => duit; honderd
while => terwijl; poos; tijd; gedurende; tijdje; onder; een hele tijd; momentje; tijdens; staande
work => arbeid; functioneren; arbeiden; karwei; het doen; emplooi; in zijn werk gaan
animals => dieren; dierenrijk
by => door; met; per; op; tegen; langs; nabij; dichtbij; naast
interesting => belangwekkend; vreemd; curieus; typisch; vreemdsoortig; lucratief; rendabel; winstgevend; aantrekkelijk
adults => volwassenen
cause => veroorzaken; oorzaak; reden; aanleiding; aanrichten; teweegbrengen; doel; doen; maken; berokkenen
glucose => druivensuiker; druivesuiker; dextrose
in => binnen; te; tijdens; per; aan; op; bij; met; naar
assigned => toegewezen
usual => gebruikelijk; gewoon; algemeen; generaal; gangbaar; gewoonlijk; normaal; alledaags; courant; daags
monkeys => apen
measured => afgemeten; ceremonieel; plechtig; plechtstatig; gematigd; afgepast; weloverwogen
these => dit; dit hier; die; dat
ageing => veroudering
diet => parlement; rijksdag; voedsel; spijs; afvallen; lijnen
seen => gezien
per => in; te; binnen; aan; om; tegen; voor; door middel van; door bemiddeling van
few => weinig; karig; schaars; schraal; schriel; zeldzaam; kostbaar; minderheid; ongemeen; paar
include => bevatten; bijvoegen; behelzen; insluiten; betrekken; invoegen; omvatten; begrijpen; coveren
rate => verhouding; taxeren; begroten; schatten; waarderen; evenredigheid; proportie; snelheid; achten
necessarily => noodzakelijk; nodig; noodzakelijkerwijs; onvermijdelijk
cold => verkoudheid; kou; afstandelijk; fris; onvoorbereid; catarre; kil
respond => antwoorden; reageren; beantwoorden; antwoorden op; verantwoorden; bescheid geven; repliceren; terugzeggen
can => kunnen; blik; conserveren; inblikken; conservenblik; blikje; toilet; mogen; afvoeren
key => sleutel; toets; toonsoort; scala; toonladder; toonschaal; spie; toonaard; toon; klep
people => volk; mensen; lui; personen; bevolken; lieden; familie; bewonen; massa; verwanten
mechanism => techniek; machine
how => op welke manier; wat; op welke wijze; manier; wijs; wijze; zoals; als
further => nader; aanvullend; additioneel; accelereren; bespoedigen; langer; meer; verderop; verhaasten
experienced => ervaren; deskundig; geoefend; bedreven; zaakkundig; doorgewinterd; geroutineerd
on => op; aan; over; bij; in; jegens; met; om; te; tot
many => veel; vele; velen; evenveel; talrijk; menigte; menige
increased => is gestegen
likely => waarschijnlijk; aannemelijk; allicht; vast; wel; zeker; geschikt; knap; veelbelovend; vermoedelijk
such => zulk; zo; zodanig; dergelijk; dusdanig; zo’n; zulk een; zozeer; zo'n; zo een
causes => oorzaken
thousand => duizendtal
randomly => willekeurig; bij toeval; toevallig; toevalligerwijze
hallmarks => keurmerken
dramatic => bovenmatig; extreem; uiterst
life => levensduur; levenslang; hachje; aanzijn; levenswijze; bezieling; energie; levendigheid
save => redden; bewaren; opslaan; behouden; besparen; bergen; bezuinigen; uitsparen; behoeden
or => of; goud; weder; anders; anderszins; in het andere geval; zoniet; dan wel
healthier => gezonder
lifespan => levensduur
low => laag; lage; gemeen; laaghartig; schunnig; infaam; vuig; depressie; lagedrukgebied; loeien
stress => spanning; beklemtonen; klemtoon; accent; accentueren; nadruk; benadrukken; de klemtoon leggen op; drang
now => nu; thans; tegenwoordig; wel; enfin; komaan; tja; heden; welnu
energy => fut; arbeidsvermogen; spirit; kracht; wilskracht; nadruk; veerkracht; Energiesignaal; moe
live => wonen; gevestigd zijn; resideren; huizen; rechtstreeks; scherp; overleven
says => zeggen
he => zij; ’m; ik; jij; degene
extends => strekt
revealed => onthuld
years => jaren; jarenlang
lower => verlagen; strijken; neerlaten; afdraaien; laten zakken; afslaan; neerhalen; vellen; zakken; onderste
availability => beschikbaarheid; voorhanden zijn; aanwezigheid; bruikbaarheid
if => als; indien; wanneer; of; ingeval; as; mits; hetzij; If; zo
but => maar; behalve; echter; doch; slechts; enkel; alleen; niettemin; pas
it => hij; er; daaraan; eraan; erheen; hem; ’t; haar; daar ... aan
damage => schade; beschadigen; schaden; averij; nadeel; beschadiging; havenen; toetakelen; schade aanrichten; verlies
we => ons; Wij; men
journal => tijdschrift; krant; dagblad; courant; magazine; periodiek; dagboek; revue; logboek
and => en; alsook; alsmede
for => omdat; naar; want; daar; aangezien; wegens; gedurende; onder; staande
thinks => denkt
two => tweetal; biljet van twee dollar; tweejarig; tweejarige; biljet
reduced => afgeprijsd; gesoldeerd; teruggebracht; verkleind; verminderd; aanbieding
normal => gewoon; gewone; standaard-; ordinair; gangbaar; gebruikelijk; geldend; gewend
temperature => verhoging
investigate => onderzoeken; uitzoeken; exploreren; nagaan; uitvissen; vorsen; bekijken; bestuderen; een enquête houden; wetenschappelijk onderzoeken
much => veel; zeer; erg; vele; evenveel; verreweg; dikwijls; een heleboel; flink; gedurig
rates => prijzen
their => hun; haar; zijn; hunne; drukken; een; invloed; op; uitoefenen; d’r
are => zijn; bent; vierkante decameter; zijt; is
there => daar; aldaar; ginds; ginder; daarheen; daarginds; ’r
hibernate => overwinteren; een winterslaap houden; sluimerstand; slaapstand; slaapstand inschakelen
severely => hevig; bar; ernstig; gestreng; hard; straf; streng; strikt
body => lichaam; lijf; lijk; carrosserie; massa; corpus; menigte; hoofddeel; deel; kadaver
less => minder; min; kleiner; amper; minus; minder dan
prompted => gevraagd
blood => ras; temperament; bloedverwant; bloedverwante; familielid; verwant; aderlaten; bloedonderzoek
well => bron; goed; put; gezond; nou; waterput; fit; nu goed
others => ander; anderen; iemand anders; the others
loss => verlies; schade; verliezen; nadeel; strop; deficit; schadepost; nederlaag; warmteverlies; aderlating
limit => grens; beperken; begrenzen; beknotten; perk; begrenzing; beperkingen opleggen aan; landsgrens; rand
planning => opzet
when => wanneer; als; toen; zodra; terwijl; eenmaaal; eens; van zodra; dan; waarop
may => mogen; kunnen; het recht hebben; meidoorn; misschien; mei
her => zijn; d’r; hun; zij; ’r; ze; aan haar; naar haar; d'r
cutting => stek; stekken; hakken; snijdend; kappen; snijden; bijlslag; bijtend; filet
year => jaartal; klas; begrotingsjaar; boekjaar; jaarcijfer
first => eerst; vooreerst; ten eerste; allereerst; origineel; aanvankelijk; oorspronkelijk; primair; baanbrekend
has => heeft
metabolic => stofwisselings-
expand => uitbreiden; vergroten; uitzetten; toenemen; uitdijen; uitwerken; factoriseren; ontbinden in factoren; openzetten; zich uitbreiden
is => zijn
sense => betekenis; zintuig; zin; gewaarworden; aanvoelen; voelen; gevoelen; verstand; waarnemen; gevoel
more => langer; verder; bovendien; meest; -er; Meer; groter
that => die; zo; hetgeen; welke; even; hetwelk; degene
some => enkele; wat; enige; enigszins; zowat; een beetje; een weinig; enig
significant => veelbetekenend; betekenisvol; beduidend; belangrijk; veelzeggend; voelbaar; waarneembaar; aanzienlijk; behoorlijk
with => met; bij; door; tegen; voor; samen met; aan; per; ten huize van; aaneen
break => pauze; pauzeren; kapotgaan; overtreden; stukgaan; verbreken; kapotmaken; stukmaken
rest => stilstand; overblijfsel; kalmte; rommel; uitrusten; nachtrust; stilstaan
square => vierkant; plein; kwadraat; plaats; vierkante; kwadrateren; markt; oplossen; veld
bacteria => Lactobacillus fermentum ME-3; bacil
should => moeten; behoren; dienen; horen; zullen; mochten; zou moeten; zouden; mogen
cleanup => schoonmaken; opruimen
mystery => raadsel; geheimenis; geheim; geheimzinnigheid
perhaps => misschien; mogelijk; wellicht; mogelijkerwijs; soms; het zou kunnen; allicht; vast; waarschijnlijk; wel
harmful => schadelijk; nadelig; gevaarlijk; hachelijk; link; bedenkelijk; gewaagd; riskant; waaghalzerig; kwalijk
another => een andere; nog een; aanvullend; extra; iemand anders; meer; additioneel; overig
ropes => touwen
researchers => onderzoekers
not => nee; neen; geen; generlei
w => slepen
ocean => wereldzee; zee; massa
other => ander; andere; anderen; anders; verschillend; nog; overig; afwijkend; different; divers
times => keer; maal
japan => lakken; verlakken
carry => dragen; overdracht; overdragen; overnemen; beschikbaar hebben; greep; te horen zijn; ter beschikking hebben; brengen; vervoeren
down => omlaag; dons; af; naar beneden; depressief; depri; neer; droppen; kwart
laboratory => lab; labo
underestimated => onderschat
pacific => vreedzaam
terms => voorwaarde; bepaling; conditie; verstandhouding
kilogram => kilo
including => met inbegrip van; inbegrepen; tot en met; zelfs
patch => lap; lapwerk; verstellen; oplappen; ingezet stuk; bed; lappen; perk; bloemperk
suggestion => voorstel; tip; wenk; aanbod; aanbieding; bod; voorslag; aanraden; aansporing
still => nog; alsnog; nog steeds; toch; distilleerderij; kalmeren; distilleerapparaat; bedaard; bedaren
flotsam => drijfhout
into => in; binnen; per; te; aan; bij; met; naar; op; tegen
so => zo; zodanig; dus; zodoende; bijgevolg; derhalve; zodat; dermate; zozeer; dan
pieces => stukken
computer => rekenaar; pc; personal computer; rekenkast; rekentuig
most => hoogst; meer; zeer; extreem; in hoge mate; uitermate; -st; allemachtig
label => etiket; etiketteren; aanbrengen; prijzen; bestempelen; categoriseren; platenmaatschappij; barensteel; heten
expanding => uitbreiden
part => deel; onderdeel; stuk; gedeelte; rol; bestanddeel; component; ingrediënt; aandeel
sinking => achteruitgang; besnoeiing; daling; debâcle; degeneratie; degradatie; kleinering; ondergang; ontaarding; rampspoed
affects => beïnvloedt
litter => draagstoel; vuilnis; afval; draagbaar; zwerfafval; strooisel; werpen; worp; zwerfvuil; draagbed
large => groot; grote; flink; ruim; wijd; fors; omvangrijk; aanmerkelijk; aanzienlijk; ampel
instance => voorbeeld; geval; voorval; exempel; toonbeeld; exemplaar; model; aandrang; keer
excreted => uitgescheiden
surveys => enquêtes
one => een; één; men; enige; je; de; dezelfde; een zekere; eenheid
model => modelleren; toonbeeld; voorbeeld; mannequin; staan; maquette; schema; tonen; boetseren
discarded => weggegooid
know => weten; kennen; kunnen; bekend zijn met; beheersen; machtig zijn; verstaan; begrijpen; onderscheiden; beleven
seas => zeeën
been => geweest; zijn
objects => spul
third => Terts
netherlands => benamingen van nederland
tsunami => vloedgolf
comprehensive => uitgebreid; alomvattend; diepgaand; omvattend; veelomvattend; lijvig; allesomvattend; omvangrijk; alles; all-round-
team => ploeg; equipe; groep; afdeling; detachement; groepering; elftal; samenwerken; vlucht
great => fantastisch; kostelijk; fijn; heerlijk; prachtig; tof; voortreffelijk; uitmuntend
exist => bestaan; zijn; leven
aerial => antenne; bovengronds; met lucht gevuld; ra; spriet; voelhoorn; voelhoren; voelspriet; lucht; lucht-
were => was; zou zijn
little => klein; weinig; gering; karig; min; nietig; minuscuul; beetje; jongere
fishing => hengelsport; sportvisserij; stek; visvangst; het vissen
because => omdat; daar; aangezien; vermits; want; wijl; dewijl; doordat; gezien; naardien
entangle => verwarren; verstrikken; verwikkelen; betrekken; verknopen; bedotten; beetnemen; in verwarring brengen
debris => puin; afval; rommel; gletjserpuin; wrakhout; prullaria; overblijfselen; restanten; ruine; wrakstukken
trying => lastig; moeilijk; vermoeiend
towed => gesleept
sea => maritiem; zee-; massa; zeewater; stortzee; zee‐
come => het gevolg zijn van; klaarkomen; afstammen; aankomen; voortkomen; naderen; ontspruiten; arriveren; gebeuren
organisation => ORG; vennootschap
floor => verdieping; etage; auditorium; bodem; grond; hoorders; toehoorders
greatly => terdege; zeer; dikwijls; een heleboel; gedurig; hoog; hoogst; menigmaal; sterk
increase => toename; vergroten; vermeerderen; vermeerdering; toenemen; verhogen; opdrijven; ophogen; oplopen; uitbreiden
surface => oppervlak; oppervlakte; opduiken; kroon; kruin; mantel; top; topje; aan de oppervlakte brengen; boven water komen
eaten => gegeten; opgegeten
outer => uiterlijk; uitwendig; extern; kosmisch
data => gegevens; informatie; materiaal; gegeven; grondstof; materieel
made => maken
marine => vloot; zee-; zeemacht
photo => fotograferen; afbeelding; beeld; Foto's; plaat; prent; voorstelling
could => kunnen
gathered => verzamelde
between => tussen; onder; onder ons gezegd en gezwegen; ertussen; te midden van; tussendoor; begeleid; daartussen; gekantonneerd; geëvend
missing => ontbrekend; verdwenen; vermist; gebrekkig; zoek
find => aantreffen; vondst; ontdekken; achten; concluderen; waarnemen; treffen; bemerken
alone => alleen; louter; verlaten; enig; eenzaam; afgescheiden; afgezonderd; allenig; enkel; exclusief
across => overheen; over; horizontaal; tegenover; aan de overkant van; zijdelings; aan de overkant; dwars; dwars door; in horizontale richting
centre => middelpunt; midden; binnenste; spil; binnenwerk; ingewand; medium; middelmaat
basins => bekkens
fed => voedden
least => minst; minste; allerminst; minder; althans
four => vier; viertal
near => nabij; dichtbij; bij; naderen; komend; aanstaand; eerstvolgend; dichterbijkomen; naverwant
like => houden van; zoals; als; graag hebben; mogen; soortgelijk; gelijksoortig; gelijkvormig
after => na; naar; nadat; door; ondanks; aan; vanwege; over
earlier => eerder; vroeger; daarvoor; indertijd; verleden; vooraan; vorig; voorafgaand; voorgaand
stock => voorraad; aandeel; kolf; reserve; opslaan; violier; in stock hebben; in voorraad
out => uiterlijk; weg; daarbuiten; eruit; buitenwaarts; naar buiten; uitwaarts; uitweg
scientific => wetenschappelijk
tonnes => ton
rely => rekenen op; afhangen; vertrouwen; zweren; afhankelijk zijn; deel uitmaken
where => waar; waarheen; waarvan; waarvandaan; waartoe; waarnaartoe; waarin; waar ... heen; waar ... naar toe; warheen
land => grond; aan land gaan; neerstrijken; aanlanden; bodem; aardrijk; dalen
us => wij; aan ons; we
estimated => geschat
collected => bedaard; kalm; rustig
had => gehad
explanations => toelichtingen
regions => taalgebied
getting => krijgen
patches => pleisters
based => onderbouwd
remove => verwijderen; weghalen; afschaffen; elimineren; wegnemen; opdoeken; wegdoen; afnemen; afhalen; afpakken
creatures => schepsels
microscopic => piepklein
ability => vermogen; bekwaamheid; vaardigheid; kundigheid; geschiktheid; competentie; aanleg; bedrevenheid; bevoegdheid; capaciteit
about => over; ongeveer; rond; bij; aangaande; om; betreffende; bijna; omheen; vrijwel
ingested => ingeslikt
area => gebied; oppervlakte; regio; streek; terrein; veld; buurt; gewest; domein
rather => nogal; liever; vrij; ietwat; tamelijk; veeleer; bij voorkeur; een klein beetje; enigszins; lichtelijk
garbage => afval; vuilnis; huisvuil; vuil; rommel; uitschot; slachtafval; troep; koeterwaals; prullaria
estimates => begroting
being => wezen; bestaan; zijn; aanzijn; entiteit
member => lid; lidmaat; ledemaat; aanhanger; lul; piemel; pik; jongeheer; leuter; plasser
from => van; uit; vanaf; tegen; sedert; sinds; vanuit; met ingang van; naar; op de
carried => gedragen
probably => waarschijnlijk; allicht; wel; zeker; vast; aannemelijk; vermoedelijk
currents => stromingen
rising => opklimmend; opstand; opheffing; muiterij; opgang; opkomend; oproer; opstijgend; rebellie; revolte
real => echt; werkelijk; waar; daadwerkelijk; echte; effectief; wezenlijk
breaking => breuk
plastic => kunststof; beeldend
particles => deeltjes
came => loodlijst
ways => manieren
denser => dichtere
mass => mis; menigte; hoeveelheid; boel; drom; hoop; meerderheid; misvieren; ophopen
similar => gelijkend; gelijksoortig; soortgelijk; gelijkvormig; eender; gelijk; gelijkaardig; vergelijkbaar; overeenkomstig; analoog
floating => zwevend; drijvend
simultaneously => tegelijkertijd; tegelijk; gelijktijdig; simultaan; gelijk; gelijkelijk
combat => gevecht; strijd; slag; kamp; veldslag; treffen; vechten; bestrijden; oorlog; bestrijding
who => wie; die; welke; dat; hetwelk; welk; 10.wie; dewelke
added => toegevoegd
until => tot; totdat; voor; binnen
billion => miljard; een miljard; één miljard
said => desbetreffend; desbetreffende; in kwestie; zeggen; genoemd; voornoemd
enemy => vijand; vijandelijk; tegenstander; belager; vijandin; antagonist; opposant; tegenwerker
victory => overwinning; zege; triomf; baat; gewin; overwinningen; verdienste; winst; zegepraal
mark => teken; punt; aanduiden; score; merkteken; tekenen; bewijs
world => aardrijk; aarde; heelal; aardbol; Aarde; kosmos; ruimte
clogged => verstopt
medical => geneeskundig; helend; medisch onderzoek
global => wereldwijd; sferisch; bolrond; bolvormig; mondiaal; wereld-; universeel; compleet; gans
necessary => nodig; noodzakelijk; benodigd; van node; essentieel; onvermijdelijk; vereist; noodzaak; onafwendbaar; onmisbaar
gazes => blikken
close => sluiten; dichtbij; dichtdoen; nabij; afsluiten; beëindigen; dichtmaken; dichten; toedoen; nabije
command => bevelen; bevel; opdracht; aanvoeren; order; voorschrijven; gebod; verordenen
urban => stedelijk; stads-; stads; stads‐; stedelijk gebied
ensure => verzekeren; betuigen; assureren; beveiligen; uitvoeren; veiligstellen; zeker stellen; behoeden; beloven; beschermen
chemical => scheikundig; verslavend middel; chemische stof; chemieproduct; chemisch product; chemische substantie
administering => toedienen
stretches => strekt
end => beëindigen; eindigen; ophouden; uiteinde; besluit; aflopen; slot
call => noemen; roepen; opbellen; roep; aanroepen; heten; schreeuwen; bellen; bezoek; bezoeken
no => nee; neen; geen; niet; verboden; tegenstem; neestem; verboden te; niemand; zonder
used => gebruikt; afgewerkt; gewoon; occasion; vroeger
current => actueel; stroom; stroming; huidig; tegenwoordig; aktueel; aktuele; huidige; hedendaags; loop
covered => bedekt; begroeid; bezaaid; gedekt
china => porselein; porseleinen; volksrepubliek china
resource => hulpbron; middel; bron; faciliteit; hulpmiddel; middelen; medium; remedie; weg
noted => bekend; beroemd; befaamd; vermaard
budget => begroting; begroten; goedkoop; low-cost; opmaken; opstellen; voorraad
death => dood; overlijden; sterfgeval; ondergang; verderf; verscheiden; heengaan; versterf; doodgaan; levenloos
bomb => bombarderen; afgaan; flop; vlam; wrak; sexbom
field => akker; gebied; terrein; lichaam; slagveld; speelveld; wei; land; vak
stretch => rekken; uitrekken; rek; reiken; spannen; aanspannen; rechttrekken; afwikkelen; besmeren
ordered => bestelde
potential => bestaanbaar; mogelijkheid; eventueel; haalbaar; mogelijk; gebeurlijk; latent
spilled => gemorst
memorial => gedenkteken; herdenkingsplaats; aandenken; gedachtenis; gedenksteen; herdenking; petitie; rekest; verzoekschrift; gedenkschrift
all => helemaal; totaal; elk; allemaal; heel; geheel
members => leden
coming => aanstaand; afkomstig; komst; volgend; aankomst; spoedig; aanstaande; aanval
reaches => bereikt
expansive => omvattend; mededeelzaam
certain => zeker; stellig; gewis; vast; bepaald; beslist; vaststaand; wis; duidelijk; verzekerd
population => bevolking; inwonertal; zielental; volk; residentie; demografie
deafening => oorverdovend
nations => landen
hostile => vijandig; vijandelijk; onvriendelijk; agressief; antagonistisch; vijandige
oppose => dwarsbomen; tegenwerken; belemmeren; tegenhouden; opponeren; weerstaan; weerstreven; bestrijden; ...; bezwaar hebben tegen
later => straks; volgend op; achter; achtereenvolgens; na
countless => ontelbaar; talloos; legio
drug => medicijn; geneesmiddel; artsenij; drogeren; dope; drogerij; kruid; narcoticum; bedwelmen
access => toegang; aanval; bereiken; toegangsrecht; toegangsweg; toelating; verkrijgen; oprit; aanwinst; benadering
thoroughly => grondig; radicaal; rijpelijk; volkomen; volledig; compleet; degelijk; finaal; geheel; heel
my => mijn; m’n; mijne; m'n
consolidate => versterken; bevestigen; samenvoegen; verstevigen
crater => trechter
disagree => het oneens zijn; overeenkomen; niet overeenstemmen; afkeuren; afslaan; afstoten; afwijzen; ciseleren; heruitzenden; nee zeggen tegen
disposal => neiging; lust; zin; aanvechting; verkoop; schikking; berging; beschikking; configuratie; opslag
say => zeggen; opgeven; luiden; opzeggen; staan; hallo; zeg; spreken; hee; hee daar
worth => waarde; waard; gehalte; gelijkwaardig aan; gewaardeerd; vermogen; waardigheid; kostbaarheid; verdienste
etched => geëtst
vanquished => overwonnen
its => zijn; haar; hun; de zijne; drukken; een; ervan; invloed; op; stempel
last => duren; afgelopen; vorig; voorbij; leest; beklijven; aanhouden; standhouden
leaders => voorspan
present => geschenk; cadeau; voorstellen; aanwezig; tegenwoordig; heden; gift; huidig
heavy => zwaar; drukkend; zware; serieus; moeilijk; moeitevol; moeizaam; onhandig; overvloedig; ruw
fear => angst; vrezen; vrees; bang zijn; bang zijn voor; schrik; beduchtheid; duchten; beklemming; benauwdheid
cost => prijs; uitgave; kostprijs; schade; verlies; uitgaven; uitgaaf
our => ons; onze
battle => gevecht; strijd; slag; veldslag; kamp; strijden; vechten; bestrijden; bevechten; oorlog
ripping => heerlijk
decree => decreteren; verordenen; besluit; verordening; voorschrift; voorschrijven; beschikking; bepalen
armies => legers
farthest => extreem
bombing => bombardement; bomaanslag
nation => staat; volk; land; mensen; peupel
engagement => verloving; verbintenis; afspraak; verplichting; treffen; betrekking; gevecht; hemelvaart; indienstneming
barren => onvruchtbaar; steriel; verlaten; woest; bar; doods; eenzaam; schraal; uitgestorven; dor
raids => invallen
looked => keek
russia => Rusland; rusland
table => lijst; tabelleren; dis; rekentafel; vermenigvuldigingstafel; plateau; rekentafels; vermenigvuldigingstafels
fight => strijden; strijd; bekampen; bestrijden; knokken; met
operating => werkzaam; functionerend
deploy => uitrollen; ontvouwen; gebruiken; implementeren; opzetten; uitspreiden; uitvouwen; inzetten
mountains => bergen; gebergte
though => hoewel; ofschoon; al; echter; alhoewel; wel; ondanks; desondanks; overigens
engage => verloven; aanvallen; huren; aannemen; aanwerven; bekleden; beslaan; bewonen; bezetten; bezig houden
might => vermogen; zou kunnen; kunnen; sterkte
confirmed => bevestigd; onverbeterlijk; verstokt
continuing => durend; voortdurend
enough => genoeg; voldoende; tamelijk; vrij; nogal; basta; genoeg!; toereikend; suffisant; afdoend
upon => aan; bij; betreffende; jegens; met; om; over; te; tegen
wiping => afvegen
single => ongehuwd; ongetrouwd; alleenstaand; alleen; alleenstaande; vrijgezel; afzonderlijk; eenzaam
peace => vrede; rust; peis; vrede met zichzelf; vree; geluk; kalmte
went => ging
bombings => bomaanslagen
back => achterzijde; ommezijde; rugstuk; rugleuning; bekleden; overtrekken; rugzijde; achteruit; ondersteunen
let => toestaan; verhuren; laten begaan; laten schieten; gedogen; loslaten; vergunnen; veroorloven
future => toekomst; toekomstig; aankomend; toekomend; toekomende tijd; beginnend; aanstaand; in spe; komend; spoedig
recognize => erkennen; herkennen; onderkennen; agnosceren; als waarheid aannemen; honoreren; identificeren; toegeven; toekennen; verkennen
instantaneous => onmiddellijk; direct; ogenblikkelijk; bruusk; plots; plotseling; plotselinge; onmiddelijk; terstond; live
admitted => toegegeven
career => loopbaan; beroep; bedrijf; broodwinning; professie; beroepsopleiding; vaart
stockpiles => voorraden
necessity => noodzaak; noodzakelijkheid; nood; behoefte; nooddruft
launcher => draagraket
free => vrij; gratis; los; bevrijden; kosteloos; vrije; open; loslaten; kosteloze; vrijmaken
glorious => glorierijk; roemrijk; beroemd; heerlijk; prachtig; roemruchtig; roemvol; zalig; alom bekend
treatment => behandeling; kuur; hantering; onderhandeling; therapie; geneeswijze; onthaal; opheldering; zuivering
corpse => lijk; kadaver; kreng; karkas; lichaam
swift => snel; vlug; gezwind; spoedig; gauw; gierzwaluw; haastig; steenzwaluw; haspel; prompt
fire => ontslaan; brand; schieten; vuren; afgaan; afvuren; fornuis; vuurzee; bakken
officer => ambtenaar; beambte; politieagent; kantoorbediende; agent; bedrijver; dealer; smeris; vertegenwoordiger
total => geheel; gehele; gelijk zijn aan; uitkomen op; compleet; som; volledig; algeheel; optellen
assaults => aanvallen
historic => geschiedkundig
waist => middel; taille; leest; gordel; lijfje; middendek; keursje; blouse; keurslijf; kuil
continued => doorgegaan; voortdurend
overhead => bovengronds; met lucht gevuld; boven; lucht-; daarboven; omhoog; hierboven; lucht; lucht‐
fury => woede; razernij; toorn; boosheid; drift; gramschap
foothills => Uitlopers
picture => afbeelding; prent; beeld; plaatje; plaat; foto; portret; schilderij; voorstelling
mall => winkelcentrum; markt; voetgangersgebied; voetgangerszone
darkened => verduisterd
battlefield => slagveld
proclaiming => verkondigen
shackles => boeien; belemmering
i => ik; me; mij
ready => klaar; af; afgelopen; bereidvaardig; dienstwillig; bereidwillig; gretig; paraat
military => leger; oorlogs-; martiaal; krijgs-; armee; legermacht; troepenmacht; strijdkrachten
merciless => genadeloos; onbarmhartig; meedogenloos; ongenadig; gemeen; gemene; wrede; wreed; onmeedogend; halsstarrig
ever => ooit; altijd; steeds; eens; immer; eenmaal; wel eens; nooit; weleens; almaar
resources => remedie; weg; medium; middel; middelen; geldmiddelen
forward => aanvaller; doorsturen; doorzenden; verzenden; voorspeler; doorgeven; voort; vooruit; afzenden
troop => bende; horde; zwerm; menigte; drift; hoop; kudde; pfadfinder; roedel
perish => omkomen; vergaan; creperen; ondergaan; sneuvelen; sterven; bederven; verongelukken; wegkwijnen; doodgaan
best => slaan; verslaan; overmeesteren; overwinnen; optimaal; aas; crack; grootmeester
mobilize => mobiel maken
missile => raket; projectiel
over => boven; afgelopen; beëindigd; klaar; voorbij; aan; afgewerkt; ruim; om
foe => vijand; tegenstander; antagonist; opposant; tegenwerker
campaign => veldtocht; actie; platteland
take => nemen; aannemen; accepteren; brengen; aanvaarden; vatten; bezetten; aanvatten; bekleden
any => enig; elk; een of ander; een of andere; enige; enkel; enkele; ieder; iemand; sommige
planet => zwerfster
launch => lanceren; uitschrijven; lancering; barkas; ontketenen; te water laten; aanzetten; doorboren; gooien; smijten
shouted => geschreeuwd
enemies => vijanden
adversary => tegenstander; vijand; tegenspeler; tegenstrever; Tegenstander; antagonist; opposant; tegenwerker
hearts => hartenjagen
deep => zwaar; diepgaand; dik; donker; laag; sterk; bas; diepliggend
triumphant => zegevierend; zegepralend
sum => optellen; bedrag; totaal; bijeentellen; somma; summa; rekensom; totaalcijfer; totaalbedrag
debt => schuld; schulden; verplichting
beneath => onder; daarbeneden
bullet => kogel; hagel; bal; bolletje (opsommingsteken); opsommingsteken; speelbal
pause => rust; interval; nadenken; onderbreking; bedaardheid; bestand; bewegingloosheid
seven => rood
build => bouwen; opbouwen; aanleggen; maken; construeren; metselen; bouw; timmeren; aanmaken; lichaamsbouw
them => hen; hun; ze; aan hun; aan ze; naar hun; zich; zij; erop; haar
eastern => oostelijk
pursued => nagestreefde
refuse => weigeren; afwijzen; afval; vertikken; afkeuren; afslaan; terugwijzen; vuilnis; het verdommen; rommel
theater => schouwburg; toneel; slagveld; aula
establishment => vestiging; instelling; oprichting; stichting; bestel; bedrijf; firma; formatie
general => algemeen; universeel; gemeen; in het groot; schetsmatig; veldheer; lijst van Zwitserse generaals
remains => overblijfselen; resten; overblijfels; as; kadaver; lichaam; lijk; stoffelijk overschot
defeated => gevallen; verslagen
pentagon => vijfhoek
settle => afhandelen; afwikkelen; afdoen; afrekenen; beslechten; beslissen; vestigen; afnemen; gaan liggen; bijleggen
arsenal => wapenmagazijn; wapenopslagplaats; tuighuis; wapenkamer; wapendepot
will => testament; zullen; wens; verbond; laatste wilsbeschikking; uiterste wil; gaan; wilsbeschikking; zin
political => staatkundig; partijpolitiek
annual => jaarlijks; jaarlijkse; jaarboek; adresboek; almanak; eenjarig
acknowledged => erkend; geaccepteerd
aircraft => vliegtuig; vliegmachine; toestel; luchtvaartuig; luchtschip; kist; luchthaven; luchtvoertuig
paying => betalen
options => configuratie
only => slechts; alleen; maar; pas; enkel; enig; net; uitsluitend; louter; verlaten
prevent => verhinderen; voorkomen; beletten; verhoeden; belemmeren; doorkruisen; storen; stremmen; weerhouden; hinderen
indeed => inderdaad; werkelijk; feitelijk; echt; waarlijk; metterdaad; wezenlijk; daadwerkelijk; immers; toch
keep => blijven; bergen; fokken; toekijken; aanhouden; bewaken; nakomen; naleven; onderhouden; opfokken
unceasing => onophoudelijk; voortdurend; blijvend; doorlopend; gedurig; ononderbroken; altijddurend; eeuwig; onafgebroken; permanent
unrelenting => meedogenloos; onverbiddelijk; onvermurwbaar; voortdurend
branches => takken
armed => gewapend; bewapend; gehoefd; gehoornd; genageld
spoils => plundering; roofbuit; vriendjespolitiek; het uitdelen van ambten aan partijgenoten; buit
strategy => krijgskunde; opzet; planning
stood => gestaan
leftover => restant; kliekje; over; resterend; blijvend; overblijfsel
available => beschikbaar; voorhanden; verkrijgbaar; disponibel; liquide; gratis; vrij; geldig; leverbaar; bereikbaar
yet => nog; al; toch; echter; maar; nog steeds; tot dusver; alsnog; niettemin; reeds
horizon => kim; gezichtseinder; kimme; einder; gezichtskring
downtown => binnenstad; centrum; stadscentrum
blighted => ellendig
national => landelijk; vaderlands; binnenlands; staats-; staatsburger; volks-
would => zouden; gelieve; willen; Use the past tense
price => schatten; waarde; koers; waard
nuclear => kern-; atoom-; atomair; kern‐
disease => ziekte; aandoening; kwaal; ongezondheid; besmetting; flauwheid; gebrek; gebrekkigheid; invaliditeit; zachtheid
ranks => gelederen
ordnance => geschut; Geschut; artillerie
fighter => kamper; strijder; gevechtsvliegtuig; krijger; bestrijder; straaljager; vechtsporter; bikkel
explained => uitgelegd
known => bekend; beroemd; geweten; gekend; gereputeerd; bekende
additional => aanvullend; bijkomend; overig; verder; extra; supplementair; toegevoegd; aanvullende; ander
exploit => uitbuiten; heldendaad; wapenfeit; uitmelken; daad; prestatie; aanval; benutten
instead => in plaats van; in plaats daarvan
given => bepaald
ordering => bestelling
confront => tegenover stellen; vergelijken; het hoofd bieden; bezwaar hebben tegen; niet toegeven; niet wijken; pal staan; standhouden; weerstaan
vehicles => voertuigen
strike => raken; houwen; klappen; kloppen; halen; inslaan; aanboren; teisteren; wissen; aanflitsen
right => juist; correct; goed; eerlijk; billijk; rechtvaardig
chorus => koor; refrein; rei; zangkoor; Refrein
corner => hoek; accapareren; opkopen; beslag leggen op; hoekschop; straathoek; zich meester maken van; zich toe-eigenen; hoekje
words => tekst; woordenwisseling
deploying => het inzetten
starvation => uithongering; hongersnood; ondervoeding
unless => tenzij; behalve
waged => gevoerd
mexico => mexico-stad
left => links; linkerkant; over; linker-; linker; linkerzijde; linksaf; linksom; linkse; blijvend
grenade => Handgranaat; granaatappel; handgranaat
fighting => actief
humanity => mensheid; mensdom; menselijkheid; mensengeslacht; menslievendheid; medemenselijkheid; mens
without => zonder; gespeend van; ontbloot van; verstoken van; zonder te; buiten; ex; daarbuiten; geen; tenzij
lay => leggen; wereldlijk; vlijen; neerleggen; leken-; ligging; plaatsen; zetten; leke-; uitbrengen
sky => hemel; lucht; firmament; uitspansel; hemelgewelf; zwerk; luchtruim; ruimte; heelal; klimaat
wasteland => woestenij; wildernis; woestijn; braak; braakliggend terrein
taking => afname; vangst; aantrekkelijk; besmettelijk
plain => vlakte; duidelijk; zuiver; eenvoudig; klaar; helder; vlak; uitgesproken; kaal; gewoon
flesh => vruchtvlees; mensenkleur; vel; vervetten; aandikken; verdikken
mortal => sterfelijk; sterveling; dodelijk; sterfelijke; moorddadig; ontzettend; verschrikkelijk
casualties => doden en gewonden
crumbling => brokkelig
fallen => gevallenen
through => door; doorheen; met; per; geheel; heel; volledig; via; aan; af
plains => vlaktes
percentage => rente; gehalte; boodschap; commissie; commissieloon; opdracht
hand => overhandigen; werkman; werkkracht; wijzer; aanreiken; aangeven; geleiden; greep; handgreep
full => volledig; compleet; verzadigd; ruim; zat; totaal; volkomen; wijd; geheel
commanders => bevelhebbers
planned => gepland
bring => brengen; aandragen; bezorgen; aanvoeren; aanbrengen; afhalen; besturen; geleiden; leiden; medebrengen
five => vijf
weapon => gevechtswapen
each => elk; ieder; elke; al; alle; iedere; met; per; alleman; elkeen
war => oorlog; krijg; gevecht; strijd; oorlogvoeren; strijden; conflict; geschil; kamp; oorlog voeren
clashes => botsingen
granted => toegestaan
rein => teugel; besturen; beteugelen; hoofdstel; leidsel; Tuigage; toom; intomen; tuigage
heard => gehoord
delay => vertraging; uitstellen; vertragen; uitstel; oponthoud; verdagen; verschuiven; achterstand; verdaging; aanhouden
chairman => voorzitter; president; preses; praeses
entire => geheel; heel; gans; compleet; vol; volledig; algeheel; totaal; volkomen; volslagen
asset => activa; aanwinst; prooi; acquisitie; buit; verkrijging; bezit; voordeel; pluspunt; verwerving
fierce => woest; fel; heftig; hevig; barbaars; gruwelijk; meedogenloos; wreed; wreedaardig; scherp
waste => afval; verspillen; verkwisten; verdoen; verspilling; rommel; verklungelen; vermorsen; verkwisting; vuil
state => toestand; verklaren; land; rijk; beweren; gesteldheid; verzekeren; bekendmaken
wars => oorlogen
arms => wapen; krijg; blazoen; wapenschild; wapens
windswept => winderig
plan => ontwerp; ontwerpen; concept; bedoeling; blauwdruk; doel; opzet; plattegrond
countries => landen
order => bevelen; bestellen; bestelling; bevel; volgorde; commanderen; gebod
according => volgens; blijkens; ingevolge; afhankelijk; luid; overeenkomstig
preemptive => preventief
continue => voortzetten; doorgaan; verdergaan; vervolgen; aanhouden; voortduren; voortgaan; beklijven; duren
screeching => gekrijs
offensive => aanvallend; beledigend; aanval; weerzinwekkend; inval; walgelijk; attaque; smadelijk; stotend
every => ieder; elk; al; alle; iedere; elke; alleman; allemaal; allen; alles
funds => voorraad; contanten; geldmiddelen
parade => optocht; prijken; pronken; pralen; pralerij; samenscholing; defilé; appèl
air => lucht; luchten; wijsje; ventileren; uitzenden; melodie; verluchten; voorkomen; uiterlijk
just => net; rechtvaardig; slechts; billijk; maar; enkel; pas; precies
officials => ambtenaren
savage => wild; barbaars; woest; wilde; onbeschaafd; onbeschoft; barbaar; wreed; primitief; gruwelijk
ash => es; essenhout; stof; Essen
thursday => donderdag
terror => verschrikking; schrik; schrikbewind; ontzetting; angst; paniek; schrikkelijkheid; vrees; bezorgdheid
syria => Doordraaien
warhead => springkop; kop; Springkop
earth => grond; land; begraven; bodem; aardbol; aanaarden; aardbodem; aardrijk
conceivable => denkbaar; bestaanbaar; haalbaar; mogelijk; geloofwaardig; begrijpelijk
fixed => vast; onbeweeglijk; star; strak; afgesproken; bepaald; bepalend; geregeld; ingesteld; stationair
intended => bedoeld; bewust; doelbewust; expres; intentioneel; moedwillig; opzettelijk; voorbedacht; welbewust; weloverwogen
joint => gewricht; gezamenlijk; stickie; gemeenschappelijk; nor; geleding; gelid; knoop; bak
justice => gerechtigheid; rechtvaardigheid; recht; billijkheid; berechting; gerecht; rechtsbedeling; raadsheer; rechtspleging
soon => spoedig; binnenkort; gauw; weldra; dra; alras; haast; straks; eerlang; eerstdaags
must => behoren; dienen; horen; zullen; behoeven; schimmel; hebben
serious => ernstig; belangrijk; erg; bedenkelijk; voornaam; zorgwekkend; zwaar; angstig; bang
intend => van plan zijn; bedoelen; beogen; mikken; mikken op; rooien; ten doel hebben; voorhebben; voornemens zijn; zich voorstellen
length => langdurigheid; afstand; duur; stuk; tijdsduur; eind; grootte; lengtemaat; overmaat
unto => tot; naar; tot aan
clash => conflict; botsing; botsen; schermutseling; tegenstrijdigheid; strijd; confrontatie; schok; stoot; treffen
armored => gepantserd; beveiligd
forces => krachten
crush => verpletteren; vermalen; pletten; vermorzelen; malen; fijnstampen; verbrijzelen; toeloop; bevlieging; dranghek
adding => toe te voegen
beloved => beminde; lief; bemind; dierbaar; welbemind; liefste; duur; geacht
service => dienst; bediening; eredienst; godsdienstoefening; kerkdienst; opslag; ambt; baan
antarctic => Zuidpool
once => eens; eenmaal; ooit; op een keer; zodra; één keer; een keer; eenmaaal; van zodra; wanneer
quarter => wijk; buurt; vierde; stadswijk; trimester
unlike => verschillend; anders; anders dan; heterogeen; in tegenstelling tot; uiteenlopend
capture => vangen; beetkrijgen; pakken; bemachtigen; beetnemen; veroveren; buit; vangst; vatten; gevangennemen
weapons => bewapening
epic => epos; heldendicht; heldhaftig; heldengedicht; verhalend
possession => bezit; bezitting; eigendom; goed; bezetenheid; bezittingen; vermogen
shed => schuur; loods; vergieten; storten; afwerpen; afdak; luifel; werpen; gieten; keet
staff => notenbalk; personeel; balk; medewerkers; stok; paal; baar; pijp; roede
charred => verbrand; verschroeid
ravage => afstropen; uitschudden; verwoesten; verwoesting; plundering; teisteren; plunderen; ruïneren; vernielen
viscera => ingevolgewanden; ingewand; ingewanden
amassed => vergaard
final => definitief; laatste; uiteindelijk; eindexamen; eindronde; ultiem; onherroepelijk; vast
under => beneden; onderdoor; volgens; blijkens; krachtens; minder dan
cry => huilen; wenen; schreeuwen; schreeuw; roepen; kreet; roep; krijten; gillen
citizens => burgers
become => worden; raken; gebeuren; goed staan; passen; toegaan; voortgang hebben; zich schikken; betamen; goed zitten
lasting => blijvend; aanhoudend; bestendig; gedurig; voortdurend; constant; continu; onafgebroken; onophoudelijk; vast
do => maken; bedrijven; fuif; gaan; genoegen; goeddoen; bakken
unleashed => losgelaten
desk => bureau; lessenaar; schrijftafel; schrijfberd; lezenaar; schrijfbureau; balie; tafel; buro; advocatenkantoor
fact => feit; werkelijkheid; Feit
aside => opzij; terzijde; zijwaarts
got => gekregen
bus => autobus; de; met; afruimen; vervoeren; reizen; autocar; stadsbus
really => werkelijk; echt; wezenlijk; waarlijk; waarachtig; inderdaad; heus; naar waarheid; eigenlijk; daadwerkelijk
eye => oog; kijker; bekijken; observeren; gadeslaan; in het oog houden; nakijken; gezichtsorgaan; naaldoog; oculus
get => behalen; aankomen; raken; kopen; buit maken; buitmaken; doorkomen; inhalen; inslaan; klaarspelen
working => moeite; poging; bebouwing; bediening; bedrijf; beschaving; bouw; cultuur
o => te; mede; ook
him => aan hem; naar hem; aan ’m; haar; naar ’m; ’ie; ’m
news => nieuwigheid; journaal; bericht; nieuwsberichten; actualiteiten; iets actueels; tijding
individually => achtereen; achterelkaar; afzonderlijk
ignored => buiten beschouwing gelaten
dies => doodgaan
devastated => verwoest
almost => bijna; vrijwel; bijkans; haast; nagenoeg; zo goed als; schier; zowat; welhaast; amper
think => menen; geloven; achten; van mening zijn; beschouwen; vermoeden
new => vers; opkomend; ander; jong; weer; apart; kersvers
going => stap; gang
coworkers => collega's
invited => uitgenodigd
struggling => worstelen
bat => vleermuis; slaghout; knuppel; kolf; racket; slaan; vleermuizen
hard => moeilijk; zwaar; straf; sterk; kalkrijk; onweerlegbaar; inspannend; lastig
whether => of; hetzij; of .. of; hè
press => pers; drukken; aandrukken; persen; knellen; urgent zijn; dringen; drukpers; haasten; jachten
care => zorg; zorgen; verzorging; bezorgd zijn; zorgvuldigheid; bekommernis; kommer; verzorgen; zich bekommeren; verpleging
explaining => uitleggen
way => manier; wijze; gewoonte; baan; gebruik; usance; afstand; route; methode
leaving => afscheid; afreis; overlijden
fallon => vallen op
representative => vertegenwoordiger; afgevaardigde; gedeputeerde; gedelegeerde; zaakbezorger; zaakwaarnemer; exponent; makelaar; plaatsvervanger
hit => kloppen; klappen; houwen; halen; inslaan; teisteren; furore; opvallen; succes; treffer
group => groeperen; groepering; verzameling; stel; hoop; schare; kudde; school
chair => stoel; zetel; leerstoel; voorzitterschap; crapaud; fauteuil; keukenstoel; kinderstoel; klapstoel; kuipstoel
send => verzenden; sturen; opsturen; doen toekomen; expediëren; uitzenden; versturen
ripple => kabbelen; rimpeling
decision => besluit; uitspraak; verdict; wijzing; beslistheid; arrest; uitslag; Europees besluit; conclusie
pretty => mooi; aardig; nogal; beminnelijk; vriendelijk; lief; tamelijk; leuk; keurig; knap
unsure => onzeker
inform => inlichten; voorlichten; meedelen; berichten; verwittigen; mededelen; verklikken; aankondigen; in kennis stellen
didn => jonathan bourdon
assure => verzekeren; betuigen; beveiligen; geruststellen; afzekeren; waarborgen; uitvoeren; behoeden; beloven
maybe => misschien; mogelijk; mogelijkerwijs; wellicht; het zou kunnen; soms
away => weg; verwijderd; heen; over; vandoor; voort; afwezig; dada; exit; foetsie
knew => kende; wist; wisten
reportedly => naar verluidt
miss => juffrouw; mislopen; misgrijpen; kijken; mislukking; niet; ontwijken; snappen
job => baan; werk; taak; betrekking; karwei; arbeid; beroep; ambt; werkkring
email => e-mailbericht; elektronische post; bericht sturen
goodbye => dag; tot ziens; doei; houdoe; adieu; vaarwel; goedendag; tot weerziens; afscheid; afscheids-
here => heden; hier en nu; domicilie; huis; verblijf
opportunity => kans; gelegenheid; mogelijkheid; gebeuren; gebeurtenis; incident; geval; voorval; geluk
his => zijn; de zijne; het zijne; aan hem; haar; diens; d’r; hare; het hare
local => plaatselijk; stamkroeg; lokale trein; plaatselijke bewoner; stamcafé; stoptrein; alhier; aanstaand
want => willen; verlangen; begeerte; lust; wens; zin; tekort; behoefte; gebrek
sales => uitverkoop; verkoop; afzet; inkoopactie; distributie; koopovereenkomst; omzet; verkopen
same => hetzelfde; dezelfde; identiek; dito; gelijk; zelfde; -zelfde; datzelfde; eender; op dezelfde wijze
feels => voelt
imagination => verbeelding; verbeeldingskracht; inbeelding; fantasie; voorstelling; voorstellingsvermogen; droomgezicht
mining => mijnbouw; mijnarbeid
suspects => verdachten
don => aantrekken; zich; maffiabaas; uitdossen; prof; professor; aandoen
trust => vertrouwen; geloof; fiducie hebben in; toevertrouwen; fiducie; vertrouwen hebben in; afgaan op; vertrouwen op; vertrouwen stellen in
tell => vertellen; zeggen; opgeven; voorschrijven; verhalen; bevelen; gelasten; debiteren; opdragen
company => bedrijf; gezelschap; firma; zaak; maatschappij; vennootschap; bezoek; bezoekers; handelsfirma
spitting => spugen
suppose => veronderstellen; aannemen; vermoeden; stellen; menen; gissen; denken; geloven; inbeelden
face => gezicht; aangezicht; gelaat; zijde; gelaatsuitdrukking; bakkes; de confrontatie aangaan met; mee afrekenen; onder ogen zien; tegemoet gaan
ask => vragen; verzoeken; eisen; aanvragen; inroepen; bestellen; vereisen; vergen; verlangen; opeisen
awkward => onhandig; genant; ongemakkelijk; onbeholpen; log; pijnlijk; plomp; lastig; penibel; stumperig
ranged => varieerden
sure => zeker; stellig; vast; gewis; wis; verzekerd; vaststaand; veilig; jazeker; ongetwijfeld
hours => uur
massive => massaal; enorm; gigantisch; grootscheeps; sterk; stevig; zwaar; geweldig; immens
dozens => tientallen
anymore => niet meer; langer; meer
operative => werkzaam; arbeider; werker; werkkracht; werkman; werkmier; agent; bedrijver; dealer; politieagent
changed => veranderd
mean => betekenen; bedoelen; gemiddelde; menen; gemiddeld; van plan zijn; willen zeggen; boosaardig; willen
telling => indrukwekkend; krachtig
office => kantoor; bureau; dienst; ambt; betrekking; plaats; baan; werkkring; overheidsdienst; bureel
noting => opmerkend
considering => gezien; aangezien
recent => vers; fris; luchtig; onbedorven; laatst; nieuw; jongste; juist gebeurd; van jonge datum
occasional => toevallig; gelegenheids-; af en toe; nu en dan; indicenteel; incidenteel; dungezaaid; gelegenheids‐
whistleblower => klokkenluider
old => bejaard; vergevorderd; antiek; ouderwets; aftands; aloud; bouwvallig; gammel; oudheid
highly => hoog; zeer; hoogst; hogelijk; in hoge mate; uitermate; buitengewoon; erg; heel
scope => bereik; domein; reikwijdte; omvang; bestek; grootte; strekking; terrein; uitgebreidheid
recently => onlangs; laatst; de laatste tijd; kort geleden; overlaatst; kortelings; kortgeleden
reveal => onthullen; openbaren; afkondigen; kenbaar maken; openbaar maken; publiceren; ruchtbaar maken; ontwikkelen; loslaten; aandienen
seems => lijkt
something => iets; ergens; wat; aanblaffen; aangelegenheid; aansprakelijk; affaire; ding; een duister beeld schetsen; een somber beeld schetsen
unethical => immoreel; infaam; laaghartig; oneerlijk; oneervol; ongehoord; onzedelijk; schandelijk; verdorven; voos
conspicuously => opvallend
did => deden; gedaan
directly => meteen; dadelijk; rechtstreeks; zo; rechtuit; aanstonds; rechtop; eerlijk; zodadelijk
blow => blazen; waaien; slag; ontploffen; springen; klap; mep; pijpen; tegenslag; spuiten
avoiding => vermijden
business => zaken; zaak; bedrijf; vak; klandizie; onderneming; zakenleven; aangelegenheid; ding
honestly => eerlijk; oprecht; behoorlijk; echt; eigenlijk; exact; fatsoenlijk; gevoeglijk; innig; juist
vibe => vibraties
coldness => kou; koude; onverschilligheid; koud; frigiditeit
contact => aanraking; aanraken; contact hebben met; voeling; contact maken met; Omgangsrecht
unusually => ongewoon; ongebruikelijk; abnormaal; afwijkend; onregelmatig; apart
incident => voorval; gebeurtenis; gebeuren; episode; inslaand; bijkomstig; geval; invals-
happy => gelukkig; blij; tevreden; zegenrijk; verheugd; vrolijk; bedreven; handig; kundig; verblijd
pissed => dronken; teut; beneveld; beschonken; bezopen; kachel; zat
authorities => overheid
couple => paar; stel; duo; tweetal; echtelieden; echtpaar; span; paren
me => mij; ik; mijn; m'n; aan me; aan mij; naar me; naar mij; mezelf
operation => bewerking; ingreep; handeling; exploitatie; verrichting; werking; bediening; bedrijf; behandeling
leadership => voorzitterschap; leiding
d => D
case => naamval; geval; kist; zaak; aangelegenheid; casus; doos; proces; rechtszaak
acted => gehandeld
superior => meerdere; prevalent; opperste; baas; chef; aanvoerder; bovenste; voortreffelijk; beter
promises => beloften
role => functie; taak; sociale rol; ambt; hoedanigheid; verantwoordelijkheid; personage; hoofdrol; plicht
points => wissel
look => kijken; uiterlijk; uitzien; blik; uitzicht; bekijken; verschijning; kijk; schijn
juicy => sappig; smeuïg; pittig; smakelijk
alarm => beangstigen; alarm slaan; wekker; alarmsignaal; verontrusten; ontsteltenis; verbijstering; alarmklok
spying => spionage; spioneren
private => besloten; particulier; persoonlijk; onderhands; ambteloos; soldaat; eigen
federal => bonds-
reflected => réfléchi; weloverwogen
conversation => gesprek; onderhoud; bespreking; discussie; dialoog; grapjasserij; scherts
chili => chilipeper; paprika; Spaanse peper; rode peper
quite => tamelijk; nogal; volkomen; vrij; bijster; erg; heel; bijzonder; geheel; helemaal
district => wijk; gebied; buurt; gouw; regio; arrondissement; stadswijk; kanton; departement
code => wetboek; programmeren; cijfer; geheimschrift; sleutel; cijferschrift; geheimtaal; reglement
book => reserveren; album; noteren; te boek stellen; vlammen; bespreken; bestellen
day => etmaal; heden; vandaag; zon; daglicht
enforcement => handhaving; Handhaving; dwang; gebruik; toepassing
someone => iemand; een of ander; een of andere; enig; deze of gene; persoon; aanblaffen; een duister beeld schetsen; een somber beeld schetsen; van
john => hoerenloper; latrine; prostituant; privaat; toilet; wc
brushing => borstelen
fears => angsten
biggest => grootst
childhood => kinderjaren; kindsheid; kindertijd; jeugd; kinderachtigheid; kind; aanvang
revelations => onthullingen
album => gedenkboek; muziekalbum; plaat; fotoalbum
believes => gelooft
successful => geslaagd; gelukt; voorspoedig; efficiënt; gelukkig; met goed gevolg
anything => iets; alles; wat dan ook
controversial => omstreden; betwist; kwestieus; aanvechtbaar; bedenkelijk; dubieus; twijfelachtig; verdacht; polemisch
offer => aanbieden; aanbod; presenteren; voorstellen; bod; aanbieding; aanzoek; indienen; vertonen
inappropriately => ongepast
chapters => hoofdstukken
truth => waarheid; waarachtigheid; werkelijkheid; eerlijkheid; oprechtheid; echtheid; eed; nauwkeurigheid; bewijs
sees => ziet
temple => slaap; bedehuis; godshuis; kerk; kerkgebouw; poot; brilmontuur; brilveer; moskee
split => kloven; klieven; verdelen; spagaat; doorklieven; grand écart
name => benoemen; benaming; naamwoord; roep; kiezen; aanstellen; opnoemen; vermelden
lies => leugens
wrong => verkeerd; fout; onjuist; slecht; mis; foutief; kwaad; onrecht; aandoen; benadelen
beef => rundvlees; biefstuk; klapstuk; donderjagen; emmeren; kankeren; katten; meieren; mopperen
muslim => mohammedaan
election => verkiezing; keuze; optie; keus; keur; stemming; ballotage; kies-
recipe => bereidingswijze; inkomen; ontvangst; ontvangstkamer; opbrengst; procédé; verdienste; werkwijze
clerk => kantoorbediende; bediende; schrijver; secretaris; winkelbediende; commies; kantoorklerk; actuaris; griffier
adolescence => puberteit; jeugd; jongelingsjaren; jongere
teeth => gebit; tanden; tand
distracted => afgetrokken; verstrooid; dol; krankzinnig; radeloos; uitzinnig; verbijsterd; verward
walker => wandelaar; voetganger; looprek; loper; rollator; Rollator
presidency => college van bestuur; praesidium; voorzitterschap
stone => pit; aarden; rots; van klei; pion; stuk
mirror => spiegel; afspiegelen; weerspiegelen; speigel; spiegelen; toonbeeld; weerkaatsen; weerspiegeling; bedenken
broth => bouillon; bouillonsoep; vleesnat; consommé; soep
famous => beroemd; befaamd; alom bekend; vermaard; wijdvermaard; gevierd; roemrijk; gerenommeerd; glorierijk; roemruchtig
trump => troef; overtroeven; aftroeven; troeven; mondharmonica; Troef; mondharp
director => regisseur; bestuurder; leider; administrateur; beheerder; chef; hoofd; zetbaas
fucking => kanker; kut; neuken
details => gegevens
purple => paars; violet; magenta; pimpelpaars; lila; purperrood; violetkleurig
expect => verwachten; wachten; te wachten staan; afhalen; rekenen; anticiperen; verbeiden; afwachten; bedacht zijn op; denken
former => voormalig; eerstgenoemde; verleden; deze; voorafgaand; voorgaand; gewezen; toenmalig; vorig
records => archief; administratie
judge => oordelen; rechter; beoordelen; schatten; achten; beoordelaar; berechten; taxeren; achting hebben voor; begroten
law => wet; recht; theorema; decreet; politie; rechtspleging; regel; regeling; smeris; wetgeving
inside => binnen; in; binnenkant; te; per; binnenin; aan; daarbinnen; inwendig; binnenste
loyalty => trouw; oprechtheid; aanhankelijkheid; eerlijkheid; getrouwheid
shut => dichtdoen; dichtmaken; toedoen; afsluiten; dichtklappen; dicht; gesloten; toe; op slot doen
pull => trekken; ruk; rukken; trek; slepen; naar zich toe halen; voorttrekken; aantrekkingskracht; haal
visiting => bezoekende
try => proberen; uitproberen; trachten; pogen; beproeven; poging; streven; toetsen; zich inspannen; berechten
itinerary => routebeschrijving; reisgids; route; weg; wegbeschrijving; reisverslag; reisplan; tracé; koers; reisbeschrijving
bartenders => barmannen
piece => stuk; onderdeel; deel; brok; fragment; stukje; eindje; gedeelte; pion; bonk
sad => triest; verdrietig; treurig; bedroefd; droevig; droef; triestig; verdrietelijk; somber; bedroevend
three => drietal; gedrieën
sock => kous; mep; raken; smijten
seem => lijken; schijnen; overkomen; toeschijnen; voorkomen; dunken; er uitzien; het uiterlijk hebben van
copy => kopiëren; nabootsen; nadoen; afschrift; exemplaar; imiteren; nabootsing; naäpen
leave => afreizen; zich verwijderen; loslaten; op reis gaan; toelaten; overlaten; vrijaf; in de steek laten; uitgaan; uitlopen
boater => strohoed; strooien hoed
up => omhoog; opwaarts; naar boven; aan; bereid; beschikbaar; klaar; langs; mee
prefer => verkiezen; voorkeur geven; de voorkeur geven aan; liever hebben; voortrekken; meer houden van; opteren; begunstigen; bevorderen
straw => rietje; strohuls; strooien
spouse => echtgenoot; eega; gade; echtgenote; man; gemaal; vrouw; wederhelft; eegade; ga
neck => hals; flessenhals; wurgen; baarmoederhals; bottleneck; landengte; nikker; worgen
traveling => op reis
travel => reizen; reis; rijden; gaan; varen; karren; lopen; bereizen; verplaatsen; verlopen
trip => reis; struikelen; tocht; toer; uitstapje; uitstap; excursie; fout; tocht trip
thing => voorwerp; object; onderwerp; lijdend voorwerp; mikpunt; punt; zaak; schepsel
identify => vereenzelvigen; determineren; herkennen; onderkennen; beleggen; erkennen; houden; leggen; plaatsen
solo => alleen; een solo spelen
crane => kraanvogel; hijskraan; lift; bok; hevel; kraanvogels
terrible => vreselijk; verschrikkelijk; ijselijk; afschuwelijk; schrikaanjagend; vervaarlijk; ontzettend; schrikwekkend; gruwelijk; erg
city => stad; grote stad; plaats; wereldstad; binnenstad; stadskern; centrum
letting => verhuur
grass => wiet; kruid; weiland; marihuana; grasmat; verklikker; weiden
extra => figurant; additioneel; aanvullend; supplementair; supplerend; toegevoegd; meer; nevenfiguur
feel => betasten; gewaarworden; tasten; aanvoelen; rieken; ruiken; geuren
re => betreft; wat; betreffende; opnieuw
yourself => zelf
give => schenken; overhandigen; verlenen; cadeau geven; opbrengen; toekennen; aangeven; doneren; aanreiken
things => spullen; spul; goedje; kledij; kleding; kleren
everywhere => overal; alom; wijd en zijd; allerwegen; overal waar; overall
experience => ervaring; beleven; belevenis; ervaren; ondervinden; ondervinding; meemaken; ondergaan; beleving; kennis
anyone => iemand; iedereen; wie; wie dan ook; een ieder; elkeen; wie ook
mustard => mosterdplant
believe => menen; denken; houden voor; geloven in; in; agnosceren; erkennen; honoreren
happen => gebeuren; geschieden; voorkomen; voorvallen; toegaan; overkomen; aan de hand zijn; voortgang hebben; worden; plaatsvinden
pay => betalen; uitbetalen; dokken; storten; loon; uitkeren; salaris; voldoen; bezoldigen; lonen
remind => herinneren; erop komen; reproduceren; terughalen; aanmanen; doen denken; doen denken aan
meeting => vergadering; bijeenkomst; samenkomst; ontmoeting; ontmoetingsplaats; beraad; overleg; treffen
sprig => takje; gard; roede; spitsroede; stokje; tak
onion => ui; ajuin; kop; ui m
putting => zetten
id => Es; Id; legitimatie; winde
suitcases => bagage
suit => pak; kostuum; set; stel; stelletje; kleur; zaak; complet; passen
throw => gooien; werpen; worp; smijten; keilen; uitspelen; afwerpen; gooi; kleien; omgooien
offers => aanbieden
obligated => verplicht
plaid => geruit; schotse ruit
died => gestorven
roller => rol; cilinder; scharrelaar; wals
make => doen; bedrijven; brengen; uitvoeren; vormen; bouwen; laten; uitbrengen
entertain => vermaken; amuseren; onderhouden; recipiëren; ontvangen; gastvrijheid verlenen aan; vrijhouden; koesteren; onthalen; afleiden
buildings => gebouwen
traipse => rondzwerven
gawking => gapen
never => nooit; helemaal niet
em => gedachtestreep; wit
again => opnieuw; weer; alweer; nogmaals; wederom; weder; van voren af aan; ook al weer; terug; verder
rewarding => bevredigend; dankbaar; de moeite waard
trail => spoor; pad; karrespoor; wagenspoor; route; afdruk; voetspoor; slepen; sliert; staart
off => uit; weg; af; heen; over; vandoor; verwijderd; voort; naast; nabij
family => gezin; huis; clan; huisgezin; stam; geslacht; huishouden; serie; bloedverwant
impression => indruk; effect; deuk; uitbeelding; verbeelding; voorkomen; afdruk; belichting; mening
mentally => geestelijk; intellectueel; psychisch
scene => toneel; tafereel; tableau; landschap; blik; schandaal; schouwtoneel; uitzicht
stand => kraam; opstaan; standplaats; verdragen; doorstaan; weerstaan; loods
event => gebeurtenis; voorval; gebeuren; gelegenheid; geval; incident; belangrijke gebeurtenis; gebeurde; episode
horrified => ontsteld
hangout => chillen
possibility => mogelijkheid; kans; gelegenheid; geluk; opportuniteit; toeval; contingentie; eventualiteit
encourages => moedigt
complex => ingewikkeld; samengesteld; geheel; samenstel
movies => bios; bioscoop
route => weg; tracé; baan; baanvlak; reisplan; leiden; traject; sturen; hoofdweg
absolute => onvermengd; volkomen; volstrekt; onvoorwaardelijk; onbetwistbaar; puur; rein; compleet; volledig
action => handeling; werking; daad; optreden; mechanisme; beweging; proces; strijd; geding
instilled => bijgebracht
felt => vilthoed
abuse => misbruik; misbruiken; mishandelen; mishandeling; uitschelden; verkrachten; belediging; beschimpen; beschimpingen; onteren
car => auto; wagen; automobiel; wagon; rijtuig; spoorwagen; voertuig; tram; bak
plays => toneelstukken
prevalence => overwicht; gangbaarheid
recognition => erkenning; herkenning; identificatie; Herkenning
aesthetic => schoonheidsleer
girl => meisje; meid; griet; grietje; meidje; meiske; mietje; vrouw; dochter
belief => overtuiging; vertrouwen; geloven; doctrine; dogma; fiducie; mening; opinie
cinematic => kinematografisch
suggest => voorstellen; aanwijzen; opperen; aangeven; aanduiden; een wenk geven; uitduiden; influisteren; kiezen
actor => toneelspeler; komediant; speler; actrice; toneelspeelster; agent; bedrijver; dealer
observation => waarneming; opmerking; aanmerking; standje; blaam; waarnemen; berisping; terechtwijzing; aandacht
admits => geeft toe
courageous => moedig; dapper; boud; kloek; koen; vermetel; ferm; onvervaard; stout; stoutmoedig
rapists => verkrachters
similarly => op dezelfde manier; gelijkend; als; desgelijks; evenals; evenzo; gelijk
then => vervolgens; toenmalig; toentertijd; daarop; destijds; trouwens; daarna; dus
cast => werpen; gieten; gooien; rolverdeling; afgietsel; rolbezetting; gips; uitgooien
relation => betrekking; verband; omgang; verhouding; opzicht; verkeer; verstandhouding; familielid; verhaal
experiences => ervaringen
sex => geslacht; vrijen; kunne; geslachtsgemeenschap; geslachtsdaad; geslachtsdeel
bold => moedig; vet; vetgedrukt; brutaal; dapper; stoutmoedig; gedurfd; stout; ferm; lijvig
series => reeks; set; ris; rist; opeenvolging; aaneenschakeling; collectie; rij
arises => ontstaat
men => heren; mannen; lieden; lui
itself => zelve; zich
prevalent => heersend; overheersend; dominant; dominerend; gezaghebbend; maatgevend; toonaangevend; courant; gangbaar
viewer => kijker; toeschouwer; weergaveprogramma
girls => meisjes
staging => enscenering; toneelschikking; mise-en-scène; regie; spelleiding; stellage; tribune
anthology => bloemlezing; chrestomathie
filmmaking => filmproductie
before => voor; eerder; vroeger; voordat; voorheen; vóór; alvorens; voordien; vooraleer; vooraf
en => En; gedachtestreep; hiëroglief
head => hoofd; kop; chef; leiden; leider; krop; baas; de weg wijzen; aanvoeren; geleiden
already => al; reeds; alvast; nu al; dan; een keer; eens
sort => aard; slag; rangschikken; geslacht; klasse; uitzoeken
talking => oratie; rede; redevoering; speech; spraak; spreken; vertoog; gepraat; praat; sprekend
boys => jongens
roommate => medebewoner; Wohngemeinschaft; kamergenoot; slapie; voordeurdeler
establish => oprichten; stichten; vaststellen; vestigen; bevestigen; constateren; inrichten; funderen; bouwen; baseren
documentary => actualiteiten; iets actueels
arrival => aankomst; komst; aanvoer; bezorging; bevoorrading; leverantie; levering; plaats van aankomst; proviandering; provisie
sophistication => verfijning
performance => voorstelling; optreden; opvoering; prestatie; spel; uitvoering; vervulling; opvoeren; vermogen
herself => zelf; vanzelf; zelve; zich
reënactment => het weer invoeren
raped => verkracht
framework => kader; lijst; geraamte; omlijsting; raam; bouw; samenstelling
shown => getoond
varied => verschillend; menigvoudig; menigvuldig; afwisselend; bont; divers; gemengd; veelsoortig
effort => inspanning; moeite; poging; worsteling; krachtsinspanning; arbeid; demarche; diplomatieke stap; inzet; prestatie
submerged => ondergedompeld
memories => herinneringen
card => speelkaart; troef; agenda; controleren; kaardplank; plan; schema
moment => ogenblik; tijdstip; oogwenk; tel; wijl; wip; stond; wijle
staged => geënsceneerd; geleidelijk; gradueel
dead => dood; gestorven; overleden; dode; doden; dodelijk; gestorvenen; overledenen; doods; bloed-
eight => achtste
depicted => afgebeeld
crude => ruw; grof; onbewerkt; primitief; bot; onbehouwen; naakt; onafgewerkt; ongeraffineerd
adolescent => puber; pubermeisje; tiener; jongvolwassene; puberaal; jongere; opgeschoten; opgroeiend
discusses => bespreekt
genre => soort; geslacht; aard; klasse; slag; woordgeslacht
misguided => misleid; misplaatst
slut => hoer; snol; lichtekooi; sloerie; stoephoer; publieke vrouw; del; slons; bitch
situation => stand; toestand; ligging; stand van zaken; plaats; houding; positie; kader; conditie
negotiate => onderhandelen; handeldrijven; handelen; zaken doen; handel drijven; sluiten; tot stand brengen; verhandelen
reflect => weerkaatsen; weerspiegelen; spiegelen; terugkaatsen; nadenken; afspiegelen; bedenken; beschouwen; overdenken
importance => belang; belangrijkheid; betekenis; gewicht; consequentie; kaliber; gewichtigheid; relevantie; baat
open => openmaken; opendoen; opengaan; aansnijden; breedvoerig; groot; omvangrijk; openhartig
precocious => vroegrijp; vroegvolwassen; voorlijk
industry => nijverheid; vlijt; ijver; sector; naarstigheid; werklust; bedrijfsleven; bedrijfstak; branche
evoke => oproepen; naar buiten roepen; ten gevolge hebben; uitlokken
merit => verdienste; waard zijn; toekomen; waardig zijn; autoriteit; beroemdheid; gezag; glorie; lof
falsification => vervalsen; vervalsing; vervorming
rapes => verkrachtingen
using => gebruik
artistically => kunstzinnig
actual => werkelijk; daadwerkelijk; feitelijk; effectief; eigenlijk; huidig; reëel; echt; wezenlijk
distortion => vervorming; verdraaien; Oversturing; deformatie; verdraaiing; verstuiking
mores => gebruik; zede; gewoonte; usance; gebruiken; gewoonten
longtime => lang; langdurig; lange tijd
making => fabricage; aanmaak; fabricatie; gedoe; vervaardiging; farad; formatie; vorming
carouse => zuipen
she => zij; ze; hij; haar; d’r; ’r; het; ik; jij; d'r
friend => vriendinnetje; medestander; maatje; bevriend zijn met; amice; geestverwant
light => aansteken; helder; schijn; schijnsel; aanmaken
reconstruction => wederopbouw; herstel; herstelling; herbouw
school => leerschool; universiteit; kunstrichting; africhten; leren; onderrichten; onderwijsinstelling
embedded => ingebed; vastgebetonneerd; verankerd; ingebouwd
immediately => onmiddellijk; meteen; dadelijk; direct; schielijk; zo; aanstonds; terstond; op staande voet; subiet
alike => soortgelijk; gelijksoortig; gelijkvormig; eender; hetzelfde; evenzeer; even; gelijkelijk
course => cursus; gang; baan; loop; route; leergang; gerecht; tracé
within => binnenin; binnen; in; per; te; aan; daarbinnen; innerlijk
next => volgend; naast; volgende; vervolgens; aanstaand; daarna; eerstkomend; aankomend; dan; eerstvolgend
society => maatschappij; samenleving; gezelschap; club; vereniging; gemeenschap; genootschap; kring; krans
curly => krullenbol; krullig; krullerig; gekruld; gekruld.; kroes; krullend
recovery => herstel; terugwinning; genezing; berging; behoud; heil; redding; uitkomst; uitredding; verlossing
expands => breidt uit
input => invoer; invoeren; ingeven; ingang; aandienen; aankondigen; adverteren; annonceren; bijdragen
feature => eigenschap; trek; bevatten; hoofdartikel; met; karaktertrek; benadrukken; laten; oplichten
standard => norm; banier; regel; vlag; maatstaf; vaandel; veldteken; vendel
expressed => uitgedrukt
extraordinarily => buitengewoon; bijzonder; uitzonderlijk
attack => aanval; aanvallen; aanslag; offensief; aangrijpen; aanvalszijde; aanranding; vlaag
looks => uitzicht; air; gelaatsuitdrukking; gezicht; mijne; uiterlijk
trouble => storen; moeilijkheid; hinderen; last; moeite; bezwaar; strubbeling; zorg; verstoren
talks => gesprekken
sets => verzamelingenleer
pregnant => zwanger; drachtig; in verwachting; betekenisvol; pregnant zwanger; veelbetekenend; zwanger worden
onscreen => op het scherm
scenes => coulissen
expressions => uitdrukkingen
living => levensonderhoud; levenswijze; bestaan; bestaand; in leven; inkomen
stole => Stola
reflection => afspiegeling; weerspiegeling; weerglans; weerkaatsing; weerbeeld; spiegelbeeld; terugkaatsing; beraad; bezinning
memory => geheugen; herinnering; aandenken; heugenis; gedachtenis; computergeheugen; nagedachtenis; herinneringsvermogen; opslagmedium
recover => genezen; herstellen; helen; beter worden; herkrijgen; terugwinnen; herwinnen; recupereren; terugkrijgen; terugvinden
ordeal => beproeving; kwelling; ontbering; bedroefdheid; droefheid; godsoordeel; hartzeer; pijn; tortuur; verdriet
kiss => kus; zoen; zoenen; kusje; copuleren; elkaar kussen; elkaar zoenen; naaien; neuken
appalling => ontzettend; ontstellend; verschrikkelijk; verbijsterend; afstotelijk; afzichtelijk; foeilelijk; ijselijk; schrikaanjagend; vervaarlijk
artistic => kunstzinnig; kunstig; kunstmatig; creatief
suddenly => plotseling; ineens; opeens; plots; plotsklaps; pardoes; eensklaps; abrupt
participate => deelnemen; meedoen; meemaken; deel hebben; deelhebben; delen
intimate => innig; vertrouwelijk; gezellig; knus; suggereren; laten doorschemeren; vertrouweling; sexueel; diepzinnig
image => beeld; afbeelding; plaat; voorstelling; prent; beeltenis; plaatje; figuur; beeldkopie
awareness => bewustzijn; besef; bezinning; bekendheid; kennis; wetenschap; zich bewust zijn van; bekende; gewaarwording; kennen
perform => verrichten; uitvoeren; opdagen; opdraven; te voorschijn komen; verschijnen; bedrijven; doen; spelen; optreden
turns => bochten
rapist => verkrachter; verkrachterin
apartment => flat; woning; vertrek; kwartier; logies; onderkomen
blend => mengen; mixen; vermengen; temperen; mengsel; verwarren; wassen; mix; doorlopen; fusie
simulated => artificieel; gekunsteld; gemaakt
consent => toestemmen; instemmen; instemming; toestemming; het eens zijn; goedvinden; toegeven; aannemen; accepteren; fiat
boy => jongen; knaap; jongens; kerel; mannen; huisboy; kerels; nikker; tsjongejonge
horror => verschrikking; gruwel; gruweldaad; afgrijzen; afschuw; zielsangst; afschrik; walging; weerzin; ontsteltenis
enacting => inleidend
classics => De klassieken
innovative => vernieuwend; apart; creatief; oorspronkelijk; origineel
responsibility => verantwoordelijkheid; verantwoording; aansprakelijkheid; toerekenbaarheid; plicht; congruentie; functie; gelijkluidendheid; rol; taak
resistance => weerstand; tegenstand; verzet; tegenweer; tegenkanting; tegengas; weerstandsvermogen; hostiliteit; elektrishe weerstand; ohmse weerstand
sexual => geslachtelijk; generatief; geslachts-
age => leeftijd; ouderdom; tijdperk; verouderen; era; tijd; generatie; oud worden; doen verouderen; oud doen worden
sought => gezocht
half => helft; halveren; deel; partij; semester; gedeeltelijk; partieel
challenged => uitgedaagd
woman => vrouw; mens; wijf; dame; vrouwelijk; juffrouw; mevrouw; vriendin; vrouwspersoon
set => stel; apparaat; inrichting; groep; hulpmiddelen; hoop; reeks; schare; troep; complet
authentically => echt
unfold => ontplooien; uitspreiden; afwikkelen; ontrollen; ontwarren; ontwikkelen; uitrollen; besmeren; doorsmeren
reality => werkelijkheid; feitelijkheid; waarheid; wezenheid; wezenlijkheid
endured => doorstaan
screen => beeldscherm; schut; afschermen; zaal; beschermen; doek; raster; rooster; beeldbuis
agreed => akkoord; afgesproken; in orde; goed; OK; okee; top; overeengekomen; accoord; eens
sardonic => cynisch; sarcastisch; bitter
overcome => overwinnen; verslaan; winnen; bevangen; overtreffen; zegevieren; afbreken; afhakken; afhouwen; afkappen
truths => waarheden
film => rolprent; laagje; vlies; fotorolletje; waas; bioscoop; cinematografie
sophisticated => geraffineerd; wereldwijs; geperfectioneerd; verfijnd; ontwikkeld; geavanceerd; subtiel; gecultiveerd
violence => geweld; geweldpleging; agressie; hevigheid; gewelddaad; gewelddadigheid; handtastelijkheid; heftigheid
remembered => zich herinnerd
blame => verwijten; beschuldigen; schuld; wijten; toeschrijven; beschuldiging; terechtwijzen; aangifte; aanklacht; aanrekenen
social => maatschappelijk; gezellig
date => dadel; datum; afspraak; afspraakje; rendez-vous; einde; tijdstip; dactylus
rape => verkrachten; verkrachting; koolzaad; schenden; ontvoering; roof; aanranding; raapzaad; aanranden
aware => bewust; welbewust; op de hoogte zijn; op zijn hoede; waakzaam; wakker
wide => breed; groot; ruim; uitgebreid; breedvoerig; royaal; uitgestrekt; omvangrijk; veelomvattend
throughout => overal; dwars door; door heel de; door heel het; het hele ... door; alom; door; door en door; gedurende; geheel
attacked => aangevallen
appropriation => toe-eigening; bestemming; toeëigening
acknowledge => erkennen; bekennen; toegeven; bevestigen; agnosceren; als waarheid aannemen; honoreren; bedanken voor; bekrachtigen; danken voor
archeology => oudheidkunde
camera => fototoestel; fotoapparaat; fotocamera; kiektoestel; filmcamera; televisiecamera; toestel
teen => adolescent; puber; jongvolwassene; jongere
proves => bewijst
viewers => audiëntie
themselves => zichzelf; henzelf; zich; zelf
technically => strikt genomen; technisch gesproken
adventure => riskeren; wagen; risico; lotgeval; perikel; belevenis; escapade; speculatie; voorval
viewing => opbaren; bezichtiging
afterward => daarna; naderhand; dan; vervolgens; bijgevolg; derhalve; dus; zodoende; aansluitend
performed => uitgevoerd
approach => benaderen; naderen; benadering; aanpak; aanvliegen; toegang; toenadering; aantocht; komst; laan
punctuated => doorspekt
clear => duidelijk; helder; verklaren; doorzichtig; verrekenen; doorschijnend; verduidelijken; vrijspreken
young => jeugdig; jongeren; jeugd; kind; aankomend; beginnend; onervaren; pril
moral => zedelijk; zedenkundig; strekking; zedenles; deugdelijk; deugdzaam; ethisch; ruggensteun
background => achter; achterkant; achterzijde; belevenis; context; ervaring; experiment; fond
dormitory => slaapzaal; slaapcel; slaapvertrek; studentenhuis
maturity => rijpheid; vervaldag; volwassenheid; geslachtsrijpheid; wasdom; betaaldatum; vervaldatum; vervaltijd
person => mens; snuiter; vent; kerel; knul; sujet; enkeling
arise => ontstaan; verrijzen; opstaan; rijzen; stijgen; worden; opkomen; geboren worden; ontluiken; opgaan
playing => spel; spelen
own => bezitten; eigen; rijk zijn; erop nahouden; hebben; toegeven; verslaan; afgezonderd; afzonderlijk; apart
bunch => bos; tros; bundel; groep; wis; bundelen; afdeling; bosje; detachement; groepering
ranging => variërend
responses => reacties
silent => stil; zwijgend; stilzwijgend; zwijgen; geluidloos; geruisloos; stom; gedempt; stil zijn; kalm
era => tijdperk; tijdrekening; periode; tijdsgewricht; jaartelling
borrowed => geleend
long => verlangen; lange tijd; langdurig; voor lange tijd; groot; hunkeren; langdurend; reikhalzen
place => oord; zetten; leggen; ruimte; lokaal; steken; zetel
eliciting => uitlokken
fiction => verbeelding; verdichtsel; verzinsel; bellettrie; bedenksel; roman; uitvinding; uitvindsel; vinding
movie => film; rolprent; speelfilm; bioscoopfilm; bioscoop; cinematografie; film ''m''; huidschilver; vel
student => leerling; scholier; beoefenaar; cursist; leerlinge
mind => geest; verstand; psyche; intellect; letten op; denkvermogen; toekijken; aandacht schenken aan; geheugen; passen op
nudity => naaktheid
dimension => afmeting; grootte; omvang; bestek; uitgebreidheid; maat; mate; afmetingen; coupe
spectators => toeschouwers
man => mens; heer; pion; vent; kerel; manspersoon; persoon; speelstuk
actress => actrice; toneelspeelster
together => samen; bijeen; tezamen; aaneen; ineen; bij elkaar; gemeenschappelijk; gezamenlijk; tesamen; gezamelijk
demands => eisen
josh => plagen
uneasy => onbehaaglijk; ongemakkelijk; ongerust; bang; beducht; bekommerd; bezorgd; druk; gejaagd; onrustig
room => kamer; ruimte; vertrek; zaal; bestek; lokaal; speling; wereldruim; plaats; oorzaak
blocked => afgesloten; afgezet; versperd; verstopt
justify => rechtvaardigen; uitlijnen; uitvullen; billijken; in het gelijk stellen; verdedigen; begenadigen; excuseren; goedpraten; motiveren
forced => gedwongen; gemaakt; onvrijwillig; gekunsteld
deeply => diepzinnig
owing => schuld; schuldig; verschuldigd
worried => bezorgd; ongerust; verontrust; angstig; bang; beducht; bekommerd; benauwd; druk; gejaagd
whose => wier; wiens; waarvan; van wie; wie d’r; wie z’n; welks; diens; waarom; waarover
screams => geschreeuw
title => kop; onderschrift; tituleren; eigendomsbewijs; eigendomsrecht; graad
whom => wie; aan wie; waaraan; die; waarbij
concealed => bedekt; cryptisch; cryptische; duister; obscuur; occult; verborgen; verstopt
falsely => vals; hypocriet; onjuist
entertainment => amusement; vermaak; aardigheid; pretje; vermakelijkheid; afleiding; ontspanning; schik; verstrooiing
women => vrouwen; vrouw
desire => verlangen; begeerte; wens; begeren; wensen; lust; zin; zucht; willen; trek hebben in
subsequent => volgend; nagekomen; aanstaand; achtereenvolgend; komend; spoedig; aankomend; daarop volgend; aansluitend
youth => jeugd; jeugdigheid; borst; jongeheer; jongeling; jongere; jongeren; adolescentie; jeugdig; jongelingsjaren
subject => onderwerp; onderdaan; stof; vak; onderwerpen; thema; onderdane; vakgebied; apropos
embody => belichamen; representeren; verpersoonlijken; vorm geven; inlijven; uitdrukken
mouthed => mond
ones => degenen
individual => enkeling; hoofdelijk; persoon; sujet; afzonderlijk; apart; afgescheiden
both => beide; allebei; allebeide; alletwee; alle twee de; zowel; en; zowel ... als ...
passive => lijdelijk; lijdend; inactief; inert; lijdende vorm; onbeweeglijk
destructive => verwoestend; verwoestende; vernietigend; vernielzuchtig; fataal
studio => atelier; filmmaatschappij; kunstschool; platenmaatschappij; werkplaats
too => ook; eveneens; evenzeer; mede; al te; te veel; te zeer; overdreven; tevens
secure => veilig; bevestigen; bepalen; fixeren; vastzetten; behouden; beveiligen; geborgen; vastmaken; verstevigen
among => tussen; onder; te midden van; midden; in het midden van; medio; middenin; aan; bij; op
frozen => koel
force => kracht; dwingen; macht; afdwingen; noodzaken; troep; sterkte; geweld; overweldigen
closeup => detailopname
happened => gebeurd
personal => eigen; lichamelijk; gezellig; innig; intiem; knus; persoonlijk voornaamwoord; vertrouwelijk
observers => waarnemers
version => uitvoering; vertaling; bewerking; uitleg; vertolking
seat => zitplaats; stoel; zitvlak; bril; zitting; plaats; zitmeubel; zit; bank
inquiry => enquête; vraag; onderzoek; analyse; kwestie; navraag; aanvraag; nasporing; exploratie
source => bron; wel; kwel; welput; oorsprong; fontein; herkomst; wortel; bronvoorziening; aanhalen
observations => waarnemingen
distinction => onderscheiding; verschil; onderscheid; aanzien; rang; befaamdheid; elegantie; voornaamheid
remarks => opmerkingen
start => beginnen; begin; aanvangen; aanvang; aanzetten; activeren; ontstaan; aanbreken
whispers => fluistert
separate => scheiden; afzonderlijk; afgezonderd; splitsen; delen; bijzonder; verdelen; gescheiden; opsplitsen; schiften
party => feest; fuif; feesten; aanhang; leden; viering; vieren; gevolg
simply => eenvoudigweg; slechts; alleen; eenvoudig; maar; enkel; domweg; gewoon; uitsluitend; gewoonweg
generation => geslacht; voortbrenging; voortplanting; Generaties van de materie; aanmaak; verwekking
fission => splitsing; splitsen; atoomsplitsing; deling; verdeling; Binaire deling
see => zien; aanschouwen; bekijken; begrijpen; ontmoeten; aantreffen; blikken; kijken; betreffen; raken
advisor => raadgever; mentor; raadsheer; administrateur; beheerder; bestuurder; consulent; directeur; verzorger
expendable => niet essentieel; niet noodzakelijk; nutteloos; onnodig; overbodig; overtollig; vervangbaar
good => lief; okee; verstandig; vriendelijk; wijs; braaf; aardig; dik
leader => aanvoerder; chef; baas; hoofd; aanvoerster; voorman
harrowing => verschrikkelijk; verstorend; vreselijk; beklagenswaardig; hartverscheurend; treurig
grinding => malen; maling; slijpen; vermalen
dried => droog
attacks => aanvallen
somewhere => ergens; ergens heen; hier of daar
mess => brij; puinhoop; zootje; moes; pap; zooi; mis; rommel; rotzooi; dienst
thin => mager; schraal; slank; sprietig; verdunnen; smal; schriel; karig
cult => eredienst; verering; sekte; verheerlijking; aanbidding
greasy => vet; vettig; dik; olieachtig; vuil
north => noordelijk; noordwaarts; stijgende; noordenwind
allies => Geallieerden; bondgenoot
human => menselijk; mens; Luchtpersoon; homo sapiens; mensachtige; mensenkind; persoon; sterveling
capable => bekwaam; kundig; competent; bedreven; behendig; deskundig; handig; vaardig; bevoegd
soot => rookzwart
commitment => verbintenis; engagement; verplichting; gevecht; inzet; toezegging
cut => snijden; maaien; afsnijden; doorsnijden; snerpen; snijwond; afnemen; afpakken; hakken; korten
layer => laag; aardlaag; legster; legkip; afleggen; aflegger; grondlaag; loot; marcotteren
consequences => gevolgen
numbers => tallen
ultimately => eindelijk; per saldo; ten slotte; uiteindelijk; ten laatste; tenslotte
wave => golf; baar; gebaren; onduleren; slingeren; wapperen; gulp; swingen
won => gewonnen
change => veranderen; verandering; wisselgeld; wijzigen; aanpassing; wisselen; wijziging; verwisselen; aanpassen; vervangen
dying => sterven; stervend
permanently => altijd; steeds; voorgoed; voortdurend; aldoor; altoos; bij voortduring; blijvend; immer
upcoming => aankomend; aanstaand; spoedig; volgend
geography => aardrijkskunde
appointed => aangesteld
admit => toegeven; toelaten; toestaan; bekennen; binnenlaten; erkennen; toegang verlenen; gedogen; aannemen; accepteren
hordes => menigte
regional => gewestelijk; streek-; streek‐
delays => vertragingen
posing => poseren
government => regering; overheid; bewind; bestuur; heerschappij; leiding; bestuursvorm; overheids-; politiek
remarkably => opmerkelijk; merkwaardig; eigenaardig; excellent; opmerkenswaardig
challenges => uitdagingen
acknowledging => erkennen
term => trimester; vakterm; voet; woord; periode; benaming; bepaling; conditie
despot => dwingeland; alleenheerser; dictator; onderdrukker; tiran; autocraat
goes => gaat
public => openbaar; openlijk; ruchtbaar; overheids-; staats-; algemeen; buitenwacht; generaal; openbaarheid
inevitably => onvermijdelijk; noodzakelijkerwijs
commit => bedrijven; begaan; plegen; toevertrouwen; toewijzen; vertrouwen; beleggen; besteden; investeren; toewijden
peninsula => schiereiland
security => veiligheid; beveiliging; onderpand; zekerheid; pand; borgstelling; waarborg; veiligheidsdienst; borg; effecten
invasion => inval; schending; agressie; binnendringen
meat => vlees; vleessoort; hansworst; lulvent; substantie; vlees op de botten; vruchtvlees; voedsel; kost; spijs
tens => tientallen
certainly => zeker; beslist; voorzeker; ongetwijfeld; wel degelijk; natuurlijk; bepaald; vast; en of; waarlijk
promised => beloofd; toegezegd
minutes => notulen; proces-verbaal; protocol; bekeuring; boete; geldboete; proces verbaal; proces‐verbaal; protokol
correctly => juist; goed; behoorlijk; eerlijk; eigenlijk; exact; fatsoenlijk; gevoeglijk; louter
south => zuiden; zuidelijk; zuid; zuidwaarts; naar het zuiden; Zuiden
personality => aard; karakter; geaardheid; identiteit; een groot man; figuur; inborst; notabele
unique => enig; alleen; speciaal; afzonderlijk; alleenstaand; eigenaardig; enige; individueel
warned => gewaarschuwd
newly => onlangs; opnieuw; pas; daarnet; daarstraks; exact; juist; net; precies
deposed => afgezette
pool => zwembad; vijver; bassin; zweminrichting; bekken; aansluiten; plas; zich aaneensluiten; zich verenigen
metoo => ik ook
lover => minnaar; minnares; geliefde; vrijster; vriendin; vrijer; beminde; lief; liefhebber; liefste
tail => staart; schaduwen; achterste; zitvlak; achtervolger; staartstuk; achtereinde; achterwerk; munt; beschatten
garner => graanschuur; oogsten; verzamelen; cumuleren; opeenhopen; opstapelen; aannemen; accepteren; collecteren; innen
slick => glad; glad maken; glibberig; handig; uitgeslapen
despondent => moedeloos; wanhopig; hopeloos; neergeslagen; mistroostig; desperaat; radeloos
host => gastheer; troep; gastgever; gastvrouw; heerschaar; leger; herbergier
waters => vruchtwater
cigarette => saffiaantje; peuk; tabak
imaginable => denkbaar; geloofwaardig
gargantuan => immens; enorm; reusachtig; gigantisch; kolossaal
looking => op zoek
water => water geven; begieten; sproeien; gieten; bevloeien; besproeien; waterhoudend
homer => postduif
video => film; televisie; televisieshow; videocassette
fog => mist; nevel; damp; floers; rook; sluier; stoom; verbergen; verduiken; verhullen
middle => middelbaar; centrum; doorsnee; middelmaat; middelpunt; hart
resignation => berusting; gelatenheid; aftreding; aftreden; uittreding; ontslag; overgave; afstand; afgetreden; dienstbeëindiging
ten => tientje; tiental
month => maand; m
triple => drievoudig; driedubbel; verdrievoudigen; drieledig
wrapped => verpakt
movement => beweging; zet; slag; stoelgang; deel; gang; omzet; opwelling; voortgang; defecatie
reliable => betrouwbaar; vertrouwd; zeker; zekerheid; getrouwe; geloofwaardig; degelijk; aannemelijk; behouden; beproefd
clichéd => afgezaagd; banaal
denied => ontkend
reasons => redenen
apologize => zich verontschuldigen; verantwoorden; verontschuldigen; excuseren; zich excuseren
exhaustion => uitputting; moeheid; lethargie; afmatting; aftrek; apathie; bedroefdheid; consternatie; dofheid; droefgeestigheid
beach => strand; stranden; kust; landen; wal; dalen; neerstrijken; oever; zandstrand; zwemplaats
major => groot; hoofdvak; meerderjarige; belangrijk; voornaamste; hoofd-; aanzienlijk; grote
visible => zichtbaar; zichtbare; zienlijk; waarneembaar; manifest
separated => gescheiden; afzonderlijk; apart; los; uiteengegaan
fitness => geschiktheid; fitheid; gepastheid
gone => verdwenen; weg; foetsie; afwezig; dada; heen; zoek
preserver => behoeder; beschermer; bewaarder
towelling => badstof
shooting => schietpartij; jacht; geschiet; salvo; schot; vuren
tattoo => tatoeëren; tatoeëring
carrying => belastend; geladen met; vervoer
blue => blauw; depressief; teneergeslagen; depressieve; groen; terneergeslagen; deerniswekkend; depri; deprimerend
frontier => grens; perk; landsgrens; Frontier (lijn); landgrens; grensgebied
below => onder; beneden; daarbeneden; eronder; daaronder; onderstaand; omlaag; onderX; onderaan; onderin
vanity => ijdelheid; nietigheid; frivoliteit; lichtzinnigheid; vruchteloosheid; wuftheid; absurditeit; arrogantie; eigendunk; hoogmoed
mocking => spotlustig; spottend; spotternij
himself => zelf; vanzelf; zich; zelve
garish => schreeuwlelijk; wansmakelijk; bont; opzichtig; schel
original => oorspronkelijk; vernieuwend; Oorspronkelijk; afkomstig; unicum; apart; oorsprong; aanvankelijk
screenplay => scenario; draaiboek; script
touch => aanraken; raken; beroeren; aanraking; roeren; aanslag; ontroeren; toucheren; voelen; aankomen
sound => geluid; klinken; klank; gaan; geluid maken; luiden; toon voortbrengen; kleppen; overgaan; toon
sympathy => medelijden; medegevoel; deelneming; erbarmen; compassie; mededogen; medeleven; deernis
lusty => ferm; flink; gezond; krachtig; stevig; vitaal; zwaarlijvig
considered => doordacht; bedachtzaam; weldoordacht; weloverwogen
running => administratie; administratiekantoor; beheer; bestuur; toediening; administratiegebouw; hardlopen; lopend; water; loop
marriage => huwelijk; echt; bruiloft; echtverbintenis; huwelijkse staat; huwelijksband; huwelijkssluiting; huwelijksvoltrekking; trouw; trouwerij
shaggy => harig; ruig; ruigharig; borstelig
batman => ordonnans; oppasser
insisted => aangedrongen
sadness => bedroefdheid; verdriet; droefheid; zieleleed; treurigheid; smart; mistroostigheid; somberheid; droefenis; beproeving
heart => kern; pit; liefde; ziel; koenheid; moed; vruchtbaarheid; cardiaal
since => sinds; aangezien; sedert; omdat; daar; vanaf; wijl; vermits; want; sindsdien
smoking => roken; nicotineverslaving
rags => lompen; Lompen
decades => tientallen jaren
gray => grijs; grauw; grijzen; grijze; schimmel; donker; somber
david => koning david
bless => zegenen; wijden; inzegenen; consacreren; inwijden; loven; verheerlijken
resulting => consequent
celebrity => beroemdheid; beroemd persoon; ster; filmster; roem; coryfee; grootheid; vedette; vermaardheid
spoke => spaak; sport; sprak; straal
denials => ontkenningen
seeming => ogenschijnlijk; schijn; schijnbaar
towel => handdoek; afdrogen; afdroogdoek; keukenrol; theedoek
interview => vraaggesprek; ondervraging; samenkomst; audiëntie; onderhoud
country => land; platteland; staat; open veld; plattelands; boeren-; land-; natie; actie
past => verleden; voorbij; verleden tijd; voorbije; afgelopen; verder; over; aan; achter; langs
appeared => opgedoemd
silence => stilzwijgen; rust; rustigheid; kalmte; zwijgen; stilte!; vergetelheid; antigeluid; bedaardheid
celebrities => beroemdheden
protected => beschermd; immuun
award => prijs; onderscheiding; toekennen; premie; bekroning; beloning; geven; uitspraak; gunning; toekenning
fair => rechtvaardig; beurs; kermis; eerlijk; billijk; mooi; redelijk; jaarmarkt; schappelijk
dipping => dompelen
winner => kampioen; overwinnaar; succes; welslagen
complete => volledig; voltooien; aanvullen; algeheel; afwerken; heel; volkomen; geheel; totaal
ourselves => zelf; onszelf; ons; wij
rumored => gekletst
alongside => naast; behalve; bezijden; aan de zijde van; met; aan; bij; binnen; dichtbij
rejection => afwijzing; verwerping; wraking; weigering; afkeuring; declinatie; afkeuren; afslaan; afslag; afwijzen
superman => übermensch; LSD; lyserginezuurdiëthylamide
breakup => scheiden; uiteengaan; vaneengaan; zich verspreiden; breuk
crimes => misdrijven
sat => gezeten
husband => echtgenoot; man; gemaal; eega; vrouw; gade; echtelieden; zuinig beheren
march => marcheren; lopen; tippelen; grensmark; mark; betoging; defilé; loop; Mark
groped => betast
waistband => gordel; ceintuur; band; broeksband; riem
activist => onruststoker; agitator; ophitser; twiststoker; stokebrand
plainly => duidelijk; eenvoudig; gewoonweg; simpel; bij uitstek; blijkbaar; botweg; gewoon; ronduit; zonder meer
shallow => ondiep; oppervlakkig; licht; ondiepte; wad; hol; laag; vluchtig; zandbank
fiancée => verloofde; bruid; meisje; aanstaande
told => verteld; vertelden
move => bewegen; verplaatsen; verhuizen; aangrijpen; ontroeren; verroeren; verhuizing; beweging; zet; roeren
romantic => dichterlijk; poëtisch
wake => wakker maken; wakker worden; kielzog; opwekken; dodenwake; zog; kielwater
enlightened => geciviliseerd; verlicht
rose => rozenstruik; rooskleurig; rozig; roosgekleurd; bleekrood; rosarium
success => voorspoed; geluk; welstand; bloei; welslagen; welvaart; welvarendheid; welgang; hit
virile => mannelijk
prankster => schavuit
post => paal; ambt; aanplakken; betrekking; plaats; posterijen; baan; op de post doen
behind => achter; achteraan; achterste; na; achterwerk; zitvlak; aan; over; achterkant; kont
images => afbeeldingen
scenario => draaiboek; script
publicly => openbaar; in het openbaar
popular => veelgeliefd; getapt; geliefd; volks; gewild; volk; in trek; algemeen; bemind
animatedly => geanimeerd
purebred => rasecht
marquee => luifel; lichtkrant; tent; luif
recalibration => herijking
beside => naast; bij; dichtbij; nabij; aan; behalve; op; ten huize van; binnen
camp => kamperen; legeren; bivak; legerkamp
multicolored => veelkleurig; bont; meerkleurig; bonte; veelkleurige; polychrome
bearded => gebaard
depends => hangt er van af
flatten => aandrukken; afvlakken; nivelleren; platstrijken; rechten; rechtmaken; rechttrekken
distance => afstand; eind; verte; verwijderen; end; verschiet; traject; tussenruimte
enormous => gigantisch; geweldig; kolossaal; reusachtig; ontzettend; afschuwelijk; astronomisch; ferm; immens
caricature => vertekenen; beeldverhaal; spotprent; strip
remaining => resterend; overig; verder; blijvend; over; rest; ander; resterende
recalling => herinnerend
flailing => zwaaiende
approached => benaderde
early => vroeg; vroegtijdig; tijdig; pril; bijtijds; matineus; spoedig; vroeger; weldra; op tijd
domesticated => huis-; huiselijk; huis‐
gut => darm; buik; ingewanden; uitbranden; uithalen; vernietigen; maag-darmstelsel; spijsverteringskanaal; abdomen; duodenum
silently => zwijgend; stil; stilletjes; geluidloos; kalm
academy => hogeschool; universiteit; genootschap; college; instituut
outward => eruit; naar buiten; uiterlijk; buiten-; buiten; uitwendig; zichtbaar
asked => gevraagd
exactly => precies; nauwgezet; accuraat; juist; eigenlijk; OK; nauwkeurig; net; okay
arouse => opwekken; wekken; opwinden; wakker maken; agiteren; ophitsen; opruien; opstoken; schudden; aanstoken
white => blank; blanke; blanco; zuiverheid; blankheid; bleek; doorzichtig; eiwit
swim => zwemmen; drijven; varen; overzwemmen; zwemmer
run => rennen; lopen; hollen; hardlopen; aanrijden; functioneren; in zijn werk gaan; voorrijden; vlucht; werken
shy => verlegen; bedeesd; timide; schuchter; schroomvallig; beschroomd; bevangen; blo; gooien; eenkennig
am => ben; zijn
aged => oud; bejaard; aftands; bouwvallig; gammel; uitgeleefd; uitgewoond; vergevorderd; wrak; hoogbejaard
surf => branding
red => rood; blozend; ros; rosse; kleur; blos; oranje; roodachtig; rossig
mock => bespotten; spotten; honen; imiteren; nadoen; namaak; naäpen; afgietsel; imitatie; namaak-
gossip => roddel; roddelen; kletsen; babbelen; kletspraatje; roddelaar; roddelaarster; kletspraat; zeveren; zwetsen
ex => Ex; ex-man; ex-vriend; ex-vriendin; ex-vrouw; gewezen; voormalig; vroeger
trunks => onderbroek; zwembroek; broek; kniebroek; korte broek
depressed => terneergeslagen; neerslachtig; somber; gedrukt; zwaarmoedig; depri; down; bedrukt
poignancy => felheid; guurheid; pikantheid; schelheid; scherpheid; scherpte; schrilheid; acuutheid; bitterheid; helderheid
magazine => tijdschrift; krant; blad; revue; periodiek; dagblad; courant; journaal
bird => vogel; griet; vogels; grootvaderlijk; babe; brok; kanjer; kist; shuttle; spetter
schadenfreude => leedvermaak; Leedvermaak
quick => snel; vlug; haastig; rap; gauw; spoedig; gezwind; levend vlees; ras
contrary => strijdig; tegengesteld; tegenstrijdig; tegendeel; tegenliggend; tegenstaand; dwars; recalcitrant; tegengestelde; eigenzinnig
ashes => as; resten
became => werd
height => hoogte; lengte; stand; hoogtepunt; Hoogte; lichaamslengte; top; toppunt; verhevenheid; kroon
pictures => afbeeldingen
exhausted => uitgeput; op; uitverkocht; afgemat; vermoeid; bekaf; doodmoe; afgepeigerd; doodop; gaar
eyes => ogen
kind => soort; aardig; vriendelijk; lief; aard; slag; type; voorkomend; beminnelijk; leuk
tv => televisie
forty => veertigtal
male => mannelijk; mannetje; jongen; masculien; mannetjesdier; mannetjesplant; mannelijk exemplaar; kerel; gast
amusement => vermaak; vertier; ontspanning; afleiding; schik; plezier; verzet; tijdverdrijf; vermakelijkheid
hometown => vaderstad; geboortestad
haunt => spoken; achtervolgen; kwellen; beklemmen; rondspoken; trefpunt; vervolgen; verblijven; wonen; bezoeken
stands => staat
prime => eerste; voornaamste; priemgetal; uitstekend; beste; primair
dryly => droog
protectively => beschermend
children => kind
comment => opmerking; commentaar leveren op; aantekening; annoteren; uitleg; kritiek; aanmerking
returned => teruggekeerd; terug
existence => bestaan; voorkomen; aanzijn; aanwezigheid; wezen; zijn
obscure => duister; onbekend; donker; onduidelijk; verborgen; onbegrijpelijk; ondoorzichtig; raadselachtig; verdoezelen
father => papa; vadertje; ouder; eerwaarde; ouders; pap; mijnheer pastoor; pappa
panic => in paniek raken; over zijn toeren raken; panikeren
fodder => veevoer; kanonnenvoer; foerage; beemd; kost
onetime => eenmaal; eens; één keer
crisis => breekpunt; keerpunt
fake => nep; vals; vervalsen; imiteren; voorwenden; nabootsen; nadoen; onecht; namaak
hunting => jacht; jagen
unfaithful => ontrouw; afvallig; trouweloos; dubbelhartig; verraderlijk
identification => legitimatiebewijs; identiteitsbewijs; herkenning; vereenzelving; vereenzelviging
wanderer => dwaler; zwermer; zwerver; landloper; nomade; vagebond; clochard
empty => leeg; leegmaken; legen; ledigen; ledig; hol; loos; lens; leeglopen; lenzen
loves => houdt
nanny => kinderjuffrouw; kindermeisje; Kinderjuffrouw; gouvernante; au pair
france => Frankrijk; frankrijk
mask => dekmantel; mom; bemantelen; bewimpelen; mombakkes; verbergen; verbloemen; camoufleren
story => verhaal; verdieping; etage; vertelling; vertelsel; geschiedenis; relaas; sprookje; verhaaltje
gaze => staren; turen; aanstaren; aanschouwen; blik; kijken
fall => herfst; najaar; ondergang; worden; neervallen; storten; dalen
late => wijlen; vergevorderd; dood; vorig; doodgegaan; gestorven
temporary => tijdelijk; voorlopig; voorbijgaand; van voorbijgaande aard; vergankelijk; ad interim; vooralsnog
dated => verouderd; achterhaald; ouderwets
meanness => gemeenheid; gierigheid; krenterigheid; laaghartigheid; laagheid; lelijkheid; schanddaad; schunnigheid; smeerlapperij; vuigheid
tends => neigt
brief => kort; bondig; kortstondig; beknopt; samengevat; kernachtig; summier; mandaat; samenvatting; breve
question => vraag; ondervragen; bestrijden; navraag; thema; twijfel; verhoren; motie; aanvechten
power => macht; kracht; vermogen; mogendheid; heerschappij; elektriciteit; grootmacht; sterkte; stroom; spanning
smiles => glimlacht
president => voorzitter; preses; praeses; directeur
lose => verliezen; kwijtraken; afvallen; verbeuren; opgeven; verspelen; vermageren; verslagen worden; missen; achterlopen
drops => druppels
myself => mij
ended => beëindigde
loosely => ruim; losjes; los
shaped => gevormd
branding => huisstijl
user => gebruiker; gebruikster; druggebruiker; verbruiker; gebruikersnaam
insert => invoegen; steken; indoen; inschuiven; instoppen; plaatsen; inbrengen
extraction => afkomst; uittreksel; onttrekking; winning; herkomst; uittrekken
academic => universitair; student; geleerde; abstract; hoogleraar; intellectueel; wetenschapper
duly => behoorlijk; fatsoenlijk; naar behoren; netjes; passend; eerlijk; eigenlijk; exact; gevoeglijk; juist
specially => in het bijzonder; inzonderheid; vooral; bijzonder; specifiek; bewust; expres; hoofdzakelijk; met opzet
holy => heilig; gewijd; sacraal; geheiligd; foutloos; perfect; volmaakt
patient => geduldig; zieke; lijdzaam; geduld; cliënt; geduldige
therapeutics => geneeswijze
apart => afzonderlijk; bijzonder; afgezonderd; terzijde; gescheiden; vaneen; los; afgescheiden; separaat
named => genaamd; heet
imagine => zich verbeelden; inbeelden; bedenken; zich voorstellen; fantaseren; raden; veronderstellen; speculeren; voorstellen; verbeelden
conditions => omstandigheden; voorwaarden
senses => bewustzijn; verstand
accidentally => toevallig; per ongeluk; toevalligerwijze; bij toeval; bij ongeluk; onverwachts; zonder opzet; bijkomstig
prepared => bereid; klaar; genegen; gereed; paraat; verdacht; voorbereid
spade => schop; schoppen; schup; graven; spitten; woelen; schuppen; schep
controlled => beheerst
growth => groei; toename; aangroei; aanwas; ontwikkeling; wasdom; gestalte; plantengroei; accres; gezwel
organization => ordening; inrichting; associatie; structuur; Semioverheid
understand => begrijpen; snappen; bevatten; beseffen; vatten; geloven; inzien; aannemen; nemen
parasite => klaploper; profiteur; woekerplant
suffers => lijdt
vaguely => vaag; onduidelijk; afwezig; duister; onbepaald; verstrooid
holding => bestel; bestuur; bewind; gedrag; heerschappij; manieren; onderhoud; regering
hot => heet; warm; geil; gloeiend; smoorheet; snikheet; lekker; pittig; pikant; porno
generate => verwekken; ontwikkelen; voortbrengen; opbrengen; aanmaken; opwekken
dermal => huid-
unrealistic => irreël
robot => automaat; verkeerslicht; automatisch
machine => apparaat; automobiel; automaat; toestel; werktuig; rijwiel; auto; draaibank
dream => mijmeren; hoop; droombeeld; fantaseren; dagdromen; ambiëren
effective => doeltreffend; werkzaam; afdoend; efficiënt; krachtig; werkdadig; werkelijk; actief; adequaat
hold => vasthouden; ruim; scheepsruim; bijhouden; bevatten; aanhouden; tegenhouden; macht; bekleden
market => afzetgebied; afzetmarkt; marktplaats; bazaar; beurs; jaarbeurs; kermis
bets => weddenschappen
grays => grijzen
collective => gemeenschappelijk; gezamenlijk; gemeenschappelijk wonen; verzamelnaam; gemeenschap
latent => verborgen; potentieel; sluimerend; slapend
slow => langzaam; traag; vertragen; ophouden; langzame; slome; achter; laat; afremmen
isolate => afzonderen; afscheiden; afsluiten
arteriosclerosis => aderverkalking; atheromatose
medication => geneesmiddel; artsenij; behandeling; geneeskunst
finding => vondst; uitspraak; toewijzing; het vinden
nod => knikken; knik; ja knikken; knikkebollen; wenk; doen schommelen; laten balanceren
george => joris
pluck => moed; doorzettingsvermogen; afbreken; kaalplukken; tokkelen
packed => overvol; afgeladen; stampvol
frenzy => razernij; waanzin; gekheid; uitzinnigheid; zinneloosheid; zinsverbijstering; aberratie; afwijking; extase
compared => vergeleken
doing => toedoen; werk; daad; handeling; bezig zijn; zeker
character => aard; teken; personage; persoonlijkheid; geaardheid; letter; merkteken; bewijs; blijk
thanks => bedankt; dank je; dankjewel; dankzegging; dank u wel; merci; dank betuigen
paw => poot; been; onderbeen; klauw; betasten; voet; pootje; hand; handschrift; krabben
confused => verward; in de war; onthutst; ontzet; paf; perplex; sprakeloos; verbijsterd; verbluft; verbouwereerd
interested => belangstellend; belanghebbend
efficacy => doeltreffendheid; werkzaamheid; uitwerking; rendement
crudely => grof; grofweg
above => over; bovenstaand; meer dan; ten noorden van; hierboven; bovenste; bovenvermeld; benoorden
sudden => plotseling; plotselinge; bruusk; plots; abrupt; onverwacht; onverhoeds; onverwachts; onvoorzien; kortaf
health => gezondheid; welzijn; status; gezond; gezondheidstoestand; gezondheidszorg
progress => vooruitgang; voortgang; vordering; vorderen; vooruitgaan; beterschap; verbetering; opschieten; vorderingen maken; veld winnen
rectangular => rechthoekig; rechthoekige
smiling => glimlach; lach
cursed => vervloekt; vermaledijd
ads => advertenties
caterpillar => rups; larve; rupsband; made; Rups
unabashed => onbeschaamd; schaamteloos
join => verenigen; samenvoegen; toetreden; verbinden; aansluiten; samenkomen; verbinding; bijeenbinden; bijeenbrengen; lid worden
definable => definieerbaar
building => gebouw; bouwwerk; constructie; bouw; bouwen; aanbouw; perceel; bouwsel; opbouw; aanleg
inchoate => embrionaal; beginnend; onvolledig gevormd; pas begonnen; rudimentair
tidy => proper; net; ordelijk; rein; opruimen; aardig; ruimen; inrichten; niet onbeduidend; regelen
unknown => onbekend; ongekend; ongeweten; onbekende; vreemd; duister; obscuur
dishes => afwas; servies; serviesgoed
founder => oprichter; stichter; grondlegger; zinken; kelderen; metaalgieter; mislukken; vergaan; verongelukken
kindness => vriendelijkheid; liefheid; voorkomendheid; aardigheid; goedheid; goedhartigheid; welwillendheid; begunstiging; bereidvaardigheid; genadigheid
splits => spagaat; grand écart
window => venster; raam; ruit; loket; interval; etalage; opening; vitrine; uitstalraam; Venster
balding => kalen
veteran => oudgediende; ervaren; oud-strijder
products => goederen; waar
famed => befaamd; beroemd; vermaard
mimic => nabootsen; kopiëren; imiteren; nadoen; namaken; afdrukken; naäpen; imitator; nabootsend; nabootser
casually => terloops; toevallig
pointed => spits; puntig; scherp; bijtend; doordringend; fel; guur; schel; schril; snerpend
international => extern; externe
curls => krullen; lokken
enzyme => ferment
anxiety => angst; bezorgdheid; ongerustheid; verlangen; spanning; zorg; vrees; agonie; bekommernis
issue => uitgeven; emitteren; kwestie; nummer; uitvaardigen; uitgang; afkondigen; nageslacht; proclameren; verkondigen
record => verslag; plaat; grammofoonplaat; schijf; register; vastleggen; opnemen; discus; registreren
youthful => jeugdig; jong
twice => tweemaal; twee keer; dubbel
developed => bezonken; ontwikkeld
minute => minuscuul; nietig; notulen; notuleren; nietige; onbeduidend; onbeduidende
destroyed => vernietigd
inundated => overspoeld
false => onwaar; fout; bedrieglijk; onecht; onjuist; loos; dubbelhartig; verkeerd; vervalst
exposed => naakt; blootgesteld; kwetsbaar; onbeschut; bloot; kaal
hummed => neuriede
brain => hersenen; hersens; verstand; intellect; de kop inslaan; denkvermogen; geestvermogen; genie; op z'n kop slaan
matures => rijpt
transplant => ent
bodies => lichamen
horrific => afschuwelijk; vreselijk; ontzettend; schrikwekkend; verschrikkelijk; gruwelijk; schrikbarend
roughly => grofweg; ongeveer; zowat; ruw; ruwweg; ruig; approximatief; omtrent; rond; bars
confided => toevertrouwd
easy => gemakkelijk; makkelijk; licht; vlot; eenvoudig; simpel; moeiteloos; bemiddeld; gegoed; gerust
becomes => wordt
befuddled => perplex; dronken; in de war; stomverbaasd; verdoofd; zat; onthutst; ontzet; paf; sprakeloos
century => eeuw; centennium
formed => gevormd
originally => oorspronkelijk; van oorsprong; indertijd; in het begin; op een nieuwe manier; aanvankelijk; afkomstig; allereerst; in eerste instantie
chin => chinchilla; kaak
handsome => knap; fijn; mooi; fraai; net; schoon; prachtig; aantrekkelijk; attractief; begeerlijk
opening => gat; mond; begin; première; vacature; aanhef; apertuur; bres; hiaat
hair => haardos; beharing; haren; pluis; wol; borstel; hoofdhaar; vacht
grow => groeien; wassen; kweken; aangroeien; stijgen; raken; gedijen; worden; gebeuren; toegaan
regeneration => gedaanteverwisseling; herschepping; metamorfose; vervorming; vernieuwing; wedergeboorte; herstel; aanpassing; adaptatie
consumer => verbruiker; gebruiker; afnemer
punctured => lek
writing => geschrift; schrijfsel; schrijven; schrift; schriftuur; handschrift; geschrijf; oeuvre; werk; schrijf-
needle => naald; wijzer; kompasnaald; speld; naaien; pesten; plagen; stangen; spuit; injectienaald
epidermis => opperhuid
declaration => verklaring; aangifte; bekendmaking; betuiging; uitspraak; assertie; exposé; uitroepen
assume => aannemen; veronderstellen; innemen; vermoeden; menen; stellen; aanvaarden; overnemen; ervan uitgaan; nemen
suite => gevolg; reeks; optocht; stoet
dog => hond; reu; Duna mi dolo di kabes; achternazitten; achtervolgen; kerel; klauw; mannetje; vent; vervolgen
odd => vreemd; raar; oneven; bizar; merkwaardig; eigenaardig; gek; wonderlijk; vreemdsoortig; bij benadering
phase => schijngestalte; kwartier; bouwfase; kapittel; stadium; faseren
week => wekelijks
develop => ontwikkelen; ontplooien; uitgroeien; zich ontwikkelen; maken; doen ontstaan; evolueren; formeren; ontwarren; uit elkaar halen
pathways => paden
forties => jaren 1940; jaren 40; jaren veertig; quarantaine; veertigtal
steel => staal; stalen; balein; harden; temperen; uithoudingsvermogen; Bourgondisch vuurstaal; hard maken; indompelen; indopen
historian => chroniqueur; kroniekschrijver; geschiedkundige; geschiedschrijver
ruthless => onbarmhartig; meedogenloos; medogenloos; halsstarrig; hard; hardvochtig; onbuigzaam; onmeedogend; star; volhoudend
drawbacks => nadelen
woke => ontwaakte; ontwaakten
inversely => omgekeerd
delightfully => heerlijk; verrukkelijk
remarkable => opmerkelijk; merkwaardig; opvallend; prominent; op de voorgrond tredend; uitstekend; vooruitstekend; bewonderenswaardig; bijtend
scrub => boenen; schrobben; kreupelhout; struikgewas; boender; schuren; stumper; wassen; afgelasten; afkrabben
neuroscientist => neurowetenschapper
meetings => vergaderingen
platelet => bloedplaatje
coast => kust; kustlijn; zeekust; zeekant; oever; kuststreek; glijbaan; boord; kant; kust-
promptly => stipt; accuraat; exact; gauw; hard; in allerijl; juist; nauwgezet; onmiddellijk
cream => crèmekleurig; zalf; vla; crème de la crème; crèmewit; puikje
technology => techniek
falling => val
provide => voorzien van; voorzien; bevoorraden; stijven; verschaffen; spekken; bezorgen; leveren; afleveren
units => eenheden; duizend; twaalf; twintig; zes
claim => opeisen; aanspraak; beweren; aanspraak maken op; bewering; eis; pretentie; vordering
inject => inspuiten; spuiten
followed => gevolgd
taken => genomen
cheap => goedkoop; betaalbaar; ordinair; schamel; waardeloos; afgeprijsd; in aanbieding; laagwaardig; onduur; voordelig
regenerate => inschrijven; intekenen; vernieuwen; wedergeboren
lost => verloren; kwijt; verdwaald; vervlogen; de weg kwijt; verdwenen; weg; bijster; foetsie; onthutst
shirt => overhemd; hemd; map; ordner; badpak; kiel; trui; windsel
elected => gekozen; uitgelezen; uitgezocht; uitverkoren; verkozen
texture => structuur; bouw; weefsel
favorite => geliefkoost; lievelings-; uitverkoren; lieveling; geliefkoosd; gunsteling; kanshebber
wants => afwachting; verwachting
indicating => wijzend op
developmental => ontwikkelingsstoornissen
entrancing => bekoorlijk; charmant
repeatedly => herhaaldelijk; meermaals; telkens; keer op keer; meermalen; aanhoudend
gravity => zwaartekracht; ernst; gewicht; zwaarte; aantrekkingskracht; diepte; gewichtigheid; impact
mocked => bespotten
disorder => wanorde; stoornis; janboel; rommel; rotzooi; kwaal; verwarring; ontregelen; puinhoop
slim => slank; afslanken; dun; vermageren; tenger; rank; aan de lijn doen; lijnen; diëten; mager
whipped => slagroom
cloning => het klonen
quest => zoektocht; speurtocht; speurwerk; streeftocht; onderzoek; zoeken; nasporing
unit => eenheid; afdeling; detachement; team; eendracht; groep; groepering; samenhang; toestel
physician => dokter; arts; geneesheer; medicus; doctor
east => oostelijk; oostwaarts; oriënt; naar het oosten; ten oosten
product => opbrengst; resultaat; gewrocht; reactieproduct; voortbrengsel; handelswaar; vrucht
quickly => gauw; vlug; snel; schielijk; in allerijl; spoedig; hard; gezwind; haastig; ras
refined => fijn; gevoelig; delicaat; iel; kies; teder; kieskeurig; tactvol; teer
unremarked => onopgemerkt
valley => dal; rivier; keteldal
ears => oren
dermatologist => huidarts; huidspecialist
female => vrouwelijk; vrouw; wijfje; vrouwtje; wijf; dame; moer; vrouwtjes-; feminien; juffrouw
ticked => aangevinkt
massage => manipuleren; vervalsen
majority => meerderheid; merendeel; meerderjarigheid; gros
stepped => getrapt
bumps => drempels
abundance => overvloed; onbekrompenheid; rijkdom; uitbundigheid; weligheid; menigte; bij de vleet; in overvloed
smiled => glimlachte
stomach => maag; buik; dulden; velen; verdragen; zin; abdomen; dragen; gedogen; harden
largely => grotendeels; ruimschoots; doorgaans; gemeenlijk; gewoonlijk; in het algemeen; over het algemeen; überhaupt; op grote schaal; gedeelte
root => wortel; stam; aanslaan; wortel schieten; machtswortel; radix; aanvuren; administrator; beheerder
doctors => artsen
works => fabriek; oeuvre; daden; metaalfabriek; bedrijf; mechanisme
demand => eisen; vraag; eis; opeisen; vereisen; vragen; verlangen; voorschrijven; verzoeken; rekenen
prisoners => gevangenen
form => formulier; aangaan; gedaante; stand; gestalte; klas
trial => beproeving; probeersel; proef; proces; rechtzaak; proefstuk; berechting; test; onderzoek
surgery => chirurgie; heelkunde; operatie; wondheelkunde; spreekkamer; ingreep; operatiekamer; bewerking
wearing => vermoeiend; vervelend
spare => ontzien; bezuinigen; uitsparen; uitwinnen; uitzuinigen; toegeeflijk zijn voor; zich laten vermurwen; extra
papilla => tepel
counter => balie; toonbank; aanrecht; teller; loket; stuk; tegen; tegengesteld; tegenmaatregel; tegenover
marked => een; op; merkbaar; opvallend; drukken; invloed; stempel; stempelen; uitoefenen; duidelijk
gang => bende; schare; troep; ploeg; compagnie; rot; stel; vendel
surly => bars; nors; honds; nurks; onaardig; onvriendelijk; knorrig; mistroostig; stuurs; zuur
destination => bestemming; doel-; doel; doelvoorziening; reisbestemming; reisdoel; toepassing; meet
proven => bewezen
use => gebruiken; gebruik; nut; toepassing; aanwenden; benutten; aanwending; functie; toepassen; genot
follicle => Kokervrucht; kokervrucht
peak => top; spits; tip; toppunt; hoogtepunt; neus; punt; topje; climax
medicine => geneeskunde; artsenij; geneesmiddel; medicament; medium; geneeskunst; medikament
administration => bestuur; beheer; toediening; bewind; regering; heerschappij; gouvernement; overheid
cancer => kreeft; kankergezwel; carcinoom; krab; mondkanker
meltdown => kernsmelting
anatomist => anatoom; ontleedkundige
twenties => jaren 1920; jaren 20; jaren twintig
bit => beetje; stuk; hapje; boortje; beting; brok; stukje; ietsje; snufje
hairs => haren
cord => touw; kabel; snaar; zeel; snoer; stemband; lijn; draad
main => hoofd-; voornaamste; hoofdzakelijk; belangrijkste; belangrijk; belangrijkst; hoofdzakelijke; voornaam; eerste; hoofdleiding
whisker => snor; baardhaar; bakkebaarden; ei zo na; op een haar na; bakkebaard; snorhaar
secretary => scriba; minister; schrijftafel; vertrouweling; beheerder
beautiful => mooi; schoon; fraai; fijn; aantrekkelijk; knap; prachtig; net; bekoorlijk; bevallig
procedure => werkwijze; bereidingswijze; methode; handelwijze; formaliteit; manier; gebeurtenis; gedrag
house => pand; geslacht; kamer; onderbrengen; onderkomen; familie; woning; herbergen; huisvesten
hairdresser => kapper; kapster; coiffeur; barbier; herenkapper
pattern => patroon; sjabloon; knippatroon; schablone; schema; model; tekening; staal; toonbeeld; voorbeeld
penetrate => doordringen; binnendringen; doorstoten; binnengaan; binnenkomen; binnenlopen; binnenvallen; doorgronden; doortrekken
usage => gebruik; gewoonte; zede; baan; aanwending; aanwensel; bediening; behandeling; benutting
sheath => huls; foedraal; terugtrekken; bladschede; condoom; in de schede steken; bezoldiging; etui; gage
workshop => werkplaats; atelier; garage; werklokaal
help => bijstaan; bijstand; assisteren; assistentie; ter zijde staan; baten; steun
perceive => waarnemen; bespeuren; bemerken; ontwaren; merken; in de smiezen krijgen; in het oog krijgen; gewaar worden; gewaarworden; vernemen
counsels => raadgevingen
therapy => behandeling; geneeswijze
having => scherp; zoet
understood => begrepen; verstaan; begreep
existing => bestaande; bestaand; aanwezig
scientists => wetenschappers
psychological => zielkundig
tiny => klein; minuscuul; piepklein; miniem; minuskuul; propperig; kleintje; diminutief; dwergachtig; fijne
involved => betrokken; ingewikkeld; gecompliceerd; geëngageerd
toupees => pruiken
drenched => doornat; doorweekt; drijfnat; kletsnat; poedelnat; zeiknat; doorweekte; kleddernat; nat
injuries => verwondingen
potent => machtig; krachtig; sterk; fiks; geducht; straf; zwaar; krukkenvair; invloedrijk
expired => verlopen; vervallen; afgelopen
bomber => bommenwerper
obsessed => bezeten; geobsedeerde; verdiept
fat => dik; corpulent; gezet; vetlaag; lijvig; vetmesten; zwaarlijvig; volslank; vettig
thick => dicht; gezet; gebonden; lijvig; dichtopeengepakt; dichtopeengepakte; gezette
belt => riem; gordel; ceintuur; omgorden; veiligheidsgordel; klap; broeksband; brullen; dreun; insnoeren
huge => enorm; gigantisch; reusachtig; kolossaal; geweldig; ontzaglijk; breedvoerig; royaal; groot; omvangrijk
scalp => kruin; hoofdhuid; scalperen; Kruin
caution => voorzichtigheid; waarschuwing; waarschuwen; omzichtigheid; voorzorg; manen; borg; borgsom; waarborg
god => godheid; afgod; idoliseren; verafgoden; godenbeeld; idool
attractive => aantrekkelijk; aanlokkelijk; bevallig; aanminnig; grappig; interessant; lekker; bekoorlijk; aardig
targeting => gericht op
lip => grote bek; grote mond; tegenspraak; onbeschaamdheid; rand; mompelen
done => klaar; gaar; afgelopen; afgewerkt; beëindigd; op; gebeuren
obsession => bezetenheid; fixatie; dwangvoorstelling; nachtmerrie
rich => rijk; vermogend; gefortuneerd; overvloedig; rijkelijk; ruim; machtig; uitbundig; volop; weelderig
podcast => podcastuitzending
paraffin => alkaan; kerosine
punched => geponst
topically => actueel; tegenwoordig; thematisch
commercial => reclamespot; advertentie; reclame spotje; reclameboodschap; handels-; zakelijk
always => altijd; steeds; immer; altoos; constant; almaar; alsmaar; continu; elke keer; iedere keer
rat => bruine rat; rioolrat; zwarte rat; muis; overloper; muizen en ratten van de Oude Wereld; gluiperd; rattus
newspaper => krant; dagblad; nieuwsblad; courant; blad; krantenpapier; gazet; tijdschrift; dagblad '' ''; magazine
shoot => vuren; paffen; doodschieten; spruit; uitloper; stik; loot; uitspruitsel
baldness => kaalheid; haaruitval; kaalhoofdigheid; alopecia androgenetica; alopecie
awe => ontzag; vrees; angst; eerbied; consternatie; ontsteltenis; respect; stupor; verbijstering; verslagenheid
doctor => arts; geneesheer; medicus; valsificeren; genezen; gezond maken; helen
plasma => bloedplasma
wood => hout; bos; houtsoort; bebossen; brandhout; houten; woudland; foreest; aangelegd bos
generic => algemeen; generiek product; gemeenschappelijk; geslachtelijk; gezamenlijk
bloody => stomme; verdomd
sites => plaatsen
discovered => ontdekt
grown => gegroeid; gekweekt; volwassene
bubbled => geborreld
cure => genezen; helen; remedie; behandelen; cureren; geneesmiddel; beter worden; genezing; herstellen
high => hoog; verheven; lang; hard; luid; groot; krachtig; opperst; sterk
mankind => mensheid; mensdom; mensengeslacht; mens; aard; geslacht; humaniteit; klasse; menselijkheid; slag
publicity => ruchtbaarheid; propaganda; reclame; verspreiding; openbaarheid; openbaarmaking; bekendheid
ride => gaan; varen; karren; lopen; verlopen; zich begeven; auto
function => fungeren; ambt; dienen; het doen; baan; betrekking; plaats; in zijn werk gaan
tops => maximaal; maximum; aas; beste; crack; grootmeester; kanjer; kei; kraan; raspaardje
watched => bekeken
consider => beschouwen; overwegen; bedenken; nemen; bekijken; betreffen; gelden; kijken; aannemen; in acht nemen
poked => prikte
dude => kerel; vent; maat; knul; kwast; saletjonker; dandy; fat; modepop; makker
leather => leren; leerachtig; taai; zemen; huid; leer-
takes => neemt
booming => donder; donderend; dreunend
site => ligging; plaats; zetel; ruimte; oord; plek; locatie; dorp; lokaliteit
adult => volwassene; volwassen; meerderjarig; volgroeid; mondig; rijp; groot; aanmerkelijk; aanzienlijk
risky => gewaagd; bedenkelijk; gevaarlijk; waaghalzerig; hachelijk; link; bedreigend; gevaarvol; gis
artfully => geslepen; gewiekst; handig; leep; uitgekookt; doortrapt; glad; kunstmatig; listig
grafts => transplantaten
modify => modificeren; wijzigen; veranderen; aanpassen; bewerken; altereren; changeren; converteren; afstellen; bepalen
churns => karnen
credibility => geloofwaardigheid; betrouwbaarheid
spotty => puistig; gevlekt
practice => oefenen; oefening; uitoefening; gebruik; aanwenden; gewoonte; doorvoeren; in de praktijk brengen; beoefen
suffer => lijden; dragen; ondergaan; naar buiten brengen; doorstaan; velen; verdragen; uithouden; uitstaan; dulden
candidate => sollicitant; aspirant; verkiezingskandidaat
c => C
civilization => beschaving; beschaven; bewoonde wereld; cultuur
cup => kopje; beker; kop; tas; mok; bekertoernooi; bokaal; jat; kelk
reminded => herinnerde
sell => verkopen; verhandelen; overdoen; tappen; vervreemden; wegdoen; verraden; afzetten; afzetterij; bedriegen
clutch => koppeling; grijpen; vastgrijpen; aangrijpen; ontkoppelingspedaal; bemachtigen; klauw; greep; beetpakken; beetnemen
pop => pappa; knal; knallen; plek; populair; schieten; frisdrank; pop-bewerking uitvoeren
tore => torus; scheurde; scheurden
jacket => jas; jasje; colbert; buis; omslag; vest; kaft; bedekking; deken; deksel
dissecting => ontleden
liberating => bevrijdende
compound => samenstelling; verbinding; samengesteld; complex; mengsel; compositie; chemische verbinding; erf
lead => lood; aanvoeren; leiding; vooroplopen; begeleiden; besturen; de weg wijzen; voeren
extended => groot; uitgebreid; chronisch; langdurig; breedvoerig; omvangrijk; royaal; ruim; uitgestrekt; veelomvattend
formation => samenstelling; configuratie; wording
hallway => gang; corridor
tweezers => pincet; nijptang; tang; veertangetje
stopped => gestopt
nuts => bah; gek; dolzinnig; geschift; getikt; krankzinnig; waanzinnig; dol; getroebleerd; getroubleerd
gash => jaap; houw; snede; snijden
till => tot; kas; totdat; ploegen; fonds; geldkist; kassa; voor; bebouwen; bewerken
picked => uitgekozen; uitgelezen; uitgezocht
disputed => betwist; kwestieus; omstreden
beat => afranselen; winnen; klappen; pols; halen; houwen; meppen; overtreffen; polsslag; swingen
locks => sluizen
embryonic => kiem; onrijp
agency => agentschap; bureau; kracht; macht; agentschapsbureau; medium; middel; remedie; weg
results => bevinding
regenerative => herstellend
chicken => kip; hen; kippenvlees; lafaard; hoen; angsthaas; wezel; kippevlees; lafbek
claims => eisen
sewn => genaaid
flashy => flitsend; opzichtig; kleurrijk; opvallend; voyant
gap => opening; bres; hiaat; lacune; leemte; kloof; afwezigheid; euvel
fund => kapitaal; financieren; kas; geldkist; voorraad; bak; bekostigen; bezitting; boerderij
assault => aanranden; aanval; aanvallen; aanranding; vergrijpen; aangrijpen; aantasten; aanslag; bestorming; attaque
beginning => begin; aanvang; ontstaan; start; vertrek; aanhef; bron; genese; intrede; inzet
nothing => niets; niks; niemendal; nihil; nul; helemaal niet; niemand
skin => huid; vel; villen; afstropen; onthuiden; pels; schil; vacht; dierevel
convicted => veroordeeld; veroordeelde
trotted => draafde
entered => ingevoerde
incision => hak; inkerving; insnijding; kerf; snede
nerve => zenuw; geduld; lef; moed; durf; neuron; neuronenbundel; stalen zenuwen; sterke zenuwen
quietly => rustig; op zijn gemak; kalm; stil; zachtjes; kalmpjes; bedaard; gerust; zoetjesaan
beautifully => mooi; net; schoon
laser => laserstraal
true => waar; echt; gelijk hebbend; juist; eigenlijk; gegrond; heus; waarachtig; rechttrekken
paper => document; krant; behangen; akte; bescheid; werk; eindwerk; schriftuur
invented => fictief
obviously => klaarblijkelijk; duidelijk; blijkbaar; vanzelfsprekend; overduidelijk; natuurlijk; uiteraard; kennelijk; begrijpelijkerwijs; dat spreekt vanzelf
supply => leveren; aanvoer; bevoorraden; aanvoeren; bevoorrading; bezorging; stijven; voorraad; voorziening; voorzien van
sandwich => boterham; broodje
united => verenigd; gezamelijk; verbonden; eendrachtig
giant => reus; reusachtig; gigantisch; enorm; reuzen-; kolossaal; kerel; Reus; giantisch
learned => geleerd; knap; ontwikkeld; aangeleerd; belezen; academisch; erudiet
nonsense => onzin; flauwekul; zever; gekheid; ongerijmdheid; kletspraat; absurditeit; onding; zottenklap
lee => lij; lijzijde; luwte; lijzij
especially => vooral; in het bijzonder; inzonderheid; voornamelijk; hoofdzakelijk; specifiek; met name; bijzonder; apart
reporting => berichtgeving; melding
met => ontmoet; ontmoette; ontmoetten
stuff => spul; stof; vullen; goedje; dingen; opzetten; spullen; waar; materiaal; opvullen
saying => gezegde; spreekwoord; spreuk; zegswijze; aforisme; citaat; frase; zinspreuk; adagium; judicium
martin => zwaluw; huiszwaluw
converts => bekeerlingen
bottom => bodem; onderkant; zitvlak; kont; grond; ondergrond; bil; bips; achtergrond
worker => arbeider; werkkracht; arbeidskracht; arbeidster; employé
substance => stof; goedje; spul; zelfstandigheid; essentie; kern; wezen; inhoud; vermogen
pleasurable => plezierig; genotvol; prettig; aangenaam; genoeglijk
horn => claxon; toeter; trompet; gewei; Jachthoorn; orkesthoorn
strip => reep; band; uitkleden; windsel; landingsbaan; afstropen
questions => vragen
nurses => verpleegkundigen
customers => klanten; klantenkring
transplantation => overplanting; verplanting
space => ruimte; bestek; speling; wereldruim; plaats; afstand; heelal; tijdje
applied => aangewend; aangebracht; toegepast
buckler => schild
none => geen; niemand; niet een; niets; geen enkel; geen enkele; niks; niemendal; geen zier
primary => voornaamste; hoofd-; oorspronkelijk; eerst; eerste; eerstegraads; elementair; grond-
carpet => tapijt; vloerkleed; kleed; leggen; bedekken; loper; vloerbedekking; mat
risk => risico; wagen; risico nemen; op het spel zetten; kans lopen; gewaagdheid; waagstuk; gevaar; risico lopen
communicate => meedelen; mededelen; berichten; overbrengen; aansteken; besmetten; infecteren; voortzeggen; schrijven
currently => momenteel; tegenwoordig; huidig; nu; thans; op het ogenblik; heden ten dage; nou; vooralsnog
parts => delen; talent; deel; gebied; streek
stick => kleven; plakken; staf; lijmen; vastkleven; tak; aanhangen; blijven steken
companies => bedrijven
creation => schepping; uitvinding; aanstelling; genese; oeuvre; geboorte; manifestatie; ontstaan
community => gemeenschap; gemeente; maatschappij; samenleving; buitenwacht; gemeenschappelijkheid; bevolkingsgroep
patterns => patronen
problem => vraagstuk; opgave; vraagpunt; oefening; kwaal; moeilijkheid; opgaaf; kwestie
shrink => krimpen; verschrompelen; zielknijper; ineenkrimpen; ineenkronkelen; psychiater; zielenknijper; ineenschrompelen; inkorten
hole => gat; kuil; opening; put; leemte; gracht; greppel; groef; groeve
grew => groeide; groeiden
stimulate => prikkelen; aansporen; ophitsen; aanstoken; aanvuren; aanwakkeren; irriteren; zwepen; opwekken
stop => stoppen; ophouden; aanhouden; halte; beëindigen; halthouden; stilstaan; afbreken; punt
norman => normandisch
took => nam; namen
bathroom => badkamer; toilet; badhuis; zwembad; bad; badplaats; privaat; wasgelegenheid; wc; W.C.
dalliance => flirt; gelanterfanter; tijdverlies; verspilling
treatments => behandelingen
silicon => kiezel
earnestly => serieus; ernstig; in ernst
hairy => behaard; ruig; ruigharig
removed => verwijderd
heads => kruis; koppen
protects => beschermt
sells => verkoopt
specific => soortelijk; bijzonder; kenmerkend; bepaald; expliciet; afzonderlijk; concreet; eigen; eigenaardig
base => basis; baseren; hoofdkwartier; honk; kazerne; vertrekpunt; gronden; fundament; grond
padded => gewatteerd
hippopotamus => nijlpaard; Nijlpaard
magazines => tijdschriften
rolling => walsen; meeklinkend; resonerend
article => lidwoord; handelsartikel; bericht; handelswaar; object; onderdeel; stuk; waar; bijdrage
option => keus; keuze; alternatief; verkiezing; voorkeur; keur; keuzemogelijkheid; voorliefde
danger => gevaar; bedreiging; hachelijkheid; onraad; nood; perikel; gevaarlijkheid; kans; dreiging; onheil
pours => giet
unexpectedly => onverwachts; eensklaps; onverwacht; bij ongeluk; per ongeluk; zonder opzet; plotseling
grafted => geënt
competing => concurrerend
topical => actueel; tegenwoordig; plaatselijk; huidig; in de mode; in zwang; modieus; thematisch
satiating => verzadigend
seeking => onderzoek; queeste; speurtocht; speurwerk; zoektocht
disruptors => verstoorders
artificial => kunstmatig; onnatuurlijk; nagemaakt; gekunsteld; gewrongen; gemaakt; gezocht; kunstig
particular => bijzonder; afzonderlijk; speciaal; afgezonderd; los; bepaald; bijzonderheid; detail; precies; specifiek
snake => slang; serpent; slangen; Slang; cobra
creating => het creëren van
creative => kunstzinnig; scheppend; artistiek; oorspronkelijk; productief; produktief
called => heten; genaamd; heet
dedicated => toegewijd; gewijd; geëngageerd
reading => lezen; lezing; uitlezing; lectuur; voorlezen; inschatting; lees; interpretatie; leesvaardigheid
harmless => ongevaarlijk; onschadelijk; veilig; goedaardig; gevaarloos; behouden; betrouwbaar; bona fide; geborgen; gewis
fifties => jaren 1950; jaren 50; jaren vijftig
approaches => benaderingen
flight => vliegtocht; loop; troep; zwerm; ontsnapping; escape; lek
knows => weten
process => verloop; werkwijze; bewerking; procédé; bereidingswijze; ontwikkelingsgang; bewerken; behandelen; procedure
worst => slechtst; slechtste; verslaan
stigma => olifantssnuit; slurf; snuit; stempel; tromp; Stempel; schandvlek
enlarged => gezwollen
semester => kwartaal
weird => bizar; vreemd; raar; eigenaardig; merkwaardig; bovennatuurlijk; vreemdsoortig; geschift; ongewoon; getikt
freeing => emancipatie
non => vrij
far => verwijderd; ververwijderd; veraf; verafgelegen; afgelegen; heen; over; weg; vandoor
paused => onderbroken
colors => vlag; standaard; ICOVA; vaandel; vendel
offered => aangeboden
salesmen => verkopers
pioneering => baanbrekend
readership => lezers; lezerskring; lezerspubliek
fully => geheel; volkomen; heel; compleet; ten volle; helemaal; finaal; totaal
started => begonnen
boxes => dozen
lab => laboratorium
theory => hypothese; veronderstelling; idee; leer
road => weg; baan; straat; route; eenbaansweg; heerbaan; hoofdweg; rijweg; spoor; straatweg
level => niveau; vlak; waterpas; verdieping; etage; egaliseren; hoogte; peil; effen; gelijk
packaging => verpakking; omhulsel; emballage; verpakken; verpakkingsindustrie; verpakkingsmateriaal
trotting => draven
penis => lul; lid; piemel; mannelijk lid; pik; jongeheer; leuter; fallus; plasser
serendipity => toevalstreffer; gelukkig toeval
ugly => lelijk; rot; shit; shit-; vervelend; bedenkelijk; grotesk; kwaad; miezerig; schamel
stitch => steek; stikken; naaien; steken; pikken; priemen; prikken; panorama maken; borduren; breisteek
nice => aangenaam; fijn; mooi; aardig; lekker; leuk; vriendelijk; behaaglijk; heerlijk; genoeglijk
portion => deel; aandeel; dosis; rantsoen; dosering; toewijzen; uitdelen; verdelen
race => afkomst; geslacht; stam; rennen; volksstam; soort
slap => oorveeg; mep; meppen; lel; draai om de oren; klets; kletsen; neerkwakken
executive => uitvoerende macht; bestuur; directeur; regering; bevel; bewind; commando; heerschappij; uitvoerend; kader
protein => eiwit; eiwitstof
walking => lopen; wandelen; ambulant; gaan; loop; opstap; opstapje; rit; tocht; trede
regrowth => hergroei
dermis => huid; lederhuid; vel
receding => terugwijkende
arthritis => gewrichtsontsteking; jicht
impaired => verstoord; beschadigd; verminderd; verzwakt
boots => laars; laarzen
ancient => aloud; ouderwets; oeroud; oud; eeuwenoud; eertijds; weleers; oudheid; antediluviaal
attempting => proberen
boom => giek; dreunen; hoogconjunctuur; hausse; donderen; floreren
efforts => bemoeienis; geploeter; gesjouw; streven
black => zwart; negerin; neger; zwarte; donker; duister; somber; aardedonker; gitzwart; pikdonker
loop => strik; lus; breisteek; maas; steek; herhaling; repetitie; strop; herhalen; boog
hail => hagelen; begroeten; toejuichen; roep; bij acclamatie benoemen tot; halen; uitroepen tot; zijn bijval betuigen; aanhalen
fourth => vierde; kwart; vierendeel; Kwart
density => dichtheid; dikte; waarschijnlijkheid; compactheid; Aptenocanthon wollumbin; Dichtheid; soortelijk gewicht; soortelijke massa
ago => geleden; eertijds; voorbij; verleden
luscious => wulps; obsceen; smaakvol; verleidelijk; zoet; verrukkelijk; aanbiddelijk; aantrekkelijk; begerenswaardig
solution => oplossing; uitkomst; antwoord; resultaat
six => zes; zestal
following => volgende; aanhang; leden; aanstaand; navolgend; aankomend; gevolg; komend
go => gaan; lopen; rijden; verdwijnen; varen; weggaan; poging; van stapel lopen; verlopen
sleeves => mouwen
particularly => in het bijzonder; inzonderheid; vooral; speciaal; hoofdzakelijk; voornamelijk; bijzonder; afzonderlijk; apart; bepaald
automatically => vanzelf; zelfwerkzaam
identity => persoonlijkheid; overeenstemming; individualiteit
coverage => dekking; omvang
proprietor => eigenaar; bezitter; mede-eigenaar; partner; baas; grondbezitter; huisbaas; uitbater; bezitster; eigenares
dark => donker; duister; ongewisse; somber; onwetendheid; duisternis; geheim; het vallen van de avond; nachtval; onbekend
snug => nauwsluitend; behaaglijk; gezellig; knap; knus; lekker; netjes
bald => kaal; kaalhoofdig; afgesleten; kalen; bloot; kaal worden; naakt
german => Duits; Duitse; Duitser; duits; duitser; vol
pressure => druk; aandrang; drang; knel; benauwdheid; bezetting; dwang; spanning; belasting
lightly => zwak; zwakjes; voorzichtig; zachtjes; gemakkelijk; handig
birds => gevogelte; vogelstand; vogelwereld
win => overwinnen; behalen; overwinning; verdienen; succes; baat; gewin; verdienste; verkrijgen
web => net; vlies; koord; spinnenweb; baard; spinneweb; weefsel; weven
signal => sein; teken; een sein geven; blijk; merkteken; bewijs; wenk
science => wetenschap; ervaring; kennis; weten; natuurwetenschap; natuurwetenschappen; kunde; wetenschappelijk; techniek
stormy => stormachtig; onweerachtig; ontstuimig
aesthetics => schoonheidsleer
wife => echtgenote; vrouw; gemalin; man; eega; echtgenoot; gemaal; gade; wederhelft
project => ontwerp; plan; concept; blauwdruk; onderneming; opzet; plattegrond; plannen
cap => pet; muts; dop; baret; hoed; kapje; deksel; bedekken; kornet
pressing => dringend; brandend; spoedeisend; urgent; nijpend; aandrang; aandrukken; drang
managed => beheerd
clockwise => met de klok mee; rechtsom; in wijzerzin; Met de wijzers van de klok mee; wijzerzin
alopecia => haaruitval; kaalhoofdigheid; kaalheid
expression => uitdrukking; gelaatsuitdrukking; uiterlijk; spreekwijze; gezegde; zegswijze; bewoording; wijze van spreken; gezicht
ad => advertentie; aankondiging; bericht; reclame; openbaarheid; publiciteit; ruchtbaarheid
hoping => hoop
confident => zelfverzekerd; zelfbewust; vertrouweling; overtuigd; vol vertrouwen; zeker
proprietary => particulier; bedrijfseigen; bezit; eigenaar
summer => zomertijd; slijten; verbrengen; verslijten
anybody => iemand; een of ander; een of andere; enig; een ieder
counterclockwise => linksom draaiend; tegen de klok in
conference => bespreking; overleg; vergadering; seminar; assemblage; assemblee
seated => gezeten
often => vaak; dikwijls; gedurig; veeltijds; menigmaal; veel; veelal; veelvuldig; dikwerf; frequent
engineered => gemanipuleerde
liars => leugenaars
notice => opmerken; bemerken; merken; bericht; aanplakbiljet; aankondiging; opmerking; affiche; kennisgeving; waarnemen
rocket => vuurpijl; raketsla; rucola
curl => krul; rotatie; krullen; kappen; lok; friseren; doorroeren; haarkrul; haarlok; omroeren
strange => vreemd; raar; wonderlijk; buitenlands; onbekend; eigenaardig; gek; onwennig; vreemdsoortig; bizar
dropping => achteruitgang; besnoeiing; daling; debâcle; degeneratie; degradatie; kleinering; ondergang; ontaarding; rampspoed
optional => facultatief; niet verplicht; vrijblijvend
overflowing => overtollig; alluvium
focusses => richt
hanging => behang; verhangen; wandtapijt
buy => kopen; aanschaffen; aankopen; koop; overnemen; verwerven; afnemen; behalen; inkopen; verkrijgen
able => competent; bekwaam; handig; bedreven; kundig; in staat; aanmerking; de; hebben
lifer => levenslang veroordeelde
moved => bewogen; aangedaan; verplaatst; verschoven
wigs => pruiken
grail => kelk
worldwide => universeel; over de hele wereld; algemeen; globaal; mondiaal; internationaal
jan => januari
dramatically => ineens; opeens; plotseling; allemachtig; extreem; hoogst; in hoge mate; meest; uitermate; uiterst
moving => ontroerend; aandoenlijk; aangrijpend; roerend; bewegend; bewegende; emotioneel; ontroerende; treffend; beweeglijk
appointment => afspraak; aanstelling; rendez-vous; benoeming; ambt; baan; betrekking; post; plaats; uitrusting
solved => opgelost
cruelly => wreed
puncturing => doorprikken
studied => geleerd; gezocht; opzettelijk
money => geld; poen; valuta; munten; zilver
partner => vennoot; lid; associé; maat; makker; compagnon; deelgenoot; bondgenoot; gezellin
van => bestelwagen; wagon; bestelauto; voorhoede; vrachtwagen; rijtuig; wagen; bestelbus; bus; camionette
onto => op; aan; bij; in; naar; binnen; dichtbij; elk; erop; ieder
thirties => jaren 1930; jaren 30; jaren dertig
eyebrows => wimpers
startup => opstart
perfectly => helemaal; volledig; volmaakt; uitstekend; absoluut; compleet; faliekant; finaal; geheel
bountiful => mild; overvloedig; rijkelijk; weldadig
mechanical => werktuiglijk; gedachteloos; gedachteloze; automatisch
chatted => babbelden
trace => spoor; opsporen; voetspoor; calqueren; afdruk; overtrekken; afbakenen; sporen; nazoeken; spoorzoeken
chunk => brok; klomp; stuk; klont; kluit; prop; bal; dot; blok; bonk
affected => aangedaan; aanstellerig; onnatuurlijk; aangegrepen; gekunsteld; gemaakt; gewrongen; onecht; onwaar; aangetast
emotional => gevoelsmatig; aangrijpend; ontroerend; roerend; psychisch
eternal => eeuwig; eindeloos; altijddurend; eeuwigdurend; onveranderlijk; voortdurend; Eeuwig; blijvend; doorlopend; eeuwige
migrate => trekken; rondreizen; rondtrekken; zwerven; verhuizen; dwalen; werken
initiate => beginnen; ingewijde; de stoot geven tot; aanvangen; beginner; starten; het initiatief nemen tot; inleiden; inwijden
bears => beren
slice => schijf; plak; moot; snede; snee; snijden; filet; sneetje; snerpen; deel
arm => bewapenen; wapen; wapenen; wapenschild; hand; bovenarm; armleuning; been; leuning
regular => gelijkmatig; gewoon; vast; stamgast; gewone; vaste; steevast
semi => gedeeltelijk
offering => aanbod; offergave; aanbieden; aanbieding; gift
toward => naar; bij; aan; tegen; tot; voor; betreffende; in verband met; op het stuk van; ten opzichte van
quality => eigenschap; allooi; hoedanigheid; klasse; aanleg; attribuut; bekwaamheid; rang
informed => onderlegd; welingelicht
giving => genereus; gul
vote => stemmen; stem; kiezen; verkiezen; stembusgang; balloteren; zijn stem uitbrengen; stemming
appreciated => geschat
surprise => verrassing; verrassen; verbazing; verbazen; betrappen; bevreemding; verwondering; snappen; verwonderen
distinct => duidelijk; klaar; uitgesproken; helder; transparant; afzonderlijk; apart; onderscheiden; ongelijk; verschillend
aforementioned => eerder vernoemde; voorgenoemde; voornoemde; eerdergenoemd; voormeld; voornoemd; voorgemeld; voorgenoemd; bovengenoemd; bovenvermeld
mid => te midden van; medio
put => zetten; stellen; leggen; plaatsen; doen; aanspannen; brengen; steken; stoppen; aanbrengen
rustled => ritselde
warmly => heet; warmpjes; hartelijk; in der minne; vriendschappelijk; vriendelijk
origins => oorsprongen
puberty => adolescentie; rijpheid
bounced => stuiterde
donor => gever; schenker; begunstiger; steunlid; weldoener
top => bovenkant; topje; deksel; draaitol; afknotten; bovenkleding; uitmunten; van kant maken
providing => het verstrekken van
inhibits => remt
mouse => computermuis; muizen vangen; rat; muizen en ratten van de Oude Wereld
founded => gesticht
explains => legt uit
astonishing => verbazingwekkend; verwonderlijk; bevreemdend; wonderbaarlijk; schitterend; verrassend; verbazend
duration => duur; tijdsduur; lengte
solutions => oplossingen
fun => plezier; pret; vermaak; amusement; leuk; lol; plezierig; lollig; ontspanning; plezant
disorders => aandoeningen
kings => Koningen
pill => tablet; bal; kanonskogel; kogel; pluis; plunderen; tennisbal
sometime => eens; ooit; eenmaal; wel eens; weleens; soms; voorheen; voormalig; vroeger
hotel => pension; eethuis
wealth => rijkdom; vermogen; fortuin; overvloed; weligheid; abundantie; fortuinlijkheid; geluk; levenslot
lotion => balsem
abdomen => onderbuik; buik; onderlijf; achterlijf; buikholte; onderlichaam; Buik
held => gehouden
nurse => verpleegster; verplegen; verpleegkundige; verpleger; zogen; verzorgen; kinderjuffrouw; zoogmoeder; ziekenverpleger; zorgen voor
enthusiasm => geestdrift; uitbundigheid; animo; verrukking; geestdriftig; begeestering; ijver; vuur
burden => last; belasten; bezwaren; beladen; inladen; laden; lading; belasting; vracht; bewijslast
eyeballs => oogbollen
college => universiteit; faculteit; academie; hogeschool; college in Canada; genootschap; gevangenis
wrote => schreef; schreven
retention => memorie; behoud; bewaring; handhaving; instandhouding; geheugen; herinnering; herinneringsvermogen; retentievermogen
regrow => teruggroeien
write => schrijven; neerschrijven; uitschrijven; componeren; maken; scheppen; pennen; opschrijven; neerpennen; opslaan
restoration => herstel; herstelling; teruggave; hernieuwing; reveil; vernieuwing
captured => gevangen genomen
tempting => aanlokkelijk; verleidelijk; lekker; aantrekkelijk; verlokkend
convinced => overtuigd
either => of; hetzij; ofwel; ook; beide; een van beide; allebei; evenmin
color => kleuren; verf; blozen; tint; verven; inkleuren; huidskleur
clarified => verduidelijkt
lord => heer; landheer; meneer; heerschap; overste; meester; heerser; mijnheer; beheerser
professional => beroeps; beroeps-; deskundige; expert; deskundig; vakman; beoefenaar; ambtshalve
bruiser => krachtmens
strong => sterk; krachtig; geconcentreerd; fiks; geducht; zwaar; stevig; standvastig; kras
skeptic => twijfelzuchtig
prophet => ziener; voorspeller; voorzegger; waarzegger; waarzegster; zieneres; helderziende
front => voorzijde; voorkant; façade; voorgevel; gevel; voor; voorgaan; eerste; het hoofd bieden
oil => olie; oliën; petroleum; aardolie; invetten; smeren; vet; vetlaag; ruwe olie
today => vandaag; heden; tegenwoordig; vandaag de dag; heden ten dage; nu; op het ogenblik; op vandaag
fell => hakken; afhakken; kappen; neervellen; omhakken; wreed; afbreken; afhouwen
sun => zonneschijn; zonnebaden; zonnen; zonnig; zonneglans; koperen ploert
guy => kerel; vent; knul; snuiter; gast; gozer; persoon; sujet; gasten; jongens
designed => met voorbedachte rade; opzettelijk
dimensions => afmeting