restriction => beperking; begrenzing; keten; restrictie; voorbehoud
they => zij; ze; men; hen; hij; hun; die
cellular => mobiele telefoon; mobieltje; GSM; mobiel; cellulair; gsm
you => jij; je; u; jullie; gij; ge; men; jou; gulder; aan je
what => wat; hetgeen; welk; dat; wat voor; welke; wat!; hoe; hé; what
regime => regime; stelsel; bewind; staatsvorm; bestuur; bestuursvorm; gouvernement; heerschappij; overheid; regering
changes => veranderingen
cell => cel; batterij; kerker; mobieltje; cachot; element; gevangenhuis; gevangenis; afdeling; 06
evidence => bewijs; teken; bewijsmateriaal; getuigenis; aanwijzing; adstructie; bewijsstuk; getuigenverklaring; blijk; certificaat
hope => hopen; hoop; verwachting; uitzicht; verwachten; verlangen; Hoop; begeren; eerzucht; trek hebben in
caused => veroorzaakt
better => beter; verbeteren; amenderen; beter worden; betere; breken; corrigeren; emenderen; op een hoger plan brengen; wijzigen
daily => dagelijks; dagblad; alledaags; daags; dagdagelijks; krant; alle dagen; blad; courant; dagelijkse
side => kant; zijde; zijkant; zij; minder belangrijk; flank; partij; ver; zijdelings; bladzijde
restricted => beperkt; begrensd; eindig; bekrompen; besloten; gesloten
recommended => aanbevolen; raadzaam
however => echter; niettemin; maar; daarentegen; toch; eender hoe; nochtans; evenwel; desalniettemin; desondanks
choose => kiezen; uitkiezen; verkiezen; uitlezen; uitpikken; uitzoeken; aanwijzen; tonen; aanduiden; aangeven
evolutionary => evolutionair
redman => rode man
flies => gulp
reduction => reductie; korting; vermindering; afslag; verlaging; afname; inkrimping; verkleining; daling; aftrek
thought => gedachte; idee; overweging; denken; begrip; denkbeeld; inval; oordeel; overleg; voorstelling
meal => maaltijd; meel; maal; bloem; eten; griesmeel; gort; grut; grutten; gerecht
a => een; per; binnen; in; te; aan; bij; enig; iemand; naar
careful => zorgvuldig; voorzichtig; behoedzaam; zorgzaam; grondig; omzichtig; aandachtig; doortastend; prudent; nauwkeurig
zdemir => zdemir
idea => idee; denkbeeld; gedachte; begrip; bedoeling; ingeving; plan; benul; opvatting; voorstelling
fewer => minder; min
during => tijdens; gedurende; in; terwijl; onder; staande; voor; lopende; hangend; ondertussen
advertisement => advertentie; reclame; aankondiging; bericht; annonce; ruchtbaarheid; promotie; openbaarheid; publiciteit
why => waarom; waarvoor; nou; wel; hoezo; hoe zo; weshalve; waardoor; hoezo?; waarom?
ate => oog; at; aten
cholesterol => cholesterol
seemed => scheen; schenen
also => ook; eveneens; tevens; evenzeer; mede; evenals; onder andere; onder meer; zoal; alsmede
show => tonen; vertonen; aanduiden; laten zien; voorstelling; wijzen; show; aantonen; uitwijzen; demonstreren
push => duwen; duw; aanduwen; stoten; dringen; stoot; drang; zet; douwen; douw
happens => gebeurt
your => jouw; uw; je; jullie; ulle; jouwe; uwe; jij
be => zijn; wezen; worden; zich bevinden; bestaan; verkeren; liggen; plaatsvinden; staan; zitten
reference => referentie; verwijzing; referent; referente; getuigschrift; aanbeveling; certificaat; teken; verklaring; adstructie
sleep => slapen; slaap; maffen; pitten; onderbrengen; te slapen leggen; slaapstand; rusten; sluimeren; sleep
night => nacht; nachtelijke duisternis; nachtrust; overnachting; avondje; hotelovernachting; nachtje; avond; duisternis; vanavond
research => onderzoek; speurwerk; nagaan; onderzoeken; uitvissen; uitzoeken; exploreren; speurtocht; vorsen; research
this => deze; dit; dit hier; de; het; aanstaande; dat; die
libido => libido; geslachtsdrift; lust
an => een; aan; bij; binnen; in; met; naar; op; per; te
humans => mensen
study => studeren; studie; bestuderen; studeerkamer; leren; onderzoek; onderzoeken; studiezaal; bestudering; exploreren
eat => eten; vreten; gebruiken; bikken; consumeren; nuttigen; opvreten; beffen; opeten; nassen
those => die; dat; datgene; zulks; dat daarginds; diegenen; gindse; zij; die ... daar; die ... daarginds
to => naar; tegen; aan; voor; tot; bij; om te; te; met; om
was => waren; was; werd
biomedical => biomedisch
louisiana => louisiana
at => bij; op; te; aan; in; dichtbij; nabij; apenstaartje; om; naar
food => voedsel; eten; spijs; etenswaar; voeding; gerecht; voeder; voedingsmiddel; kost; levensmiddelen
as => als; aangezien; as; omdat; zo; zoals; want; terwijl; wijl; daar
around => rondom; om; rond; ongeveer; langs; omheen; omtrent; zowat; circa; plusminus
the => de; het; aan de; aan het; naar de; hoe; des te; naar het; ’t; aarde
university => universiteit; academie; universitair; unief; academisch; hogeschool
found => stichten; funderen; grondvesten; baseren; vestigen; oprichten; gronden; rechtvaardigen; terecht; tot stand brengen
even => gelijk; gelijkmatig; vlak; even; zelfs; gelijke; gelijkmaken; effen; paar; avondstond
longer => langer
center => centrum; middelpunt; centreren; midden; centraal; concentreren; center; hart; kern; as
analysing => analyseren
resting => resting
pennington => pennington
scarce => schaars; karig; schraal; schriel; zeldzaam; kostbaar; ongemeen; nauwelijks; mager; spichtig
second => seconde; tweede; moment; secondant; ondersteunen; tel; bijvallen; herkansing; ondersteuner; secunde
read => lezen; ontvangen; luiden; horen; gelezen worden; aflezen; uitlezen; voorlezen; uitkrijgen; citeren
lot => lot; perceel; kavel; partij; noodlot; lood; boel; erf; portie; kans
effects => goederen
important => belangrijk; ernstig; erg; voornaam; aanzienlijk; gewichtig; zwaar; zwaarwichtig; aanmerkelijk; geruim
big => groot; omvangrijk; volwassen; grote; aanzienlijk; flink; aanmerkelijk; belangrijk; fors; zwaar
wanted => begeerd; gewenst; gewild; gezocht
feeling => gevoel; gevoelens; emotie; gevoelig; voorgevoel; gevoelen; gewaarwording; zin; besef; beleving
very => erg; heel; zeer; bijster; bijzonder; dezelfde; echt; hetzelfde; uiterst; zelfde
drop => waterdruppel; drop; zakken; afnemen; weglaten; achterwege laten; afbreken; afgelasten; afleggen; afschaffen
samples => samples
which => welk; welke; hetwelk; die; dewelke; dat; hetgeen; wie; wat; waarmee
longevity => levensduur
findings => bevinding
requires => vereist
leanne => leanne
showed => getoond; gewezen; toonde; toonden
have => hebben; krijgen; zijn; moeten; erop nahouden; genieten; ontvangen; toucheren; bezitten; gebruiken
time => tijd; keer; maal; tijdperk; tijdstip; poos; uur; duur; klokken; chronometreren
of => van; over; voor; bij; uit; -e-; -en-; -s-; aan; met
small => klein; nietig; minuscuul; luttel; gering; karig; min; jong; miniem; smal
metabolism => metabolisme; stofwisseling
everyone => iedereen; elkeen; allemaal; elk; allen; ieder; alleman; iegelijk; al; iedere
cent => cent; duit; Cent; honderd
while => terwijl; poos; tijd; gedurende; tijdje; onder; een hele tijd; momentje; tijdens; staande
cmet => cmet
work => werk; werken; arbeid; functioneren; arbeiden; karwei; het doen; werkstuk; emplooi; in zijn werk gaan
animals => dieren; dierenrijk
by => bij; door; met; per; op; tegen; langs; nabij; dichtbij; naast
lives => levens
interesting => interessant; belangwekkend; vreemd; curieus; typisch; vreemdsoortig; lucratief; rendabel; winstgevend; aantrekkelijk
janine => janine
adults => volwassenen
diets => diëten
cause => veroorzaken; oorzaak; reden; aanleiding; aanrichten; teweegbrengen; doel; doen; maken; berokkenen
glucose => glucose; druivensuiker; druivesuiker; dextrose
in => in; binnen; te; tijdens; per; aan; op; bij; met; naar
assigned => toegewezen
usual => gebruikelijk; gewoon; algemeen; generaal; gangbaar; gewoonlijk; normaal; alledaags; courant; daags
monkeys => apen
measured => afgemeten; ceremonieel; plechtig; plechtstatig; gematigd; afgepast; weloverwogen
washington => washington
these => deze; dit; dit hier; die; dat
eating => eten
ageing => veroudering
diet => dieet; parlement; rijksdag; voedsel; spijs; afvallen; lijnen
seen => gezien
per => per; in; te; binnen; aan; om; tegen; voor; door middel van; door bemiddeling van
few => weinig; karig; schaars; schraal; schriel; zeldzaam; kostbaar; minderheid; ongemeen; paar
include => bevatten; bijvoegen; behelzen; inhouden; insluiten; betrekken; invoegen; omvatten; begrijpen; coveren
rate => verhouding; taxeren; begroten; schatten; waarderen; evenredigheid; proportie; graad; snelheid; achten
necessarily => noodzakelijk; nodig; noodzakelijkerwijs; onvermijdelijk
cold => koud; verkoudheid; kou; koude; koel; afstandelijk; fris; onvoorbereid; catarre; kil
respond => antwoorden; reageren; beantwoorden; antwoorden op; verantwoorden; bescheid geven; repliceren; responderen; terugzeggen
can => kunnen; blik; kan; conserveren; inblikken; conservenblik; blikje; toilet; mogen; afvoeren
mice => muizen
key => sleutel; toets; toonsoort; scala; toonladder; toonschaal; spie; toonaard; toon; klep
people => volk; mensen; lui; personen; bevolken; lieden; familie; bewonen; massa; verwanten
mechanism => mechanisme; mechaniek; techniek; machine
eyeem => eyeem
how => hoe; op welke manier; wat; op welke wijze; manier; wijs; wijze; zoals; how; als
calories => calorie
further => verder; nader; aanvullend; additioneel; accelereren; bespoedigen; langer; meer; verderop; verhaasten
experienced => ervaren; deskundig; geoefend; bedreven; zaakkundig; doorgewinterd; geroutineerd
on => op; aan; over; bij; in; jegens; met; om; te; tot
many => veel; vele; menig; velen; evenveel; talrijk; menigte; menige
increased => is gestegen
likely => waarschijnlijk; aannemelijk; allicht; vast; wel; zeker; geschikt; knap; veelbelovend; vermoedelijk
such => zulk; zo; zodanig; dergelijk; dusdanig; zo’n; zulk een; zozeer; zo'n; zo een
isn => isn
causes => oorzaken
thousand => duizend; duizendtal
randomly => willekeurig; bij toeval; toevallig; toevalligerwijze
hallmarks => keurmerken
dramatic => dramatisch; bovenmatig; extreem; uiterst
life => leven; levensduur; levenslang; hachje; aanzijn; levend; levenswijze; bezieling; energie; levendigheid
save => redden; sparen; bewaren; opslaan; behouden; besparen; bergen; bezuinigen; uitsparen; behoeden
ll => ll
or => of; goud; or; weder; anders; anderszins; in het andere geval; zoniet; dan wel
luigi => luigi
healthier => gezonder
levels => levels
lifespan => levensduur
low => laag; lage; gemeen; laaghartig; schunnig; infaam; vuig; depressie; lagedrukgebied; loeien
j => j
stress => spanning; beklemtonen; klemtoon; accent; accentueren; stress; nadruk; benadrukken; de klemtoon leggen op; drang
dna => dna
now => nu; nou; thans; tegenwoordig; wel; enfin; komaan; tja; heden; welnu
energy => energie; fut; arbeidsvermogen; spirit; kracht; wilskracht; nadruk; veerkracht; Energiesignaal; moe
calorie => calorie
live => leven; wonen; gevestigd zijn; levend; resideren; huizen; rechtstreeks; scherp; live; overleven
says => zeggen
cells => cellen
he => hij; zij; hem; ie; ’ie; ’m; het; ik; jij; degene
worms => wormen
extends => strekt
byproducts => bijproducten
revealed => onthuld
years => jaren; jaar; jarenlang
lower => verlagen; strijken; neerlaten; afdraaien; laten zakken; afslaan; neerhalen; vellen; zakken; onderste
availability => beschikbaarheid; voorhanden zijn; aanwezigheid; bruikbaarheid
if => als; indien; wanneer; of; ingeval; as; mits; hetzij; If; zo
but => maar; behalve; echter; doch; slechts; enkel; alleen; buiten; niettemin; pas
it => het; hij; er; daaraan; eraan; erheen; hem; ’t; haar; daar ... aan
damage => schade; beschadigen; schaden; averij; nadeel; beschadiging; havenen; toetakelen; schade aanrichten; verlies
oxidative => oxidatieve
we => wij; we; ons; Wij; men
journal => tijdschrift; krant; dagblad; courant; magazine; periodiek; dagboek; revue; journaal; logboek
and => en; alsook; alsmede
for => voor; omdat; naar; want; daar; aangezien; wegens; gedurende; onder; staande
thinks => denkt
two => twee; tweetal; biljet van twee dollar; tweejarig; tweejarige; biljet
reduced => afgeprijsd; gebradeerd; gereduceerd; gesoldeerd; teruggebracht; verkleind; verminderd; aanbieding; reduceren
normal => normaal; gewoon; gewone; normale; standaard-; ordinair; gangbaar; gebruikelijk; geldend; gewend
temperature => temperatuur; verhoging; kamertemperatuur
than => dan; dat
investigate => onderzoeken; uitzoeken; exploreren; nagaan; uitvissen; vorsen; bekijken; bestuderen; een enquête houden; wetenschappelijk onderzoeken
much => veel; zeer; erg; vele; evenveel; verreweg; dikwijls; een heleboel; flink; gedurig
rates => prijzen
their => hun; haar; zijn; hunne; drukken; een; invloed; op; uitoefenen; d’r
are => are; zijn; bent; vierkante decameter; zijt; is
there => daar; aldaar; ginds; ginder; er; daarheen; daarginds; d’r; hier; ’r
studies => studie
hibernate => overwinteren; een winterslaap houden; sluimerstand; slaapstand; slaapstand inschakelen
s => s
severely => hevig; bar; ernstig; gestreng; hard; straf; streng; strikt
body => lichaam; lijf; lijk; carrosserie; massa; corpus; menigte; hoofddeel; deel; kadaver
less => minder; min; kleiner; amper; minus; Less; minder dan
prompted => gevraagd
blood => bloed; bloeden; ras; temperament; bloedverwant; bloedverwante; familielid; verwant; aderlaten; bloedonderzoek
well => bron; goed; wel; put; gezond; nou; waterput; fit; nu goed; opwellen
others => ander; anderen; iemand anders; the others
loss => verlies; schade; verliezen; nadeel; strop; deficit; schadepost; nederlaag; warmteverlies; aderlating
limit => grens; beperken; limiet; begrenzen; beknotten; perk; begrenzing; beperkingen opleggen aan; landsgrens; rand
t => t
planning => planning; opzet
when => wanneer; als; toen; zodra; terwijl; eenmaaal; eens; van zodra; dan; waarop
doi => doi
may => mogen; kunnen; het recht hebben; meidoorn; misschien; mei
her => haar; zijn; d’r; hun; zij; ’r; ze; aan haar; naar haar; d'r
cutting => stek; stekken; hakken; snijdend; Cutting; kappen; snijden; bijlslag; bijtend; filet
colleagues => collega's
year => jaar; jaartal; klas; begrotingsjaar; boekjaar; jaarcijfer
first => eerste; eerst; vooreerst; ten eerste; allereerst; origineel; aanvankelijk; oorspronkelijk; primair; baanbrekend
missouri => missouri
has => heeft
metabolic => stofwisselings-
expand => uitbreiden; vergroten; uitzetten; toenemen; uitdijen; uitwerken; factoriseren; ontbinden in factoren; openzetten; zich uitbreiden
is => is; zijn
sense => betekenis; zintuig; zin; gewaarworden; aanvoelen; voelen; gevoelen; verstand; waarnemen; gevoel
more => meer; langer; verder; bovendien; meest; More; -er; Meer; groter
that => dat; die; zo; hetgeen; wat; welke; datgene; even; hetwelk; degene
some => enkele; sommige; wat; enige; sommigen; enigszins; zowat; een beetje; een weinig; enig
significant => veelbetekenend; betekenisvol; significant; beduidend; belangrijk; veelzeggend; voelbaar; waarneembaar; aanzienlijk; behoorlijk
fontana =>  
with => met; bij; door; tegen; voor; samen met; aan; per; ten huize van; aaneen
break => breken; pauze; pauzeren; breuk; kapotgaan; overtreden; stukgaan; verbreken; kapotmaken; stukmaken
organisms => organismen
rest => rust; rusten; rest; stilstand; overblijfsel; kalmte; rommel; uitrusten; nachtrust; stilstaan
spotting => spotting
square => vierkant; plein; kwadraat; plaats; vierkante; kwadrateren; square; markt; oplossen; veld
bacteria => bacteriën; bacterie; Lactobacillus fermentum ME-3; bacil
should => moeten; behoren; dienen; horen; zullen; mochten; zou moeten; zouden; mogen
cleanup => schoonmaken; opruimen
mystery => mysterie; raadsel; geheimenis; geheim; geheimzinnigheid
perhaps => misschien; mogelijk; wellicht; mogelijkerwijs; soms; het zou kunnen; allicht; vast; waarschijnlijk; wel
harmful => schadelijk; nadelig; gevaarlijk; hachelijk; link; bedenkelijk; gewaagd; riskant; waaghalzerig; kwalijk
another => ander; een andere; nog een; aanvullend; extra; iemand anders; meer; additioneel; andere; overig
ropes => touwen
researchers => onderzoekers
not => niet; nee; neen; geen; generlei
matthew => matthew
nets => netten
ships => schepen
cole => kool
w => slepen
ocean => oceaan; wereldzee; zee; massa
other => ander; andere; anderen; anders; verschillend; nog; overig; afwijkend; different; divers
alamy => alamy
times => keer; maal
japan => japan; lakken; verlakken
kilometres => kilometer
carry => dragen; overdracht; overdragen; overnemen; beschikbaar hebben; greep; te horen zijn; ter beschikking hebben; brengen; vervoeren
down => omlaag; dons; down; af; naar beneden; depressief; depri; neer; droppen; kwart
plymouth => plymouth
laboratory => laboratorium; lab; labo
underestimated => onderschat
pacific => vreedzaam
terms => voorwaarde; bepaling; conditie; verstandhouding
million => miljoen; één miljoen; millioen; een miljoen
kilogram => kilogram; kilo
millions => miljoenen
including => inclusief; met inbegrip van; inbegrepen; incluis; tot en met; zelfs
patch => lap; lapwerk; verstellen; oplappen; ingezet stuk; bed; lappen; perk; patch; bloemperk
suggestion => suggestie; voorstel; tip; wenk; aanbod; aanbieding; bod; voorslag; aanraden; aansporing
paulo => paulo
still => nog; stil; alsnog; nog steeds; toch; distilleerderij; kalmeren; distilleerapparaat; bedaard; bedaren
flotsam => drijfhout
into => in; binnen; per; te; aan; bij; met; naar; op; tegen
oceanic => oceanisch
so => zo; zodanig; dus; zodoende; bijgevolg; derhalve; zodat; dermate; zozeer; dan
pieces => stukken
computer => computer; rekenaar; pc; personal computer; rekenkast; rekentuig
most => meest; hoogst; meeste; meer; zeer; extreem; in hoge mate; uitermate; -st; allemachtig
label => etiket; label; etiketteren; aanbrengen; prijzen; bestempelen; categoriseren; platenmaatschappij; barensteel; heten
expanding => uitbreiden
part => deel; onderdeel; stuk; gedeelte; rol; bestanddeel; component; ingrediënt; Part; aandeel
sinking => achteruitgang; besnoeiing; daling; debâcle; degeneratie; degradatie; kleinering; ondergang; ontaarding; rampspoed
affects => beïnvloedt
litter => draagstoel; vuilnis; afval; draagbaar; zwerfafval; strooisel; werpen; worp; zwerfvuil; draagbed
large => groot; grote; flink; ruim; wijd; fors; omvangrijk; aanmerkelijk; aanzienlijk; ampel
instance => voorbeeld; geval; voorval; exempel; instantie; toonbeeld; exemplaar; model; aandrang; keer
excreted => uitgescheiden
surveys => enquêtes
one => een; één; men; ene; enige; je; de; dezelfde; een zekere; eenheid
model => model; modelleren; toonbeeld; voorbeeld; mannequin; staan; maquette; schema; tonen; boetseren
discarded => weggegooid
evolving => evoluerende
know => weten; kennen; kunnen; bekend zijn met; beheersen; machtig zijn; verstaan; begrijpen; onderscheiden; beleven
accumulates => accumuleert
seas => zeeën
been => geweest; zijn
objects => spul
third => derde; terts; Terts
netherlands => Nederlands; benamingen van nederland; nederland
tsunami => tsunami; vloedgolf; tsoenami
suggests => suggereren
comprehensive => uitgebreid; alomvattend; diepgaand; omvattend; veelomvattend; lijvig; allesomvattend; omvangrijk; alles; all-round-
team => ploeg; team; equipe; groep; afdeling; detachement; groepering; elftal; samenwerken; vlucht
washed => gewassen
hawaii => hawaii; hawaï
great => groot; fantastisch; kostelijk; fijn; grote; heerlijk; prachtig; tof; voortreffelijk; uitmuntend
exist => bestaan; existeren; zijn; leven
aerial => antenne; bovengronds; met lucht gevuld; ra; spriet; voelhoorn; voelhoren; voelspriet; lucht; lucht-
laurent => laurent
invasive => invasief
were => ware; was; zou zijn
little => klein; weinig; luttel; gering; karig; min; nietig; minuscuul; beetje; jongere
oliveira => oliveira
fishing => hengelsport; vissen; sportvisserij; visserij; stek; visvangst; het vissen
reports => rapporten
detected => gedetecteerd
because => omdat; daar; aangezien; vermits; want; wijl; dewijl; doordat; gezien; naardien
entangle => verwarren; verstrikken; verwikkelen; betrekken; verknopen; bedotten; beetnemen; in verwarring brengen
debris => puin; afval; rommel; gletjserpuin; wrakhout; prullaria; overblijfselen; restanten; ruine; wrakstukken
trying => lastig; moeilijk; vermoeiend
towed => gesleept
sea => zee; maritiem; zee-; oceaan; massa; zeewater; sea; stortzee; zee‐
come => komen; het gevolg zijn van; klaarkomen; afstammen; aankomen; voortkomen; naderen; ontspruiten; arriveren; gebeuren
organisation => organisatie; ORG; vennootschap
floor => verdieping; vloer; etage; vloeren; auditorium; bodem; gehoor; grond; hoorders; toehoorders
greatly => terdege; zeer; dikwijls; een heleboel; gedurig; groots; hoog; hoogst; menigmaal; sterk
increase => toename; vergroten; vermeerderen; vermeerdering; toenemen; verhogen; opdrijven; ophogen; oplopen; uitbreiden
surface => oppervlak; oppervlakte; opduiken; kroon; kruin; mantel; top; topje; aan de oppervlakte brengen; boven water komen
eaten => gegeten; opgegeten
outer => uiterlijk; uitwendig; extern; buiten-; buitenste; buiten; buitenaf; buiten‐; kosmisch
data => gegevens; data; informatie; materiaal; gegeven; grondstof; materieel
made => gemaakt; maken
marine => maritiem; marien; marinier; marine; vloot; zee-; Marien; marine-; zeemacht
photo => foto; fotograferen; afbeelding; beeld; Foto's; plaat; prent; voorstelling
latest => laatst
could => kunnen
tohoku => tohoku
delft => delft
sixteen => zestien
gathered => verzamelde
between => tussen; onder; onder ons gezegd en gezwegen; ertussen; te midden van; tussendoor; begeleid; daartussen; gekantonneerd; geëvend
missing => ontbrekend; verdwenen; vermist; gebrekkig; zoek
find => vinden; aantreffen; vondst; ontdekken; bevinden; achten; concluderen; waarnemen; treffen; bemerken
alone => alleen; louter; verlaten; enig; eenzaam; afgescheiden; afgezonderd; allenig; enkel; exclusief
across => overheen; over; horizontaal; tegenover; aan de overkant van; zijdelings; aan de overkant; dwars; dwars door; in horizontale richting
centre => middelpunt; centrum; midden; binnenste; spil; centreren; binnenwerk; ingewand; medium; middelmaat
basins => bekkens
fed => gevoed; voedde; voedden
least => minst; kleinste; minste; allerminst; minder; althans
four => vier; viertal
near => nabij; dichtbij; bij; naderen; komend; aanstaand; eerstvolgend; dichterbijkomen; dierbaar; naverwant
like => houden van; zoals; als; gelijk; graag hebben; mogen; soortgelijk; gelijkend; gelijksoortig; gelijkvormig
after => na; achter; naar; nadat; door; ondanks; aan; vanwege; over; achterna
earlier => eerder; vroeger; voorheen; daarvoor; indertijd; verleden; vooraan; vorig; voorafgaand; voorgaand
conclusions => conclusies
california => californië
stock => voorraad; aandeel; stock; kolf; reserve; opslaan; violier; in stock hebben; in voorraad; op stock
out => buiten; uit; uiterlijk; weg; daarbuiten; eruit; buitenwaarts; naar buiten; uitwaarts; uitweg
scientific => wetenschappelijk
tonnes => ton
rely => rekenen op; afhangen; vertrouwen; zweren; afhankelijk zijn; deel uitmaken
where => waar; waarheen; waarvan; waarvandaan; waartoe; waarnaartoe; waarin; waar ... heen; waar ... naar toe; warheen
land => land; landen; grond; aan land gaan; neerstrijken; aanlanden; aarde; bodem; aardrijk; dalen
oceans => oceanen
us => ons; wij; aan ons; we; us
estimated => geschat
collected => bedaard; kalm; rustig
had => gehad
explanations => toelichtingen
regions => taalgebied
boats => boten
getting => krijgen
patches => pleisters
based => gebaseerd; onderbouwd
remove => verwijderen; weghalen; afschaffen; elimineren; wegnemen; opdoeken; wegdoen; afnemen; afhalen; afpakken
creatures => schepsels
microscopic => microscopisch; piepklein
ability => vermogen; bekwaamheid; vaardigheid; kundigheid; geschiktheid; competentie; aanleg; bedrevenheid; bevoegdheid; capaciteit
about => over; ongeveer; rond; bij; aangaande; om; betreffende; bijna; omheen; vrijwel
ingested => ingeslikt
area => gebied; oppervlakte; regio; streek; terrein; areaal; veld; buurt; gewest; domein
rather => nogal; liever; vrij; ietwat; tamelijk; veeleer; bij voorkeur; een klein beetje; enigszins; lichtelijk
garbage => afval; vuilnis; huisvuil; vuil; rommel; uitschot; slachtafval; troep; koeterwaals; prullaria
uk => uk
estimates => begroting
being => wezen; bestaan; zijn; aanzijn; entiteit
member => lid; lidmaat; ledemaat; aanhanger; lul; piemel; pik; jongeheer; leuter; plasser
from => van; uit; vanaf; tegen; sedert; sinds; vanuit; met ingang van; naar; op de
carried => gedragen
probably => waarschijnlijk; allicht; wel; zeker; vast; aannemelijk; vermoedelijk
currents => stromingen
kilometre => kilometer
rising => opklimmend; opstand; opheffing; muiterij; opgang; opkomend; oproer; opstijgend; rebellie; revolte
real => echt; reëel; werkelijk; real; waar; daadwerkelijk; echte; effectief; wezenlijk; reële
growing => groeiend
breaking => breuk
plastic => plastic; kunststof; plastisch; plastiek; van plastic; beeldend
particles => deeltjes
came => loodlijst; kwam
ways => manieren
denser => dichtere
mass => massa; mis; menigte; hoeveelheid; boel; drom; hoop; meerderheid; misvieren; ophopen
lebreton => lebreton
similar => gelijkend; gelijksoortig; soortgelijk; gelijkvormig; eender; gelijk; gelijkaardig; vergelijkbaar; overeenkomstig; analoog
floating => zwevend; drijvend; vlottend
simultaneously => tegelijkertijd; tegelijk; gelijktijdig; simultaan; gelijk; gelijkelijk
combat => gevecht; strijd; slag; kamp; veldslag; treffen; vechten; bestrijden; oorlog; bestrijding
who => wie; die; welke; dat; hetwelk; welk; Who; 10.wie; dewelke
added => toegevoegd
until => tot; totdat; voor; binnen
conflicts => conflicten
billion => miljard; biljoen; een miljard; één miljard
said => desbetreffend; desbetreffende; in kwestie; zeggen; genoemd; voornoemd
arlington => arlington
enemy => vijand; vijandelijk; tegenstander; belager; vijandin; antagonist; opposant; tegenwerker
victory => overwinning; zege; victorie; triomf; baat; gewin; overwinningen; verdienste; winst; zegepraal
mark => mark; teken; markeren; merken; punt; aanduiden; score; merkteken; tekenen; bewijs
fought => gevochten; vocht; vochten
world => wereld; aardrijk; aarde; heelal; wereld-; aardbol; werelds; Aarde; kosmos; ruimte
troops => troepen
clogged => verstopt
medical => medisch; geneeskundig; helend; medicinaal; medisch onderzoek
global => globaal; wereldwijd; sferisch; bolrond; bolvormig; mondiaal; wereld-; universeel; compleet; gans
streets => straten
necessary => nodig; noodzakelijk; benodigd; van node; essentieel; onvermijdelijk; vereist; noodzaak; onafwendbaar; onmisbaar
gazes => blikken
close => sluiten; dichtbij; dichtdoen; nabij; afsluiten; beëindigen; dichtmaken; dichten; toedoen; nabije
chiefs => chiefs
command => bevelen; commanderen; bevel; opdracht; commando; aanvoeren; order; voorschrijven; gebod; verordenen
urban => stedelijk; stads-; stads; urbaan; stads‐; stedelijk gebied
ensure => verzekeren; betuigen; assureren; beveiligen; uitvoeren; veiligstellen; zeker stellen; behoeden; beloven; beschermen
chemical => chemisch; scheikundig; chemicalie; chemicaliën; verslavend middel; chemische stof; chemieproduct; chemisch product; chemische substantie
administering => toedienen
stretches => strekt
end => einde; beëindigen; eindigen; ophouden; uiteinde; eind; besluit; aflopen; end; slot
call => noemen; roepen; opbellen; roep; aanroepen; heten; schreeuwen; bellen; bezoek; bezoeken
no => nee; neen; geen; niet; verboden; tegenstem; neestem; verboden te; niemand; zonder
libya => libië
used => gebruikt; afgewerkt; gewoon; occasion; vroeger
current => actueel; stroom; stroming; huidig; tegenwoordig; aktueel; aktuele; huidige; hedendaags; loop
covered => bedekt; begroeid; bezaaid; gedekt
china => porselein; porseleinen; china; volksrepubliek china
resource => hulpbron; middel; bron; faciliteit; hulpmiddel; middelen; ressource; medium; remedie; weg
noted => bekend; beroemd; befaamd; vermaard
jungles => jungles
budget => begroting; budget; begroten; budgetteren; budgettair; goedkoop; low-cost; opmaken; opstellen; voorraad
death => dood; overlijden; sterfgeval; ondergang; verderf; verscheiden; heengaan; versterf; doodgaan; levenloos
bomb => bom; bombarderen; afgaan; flop; vlam; wrak; Bomb; sexbom
field => veld; akker; gebied; terrein; lichaam; slagveld; speelveld; wei; land; vak
stretch => rekken; strekken; uitrekken; rek; reiken; spannen; aanspannen; rechttrekken; afwikkelen; besmeren
ordered => bestelde
potential => potentieel; bestaanbaar; mogelijkheid; eventueel; haalbaar; mogelijk; Potentiaal; Potentialis; gebeurlijk; latent
spilled => gemorst
memorial => gedenkteken; herdenkingsplaats; aandenken; gedachtenis; gedenksteen; herdenking; petitie; rekest; verzoekschrift; gedenkschrift
all => alle; al; alles; helemaal; totaal; elk; allen; allemaal; heel; geheel
members => leden
regimes => regimes
coming => aanstaand; afkomstig; komst; volgend; komend; aankomend; aankomst; spoedig; aanstaande; aanval
reaches => bereikt
expansive => expansief; omvattend; mededeelzaam
certain => zeker; stellig; gewis; vast; bepaald; beslist; vaststaand; wis; duidelijk; verzekerd
population => bevolking; populatie; inwonertal; zielental; volk; residentie; demografie
deafening => oorverdovend
skulls => schedels
nations => landen
hostile => vijandig; vijandelijk; onvriendelijk; agressief; antagonistisch; vijandige
oppose => dwarsbomen; tegenwerken; belemmeren; tegenhouden; opponeren; weerstaan; weerstreven; bestrijden; ...; bezwaar hebben tegen
later => later; straks; volgend op; achter; achtereenvolgens; na
countless => ontelbaar; talloos; legio
drug => drug; medicijn; geneesmiddel; artsenij; drogeren; dope; drogerij; kruid; narcoticum; bedwelmen
days => dagen
access => toegang; aanval; bereiken; toegangsrecht; toegangsweg; toelating; verkrijgen; oprit; aanwinst; benadering
thoroughly => grondig; radicaal; rijpelijk; volkomen; volledig; compleet; degelijk; finaal; geheel; heel
my => mijn; m’n; mijne; m'n
africa => afrika
declared => verklaard
consolidate => consolideren; versterken; bevestigen; samenvoegen; verstevigen
crater => krater; trechter
jets => jets
disagree => het oneens zijn; overeenkomen; niet overeenstemmen; afkeuren; afslaan; afstoten; afwijzen; ciseleren; heruitzenden; nee zeggen tegen
disposal => neiging; lust; zin; aanvechting; verkoop; schikking; berging; beschikking; configuratie; opslag
say => zeggen; opgeven; luiden; opzeggen; staan; hallo; zeg; spreken; hee; hee daar
worth => waarde; waard; gehalte; gelijkwaardig aan; gewaardeerd; vermogen; waardigheid; duurte; kostbaarheid; verdienste
etched => geëtst
vanquished => overwonnen
its => zijn; haar; hun; de zijne; drukken; een; ervan; invloed; op; stempel
last => duren; laatst; laatste; afgelopen; vorig; voorbij; leest; beklijven; aanhouden; standhouden
leaders => voorspan
present => geschenk; cadeau; presenteren; voorstellen; aanwezig; tegenwoordig; heden; gift; huidig; present
heavy => zwaar; drukkend; zware; serieus; moeilijk; moeitevol; moeizaam; onhandig; overvloedig; ruw
fear => angst; vrezen; vrees; bang zijn; bang zijn voor; schrik; beduchtheid; duchten; beklemming; benauwdheid
cost => kosten; kost; onkosten; prijs; uitgave; kostprijs; schade; verlies; uitgaven; uitgaaf
our => ons; onze
battle => gevecht; strijd; slag; veldslag; kamp; strijden; vechten; bestrijden; bevechten; oorlog
ripping => heerlijk
decree => decreet; decreteren; verordenen; besluit; verordening; voorschrift; voorschrijven; beschikking; Decreet; bepalen
joseph => jozef
armies => legers
farthest => extreem
organizations => organisaties
bombing => bombardement; bomaanslag
nation => natie; staat; volk; land; mensen; peupel
engagement => verloving; engagement; verbintenis; afspraak; verplichting; treffen; betrekking; gevecht; hemelvaart; indienstneming
barren => onvruchtbaar; steriel; verlaten; woest; bar; doods; eenzaam; schraal; uitgestorven; dor
raids => invallen
looked => keek
russia => Rusland; rusland
table => tafel; tabel; lijst; tabelleren; dis; rekentafel; vermenigvuldigingstafel; plateau; rekentafels; vermenigvuldigingstafels
fight => vechten; gevecht; strijden; strijd; bevechten; uitvechten; bekampen; bestrijden; knokken; met
operating => opererend; werkzaam; functionerend
deploy => uitrollen; ontvouwen; gebruiken; implementeren; opzetten; uitspreiden; uitvouwen; inzetten
mountains => bergen; gebergte
va => va
though => hoewel; ofschoon; al; echter; alhoewel; wel; ondanks; desondanks; toch; overigens
engage => verloven; aanvallen; huren; aannemen; aanwerven; bekleden; beslaan; bewonen; bezetten; bezig houden
might => macht; kracht; vermogen; zou kunnen; kunnen; sterkte
confirmed => bevestigd; onverbeterlijk; verstokt
continuing => durend; voortdurend
enough => genoeg; voldoende; tamelijk; vrij; nogal; basta; genoeg!; toereikend; suffisant; afdoend
upon => op; aan; bij; betreffende; jegens; met; om; over; te; tegen
wiping => afvegen
single => enkel; ongehuwd; ongetrouwd; alleenstaand; single; alleen; alleenstaande; vrijgezel; afzonderlijk; eenzaam
peace => vrede; rust; peis; vrede met zichzelf; vree; geluk; kalmte
went => ging
bombings => bomaanslagen
back => achterzijde; ommezijde; rugstuk; rugleuning; bekleden; dekken; overtrekken; rugzijde; achteruit; ondersteunen
let => laten; toestaan; toelaten; verhuren; laten begaan; laten schieten; gedogen; loslaten; vergunnen; veroorloven
future => toekomst; toekomstig; aankomend; toekomend; toekomende tijd; beginnend; aanstaand; in spe; komend; spoedig
arsenals => arsenalen
recognize => erkennen; herkennen; onderkennen; agnosceren; als waarheid aannemen; honoreren; identificeren; toegeven; toekennen; verkennen
instantaneous => onmiddellijk; direct; ogenblikkelijk; bruusk; plots; plotseling; plotselinge; onmiddelijk; terstond; live
admitted => toegegeven
career => loopbaan; carrière; beroep; bedrijf; broodwinning; professie; beroepsopleiding; vaart
stockpiles => voorraden
necessity => noodzaak; noodzakelijkheid; nood; behoefte; nooddruft; necessity
launcher => draagraket
free => vrij; gratis; los; bevrijden; kosteloos; vrije; open; loslaten; kosteloze; vrijmaken
glorious => glorierijk; glorieus; roemrijk; beroemd; heerlijk; prachtig; roemruchtig; roemvol; zalig; alom bekend
america => amerika
treatment => behandeling; kuur; hantering; onderhandeling; therapie; geneeswijze; onthaal; opheldering; zuivering
corpse => lijk; kadaver; kreng; karkas; corpus; lichaam
swift => snel; vlug; gezwind; spoedig; gauw; gierzwaluw; haastig; steenzwaluw; haspel; prompt
fire => vuur; ontslaan; brand; schieten; vuren; afgaan; afvuren; fornuis; vuurzee; bakken
officer => officier; ambtenaar; beambte; politieagent; kantoorbediende; agent; bedrijver; dealer; smeris; vertegenwoordiger
total => totaal; geheel; gehele; gelijk zijn aan; uitkomen op; compleet; som; volledig; algeheel; optellen
assaults => aanvallen
historic => historisch; geschiedkundig
hills => heuvels
waist => middel; taille; leest; gordel; lijfje; middendek; keursje; blouse; keurslijf; kuil
continued => doorgegaan; voortdurend
overhead => bovengronds; met lucht gevuld; boven; lucht-; overhead; daarboven; omhoog; hierboven; lucht; lucht‐
fury => woede; razernij; toorn; boosheid; drift; furie; fury; gramschap
foothills => Uitlopers
pakistan => pakistan
picture => afbeelding; prent; beeld; plaatje; plaat; foto; portret; figuur; schilderij; voorstelling
mall => winkelcentrum; markt; voetgangersgebied; voetgangerszone
darkened => verduisterd
battlefield => slagveld
proclaiming => verkondigen
shackles => boeien; belemmering
i => ik; i; me; mij
ready => klaar; gereed; af; afgelopen; bereidvaardig; dienstwillig; bereid; bereidwillig; gretig; paraat
military => militair; leger; oorlogs-; martiaal; krijgs-; armee; legermacht; troepenmacht; militairen; strijdkrachten
merciless => genadeloos; onbarmhartig; meedogenloos; ongenadig; gemeen; gemene; wrede; wreed; onmeedogend; halsstarrig
ever => ooit; altijd; steeds; eens; immer; eenmaal; wel eens; nooit; weleens; almaar
resources => remedie; weg; medium; middel; middelen; geldmiddelen
names => namen
foundations => fundering
forward => aanvaller; voorwaarts; doorsturen; doorzenden; verzenden; voorspeler; doorgeven; voort; vooruit; afzenden
troop => bende; horde; troep; zwerm; menigte; drift; hoop; kudde; pfadfinder; roedel
perish => omkomen; vergaan; creperen; ondergaan; sneuvelen; sterven; bederven; verongelukken; wegkwijnen; doodgaan
best => best; slaan; verslaan; beste; overmeesteren; overwinnen; optimaal; aas; crack; grootmeester
mobilize => mobiliseren; mobiel maken
missile => raket; projectiel
over => over; boven; afgelopen; beëindigd; klaar; voorbij; aan; afgewerkt; ruim; om
foe => vijand; tegenstander; antagonist; opposant; tegenwerker
campaign => campagne; veldtocht; actie; platteland
take => nemen; pakken; aannemen; accepteren; brengen; aanvaarden; vatten; bezetten; aanvatten; bekleden
tanks => tanks
any => enig; elk; een of ander; een of andere; enige; enkel; enkele; ieder; iemand; sommige
planet => planeet; zwerfster
marching => marcheren
launch => lanceren; uitschrijven; lancering; barkas; ontketenen; te water laten; aanzetten; doorboren; gooien; smijten
shouted => geschreeuwd
enemies => vijanden
assembled => geassembleerd
adversary => tegenstander; vijand; tegenspeler; tegenstrever; Tegenstander; antagonist; opposant; tegenwerker
hearts => harten; hartenjagen
deep => diep; zwaar; diepgaand; dik; donker; laag; sterk; bas; diepliggend; diepte
triumphant => triomfant; triomfantelijk; zegevierend; zegepralend
sum => som; optellen; bedrag; totaal; bijeentellen; somma; summa; rekensom; totaalcijfer; totaalbedrag
debt => schuld; schulden; verplichting; debet
beneath => onder; beneden; daarbeneden
bullet => kogel; hagel; bullet; bal; bolletje (opsommingsteken); opsommingsteken; speelbal
pause => pauzeren; pauze; rust; interval; nadenken; onderbreking; pause; bedaardheid; bestand; bewegingloosheid
seven => zeven; zevental; rood
build => bouwen; opbouwen; aanleggen; maken; construeren; metselen; bouw; timmeren; aanmaken; lichaamsbouw
them => hen; hun; ze; aan hun; aan ze; naar hun; zich; zij; erop; haar
eastern => oostelijk; oosters; oosten; oosterling
pursued => nagestreefde
refuse => weigeren; afwijzen; afval; vertikken; afkeuren; afslaan; terugwijzen; vuilnis; het verdommen; rommel
theater => theater; schouwburg; toneel; slagveld; aula
drones => drones
establishment => vestiging; instelling; etablissement; oprichting; stichting; bestel; establishment; bedrijf; firma; formatie
general => algemeen; generaal; universeel; generiek; gemeen; in het groot; schetsmatig; veldheer; lijst van Zwitserse generaals; General
separatists => separatisten
soldiers => soldaten
remains => overblijfselen; resten; overblijfels; as; kadaver; lichaam; lijk; stoffelijk overschot
defeated => gevallen; verslagen
pentagon => vijfhoek; pentagoon; pentagon; Pentagon
settle => afhandelen; afwikkelen; afdoen; afrekenen; beslechten; beslissen; vestigen; afnemen; gaan liggen; bijleggen
arsenal => arsenaal; wapenmagazijn; wapenopslagplaats; tuighuis; wapenkamer; wapenarsenaal; wapendepot
comrades => kameraden
u => u
will => testament; wil; zullen; wens; verbond; laatste wilsbeschikking; uiterste wil; gaan; wilsbeschikking; zin
political => politiek; staatkundig; partijpolitiek
annual => jaarlijks; jaarlijkse; jaarboek; adresboek; almanak; annaal; eenjarig
acknowledged => erkend; geaccepteerd
aircraft => vliegtuig; vliegmachine; toestel; luchtvaartuig; luchtschip; kist; luchthaven; luchtvoertuig
paying => betalen
options => configuratie
only => slechts; alleen; maar; pas; enkel; enig; net; uitsluitend; louter; verlaten
prevent => verhinderen; voorkomen; beletten; verhoeden; belemmeren; doorkruisen; storen; stremmen; weerhouden; hinderen
indeed => inderdaad; werkelijk; feitelijk; echt; waarlijk; metterdaad; wezenlijk; daadwerkelijk; immers; toch
keep => blijven; bergen; fokken; toekijken; aanhouden; bewaken; nakomen; naleven; onderhouden; opfokken
unceasing => onophoudelijk; voortdurend; blijvend; doorlopend; gedurig; ononderbroken; altijddurend; eeuwig; onafgebroken; permanent
unrelenting => meedogenloos; onverbiddelijk; onvermurwbaar; voortdurend
branches => takken
bullets => bullets
armed => gewapend; bewapend; gehoefd; gehoornd; genageld
spoils => plundering; roofbuit; vriendjespolitiek; het uitdelen van ambten aan partijgenoten; buit
strategy => strategie; krijgskunde; opzet; planning; strateeg
stood => gestaan; stond; stonden
wounds => wonden
leftover => restant; kliekje; over; resterend; blijvend; overblijfsel
american => Amerikaan; Amerikaans; Amerikaanse; american; amerikaan; amerikaans
available => beschikbaar; voorhanden; verkrijgbaar; disponibel; liquide; gratis; vrij; geldig; leverbaar; bereikbaar
yet => nog; al; toch; echter; maar; nog steeds; tot dusver; alsnog; niettemin; reeds
cartels => kartels
horizon => horizon; horizont; kim; gezichtseinder; kimme; einder; gezichtskring
downtown => binnenstad; centrum; stadscentrum; downtown
blighted => ellendig
national => nationaal; landelijk; vaderlands; binnenlands; national; staats-; staatsburger; volks-
would => zouden; gelieve; willen; Use the past tense
price => prijs; prijzen; schatten; waarde; koers; waard
nuclear => nucleair; kern-; atoom-; atomair; kern‐
disease => ziekte; aandoening; kwaal; ongezondheid; besmetting; flauwheid; gebrek; gebrekkigheid; invaliditeit; zachtheid
ranks => gelederen
ordnance => geschut; Geschut; artillerie
fighter => kamper; vechter; strijder; gevechtsvliegtuig; krijger; bestrijder; kampvechter; straaljager; vechtsporter; bikkel
explained => uitgelegd
cities => steden
known => bekend; beroemd; geweten; gekend; gereputeerd; bekende
additional => aanvullend; bijkomend; additioneel; overig; verder; extra; supplementair; toegevoegd; aanvullende; ander
exploit => exploiteren; uitbuiten; heldendaad; wapenfeit; exploit; uitmelken; daad; prestatie; aanval; benutten
instead => in plaats van; in plaats daarvan
given => gegeven; bepaald
ordering => bestelling
confront => confronteren; tegenover stellen; vergelijken; het hoofd bieden; bezwaar hebben tegen; niet toegeven; niet wijken; pal staan; standhouden; weerstaan
continents => continenten
vehicles => voertuigen
strike => raken; houwen; klappen; kloppen; halen; inslaan; aanboren; teisteren; wissen; aanflitsen
right => rechts; recht; juist; correct; goed; rechterkant; eerlijk; rechter-; billijk; rechtvaardig
chorus => koor; refrein; rei; zangkoor; Refrein; Chorus
corner => hoek; accapareren; opkopen; beslag leggen op; hoekschop; straathoek; zich meester maken van; zich toe-eigenen; corner; hoekje
words => woorden; tekst; woordenwisseling
deploying => het inzetten
starvation => uithongering; hongersnood; ondervoeding
unless => tenzij; behalve
waged => gevoerd
mexico => mexico; mexico-stad
wading => waden
left => links; linkerkant; over; linker-; linker; linkerzijde; linksaf; linksom; linkse; blijvend
grenade => granaat; Handgranaat; granaatappel; handgranaat; grenada
fighting => vechten; actief; vecht
humanity => mensheid; mensdom; menselijkheid; humaniteit; mensengeslacht; menslievendheid; medemenselijkheid; mens
without => zonder; gespeend van; ontbloot van; verstoken van; zonder te; buiten; ex; daarbuiten; geen; tenzij
lay => leggen; wereldlijk; vlijen; neerleggen; leken-; ligging; plaatsen; zetten; leke-; uitbrengen
sky => hemel; lucht; firmament; uitspansel; hemelgewelf; zwerk; luchtruim; ruimte; heelal; klimaat
wasteland => woestenij; wildernis; woestijn; braak; braakliggend terrein
taking => afname; vangst; aantrekkelijk; besmettelijk; pakkend
plain => vlakte; duidelijk; zuiver; eenvoudig; klaar; helder; vlak; uitgesproken; kaal; gewoon
scores => scores
flesh => vlees; vruchtvlees; mensenkleur; vel; vervetten; aandikken; verdikken
mortal => sterfelijk; sterveling; dodelijk; sterfelijke; moorddadig; ontzettend; verschrikkelijk
casualties => doden en gewonden
crumbling => brokkelig
fallen => gevallenen; gevallen; fallen
through => door; doorheen; met; per; geheel; heel; volledig; via; aan; af
plains => vlaktes
percentage => procent; percentage; percent; rente; gehalte; boodschap; commissie; commissieloon; opdracht
niger => niger
hand => hand; overhandigen; werkman; werkkracht; wijzer; aanreiken; aangeven; geleiden; greep; handgreep
pyongyang => pyongyang
full => vol; volledig; compleet; verzadigd; ruim; zat; totaal; volkomen; wijd; geheel
commanders => bevelhebbers
planned => gepland
firefights => vuurgevechten
bring => brengen; aandragen; bezorgen; aanvoeren; aanbrengen; afhalen; besturen; geleiden; leiden; medebrengen
five => vijf
weapon => wapen; gevechtswapen
each => elk; ieder; elke; al; alle; iedere; met; per; alleman; elkeen
war => oorlog; krijg; gevecht; strijd; oorlogvoeren; strijden; conflict; geschil; kamp; oorlog voeren
clashes => botsingen
granted => toegestaan
rein => teugel; besturen; beteugelen; hoofdstel; leidsel; Tuigage; toom; intomen; tuigage
heard => gehoord
venezuela => venezuela
delay => vertraging; uitstellen; vertragen; uitstel; oponthoud; verdagen; verschuiven; achterstand; verdaging; aanhouden
chairman => voorzitter; president; preses; praeses
entire => geheel; heel; gans; compleet; vol; volledig; algeheel; totaal; volkomen; volslagen
asset => activa; aanwinst; prooi; acquisitie; buit; verkrijging; bezit; voordeel; pluspunt; verwerving
fierce => woest; fel; heftig; hevig; barbaars; gruwelijk; meedogenloos; wreed; wreedaardig; scherp
waste => afval; verspillen; verkwisten; verdoen; verspilling; rommel; verklungelen; vermorsen; verkwisting; vuil
rivals => rivalen
state => staat; toestand; verklaren; land; rijk; situatie; beweren; gesteldheid; verzekeren; bekendmaken
wars => oorlogen
financed => gefinancierd
valleys => valleien
iran => iran
arms => wapen; armen; krijg; blazoen; wapenschild; wapens
windswept => winderig
plan => plan; plannen; ontwerp; ontwerpen; concept; bedoeling; blauwdruk; doel; opzet; plattegrond
countries => landen
order => orde; bevelen; order; bestellen; bestelling; bevel; ordenen; volgorde; commanderen; gebod
according => volgens; blijkens; ingevolge; afhankelijk; luid; overeenkomstig
preemptive => preventief
continue => voortzetten; doorgaan; verdergaan; vervolgen; continueren; aanhouden; voortduren; voortgaan; beklijven; duren
screeching => gekrijs
offensive => offensief; aanvallend; beledigend; aanval; weerzinwekkend; inval; walgelijk; attaque; smadelijk; stotend
every => ieder; elk; al; alle; iedere; elke; alleman; allemaal; allen; alles
funds => voorraad; contanten; geldmiddelen
parade => parade; optocht; paraderen; prijken; pronken; pralen; pralerij; samenscholing; defilé; appèl
air => lucht; luchten; air; wijsje; ventileren; uitzenden; melodie; verluchten; voorkomen; uiterlijk
just => net; rechtvaardig; slechts; juist; billijk; maar; enkel; pas; zojuist; precies
officials => ambtenaren
savage => wild; barbaars; woest; wilde; onbeschaafd; onbeschoft; barbaar; wreed; primitief; gruwelijk
exploding => exploderende
ash => as; es; essenhout; asse; stof; Essen; ash
thursday => donderdag
terror => terreur; verschrikking; schrik; schrikbewind; ontzetting; angst; paniek; schrikkelijkheid; vrees; bezorgdheid
syria => Doordraaien; syrië
suggested => suggereerde
warhead => springkop; kop; Springkop
earth => aarde; grond; aarden; land; begraven; bodem; aardbol; aanaarden; aardbodem; aardrijk
conceivable => denkbaar; bestaanbaar; haalbaar; mogelijk; geloofwaardig; begrijpelijk
fixed => vast; onbeweeglijk; star; strak; afgesproken; bepaald; bepalend; geregeld; ingesteld; stationair
intended => bedoeld; bewust; doelbewust; expres; intentioneel; moedwillig; opzettelijk; voorbedacht; welbewust; weloverwogen
joint => gewricht; gezamenlijk; joint; stickie; gemeenschappelijk; nor; geleding; gelid; knoop; bak
justice => gerechtigheid; rechtvaardigheid; recht; justitie; billijkheid; berechting; gerecht; rechtsbedeling; raadsheer; rechtspleging
soon => spoedig; binnenkort; gauw; weldra; dra; alras; haast; straks; eerlang; eerstdaags
must => moeten; most; behoren; dienen; horen; zullen; behoeven; must; schimmel; hebben
serious => ernstig; serieus; belangrijk; erg; bedenkelijk; voornaam; zorgwekkend; zwaar; angstig; bang
usurping => usurping
intend => van plan zijn; bedoelen; beogen; mikken; mikken op; rooien; ten doel hebben; voorhebben; voornemens zijn; zich voorstellen
hundreds => honderden
length => lengte; langdurigheid; afstand; duur; stuk; tijdsduur; eind; grootte; lengtemaat; overmaat
unto => tot; naar; tot aan
clash => conflict; botsing; botsen; schermutseling; tegenstrijdigheid; strijd; confrontatie; schok; stoot; treffen
armored => gepantserd; beveiligd
philippines => filipijnen
forces => krachten
officers => officieren
northwest => noordwest; noordwesten; noordwestelijk
weeks => weken
crush => verpletteren; vermalen; pletten; vermorzelen; malen; fijnstampen; verbrijzelen; toeloop; bevlieging; dranghek
adding => toe te voegen
beloved => geliefd; geliefde; beminde; lief; bemind; dierbaar; welbemind; liefste; duur; geacht
service => dienst; bediening; eredienst; servies; service; godsdienstoefening; kerkdienst; opslag; ambt; baan
antarctic => antarctisch; Zuidpool
once => eens; eenmaal; ooit; op een keer; zodra; één keer; een keer; eenmaaal; van zodra; wanneer
quarter => wijk; kwart; kwartaal; buurt; vierde; stadswijk; trimester; kwartier; kwartje; inkwartieren
unlike => verschillend; anders; ongelijk; anders dan; heterogeen; in tegenstelling tot; uiteenlopend
capture => vangen; beetkrijgen; pakken; bemachtigen; beetnemen; veroveren; buit; vangst; vatten; gevangennemen
weapons => bewapening; wapens
epic => episch; epos; heldendicht; heldhaftig; heldengedicht; epiek; verhalend
possession => bezit; bezitting; eigendom; goed; bezetenheid; bezittingen; vermogen; possessie; possession
centers => centers
shed => schuur; loods; vergieten; storten; afwerpen; afdak; luifel; werpen; gieten; keet
dunford => dunford
staff => staf; notenbalk; personeel; balk; medewerkers; stok; paal; baar; pijp; roede
charred => verbrand; verschroeid
ravage => afstropen; uitschudden; verwoesten; verwoesting; plundering; teisteren; plunderen; ravage; ruïneren; vernielen
viscera => ingevolgewanden; ingewand; ingewanden
amassed => vergaard
final => finale; finaal; definitief; laatste; uiteindelijk; eindexamen; eindronde; ultiem; onherroepelijk; vast
fronts => fronten
under => onder; beneden; onderste; onderdoor; volgens; blijkens; krachtens; minder dan
cry => huilen; wenen; schreeuwen; schreeuw; schreien; roepen; kreet; roep; krijten; gillen
citizens => burgers
become => worden; raken; gebeuren; goed staan; passen; toegaan; voortgang hebben; zich schikken; betamen; goed zitten
lasting => blijvend; aanhoudend; bestendig; gedurig; voortdurend; constant; continu; onafgebroken; onophoudelijk; vast
do => doen; maken; gedoe; bedrijven; do; fuif; gaan; genoegen; goeddoen; bakken
unleashed => losgelaten
desk => bureau; lessenaar; schrijftafel; schrijfberd; lezenaar; schrijfbureau; balie; tafel; buro; advocatenkantoor
wouldn => wouldn
fact => feit; werkelijkheid; Feit
mo => mo
aside => opzij; terzijde; zijwaarts
got => gekregen
bus => bus; autobus; de; met; afruimen; vervoeren; reizen; autocar; stadsbus
really => werkelijk; echt; wezenlijk; waarlijk; waarachtig; inderdaad; heus; naar waarheid; eigenlijk; daadwerkelijk
eye => oog; kijker; bekijken; observeren; gadeslaan; in het oog houden; nakijken; gezichtsorgaan; naaldoog; oculus
get => behalen; aankomen; raken; kopen; buit maken; buitmaken; doorkomen; inhalen; inslaan; klaarspelen
working => bewerking; moeite; poging; werking; bebouwing; bediening; bedrijf; beschaving; bouw; cultuur
o => o; te; mede; ook
friday => vrijdag
him => hem; hij; aan hem; naar hem; aan ’m; haar; het; naar ’m; ’ie; ’m
news => nieuws; nieuwigheid; journaal; nieuwtje; bericht; nieuwsberichten; actualiteiten; iets actueels; tijding
hugh => hugo
individually => individueel; achtereen; achterelkaar; afzonderlijk
ignored => buiten beschouwing gelaten
dies => doodgaan
devastated => verwoest
almost => bijna; vrijwel; bijkans; haast; nagenoeg; zo goed als; schier; zowat; welhaast; amper
think => denken; nadenken; vinden; menen; geloven; achten; van mening zijn; beschouwen; vermoeden; bedenken
new => nieuw; vers; opkomend; ander; jong; opnieuw; weer; nieuwe; apart; kersvers
wenzel => wenzel
going => stap; gang
coworkers => collega's
invited => uitgenodigd
struggling => worstelen
bat => vleermuis; slaghout; knuppel; kolf; racket; slaan; vleermuizen
hard => hard; moeilijk; zwaar; straf; harde; sterk; kalkrijk; onweerlegbaar; inspannend; lastig
whether => of; hetzij; weder; of .. of; hè
press => pers; drukken; aandrukken; persen; knellen; urgent zijn; dringen; drukpers; haasten; jachten
care => zorg; zorgen; verzorging; bezorgd zijn; zorgvuldigheid; bekommernis; kommer; verzorgen; zich bekommeren; verpleging
explaining => uitleggen
way => manier; weg; wijze; gewoonte; baan; gebruik; usance; afstand; route; methode
drinks => drankjes
leaving => afscheid; afreis; overlijden
fallon => vallen op
representative => vertegenwoordiger; afgevaardigde; representatief; gedeputeerde; gedelegeerde; zaakbezorger; zaakwaarnemer; exponent; makelaar; plaatsvervanger
hit => kloppen; klappen; houwen; halen; inslaan; teisteren; furore; opvallen; succes; treffer
group => groep; groeperen; groepering; verzameling; stel; troep; hoop; schare; kudde; school
chair => stoel; zetel; leerstoel; voorzitterschap; crapaud; fauteuil; keukenstoel; kinderstoel; klapstoel; kuipstoel
send => verzenden; zenden; sturen; opsturen; doen toekomen; opzenden; expediëren; uitzenden; versturen; afzenden
ripple => kabbelen; rimpeling; repelen
decision => beslissing; besluit; uitspraak; verdict; wijzing; beslistheid; arrest; uitslag; Europees besluit; conclusie
pretty => mooi; aardig; nogal; beminnelijk; vriendelijk; lief; tamelijk; leuk; keurig; knap
unsure => onzeker
inform => informeren; inlichten; voorlichten; meedelen; berichten; verwittigen; mededelen; verklikken; aankondigen; in kennis stellen
didn => jonathan bourdon
assure => verzekeren; betuigen; beveiligen; geruststellen; afzekeren; waarborgen; assureren; uitvoeren; behoeden; beloven
maybe => misschien; mogelijk; mogelijkerwijs; wellicht; het zou kunnen; soms
away => weg; verwijderd; heen; over; vandoor; voort; afwezig; dada; exit; foetsie
knew => kende; kenden; wist; wisten
reportedly => naar verluidt
miss => missen; juffrouw; mislopen; misgrijpen; misser; kijken; mislukking; niet; ontwijken; snappen
job => baan; werk; taak; job; betrekking; karwei; arbeid; beroep; ambt; werkkring
email => e-mail; e-mailen; mailen; mail; email; e-mailbericht; elektronische post; E-mail; bericht sturen
goodbye => dag; tot ziens; doei; houdoe; adieu; vaarwel; goedendag; tot weerziens; afscheid; afscheids-
here => hier; hierheen; alhier; hierzo; heden; hier en nu; domicilie; hiero; huis; verblijf
opportunity => kans; gelegenheid; mogelijkheid; gebeuren; gebeurtenis; incident; geval; voorval; opportuniteit; geluk
his => zijn; de zijne; het zijne; aan hem; haar; hun; diens; d’r; hare; het hare
local => plaatselijk; lokaal; stamkroeg; lokaaltrein; lokale trein; plaatselijke bewoner; stamcafé; stoptrein; alhier; aanstaand
m => m
want => willen; verlangen; begeerte; lust; wens; zin; wensen; tekort; behoefte; gebrek
sales => uitverkoop; verkoop; afzet; inkoopactie; distributie; koopovereenkomst; omzet; verkopen
same => hetzelfde; dezelfde; identiek; dito; gelijk; zelfde; -zelfde; datzelfde; eender; op dezelfde wijze
feels => voelt
imagination => verbeelding; verbeeldingskracht; inbeelding; fantasie; voorstelling; voorstellingsvermogen; droomgezicht
mining => mijnbouw; mijnarbeid
instagram => instagram
suspects => verdachten
claimed => geclaimd
don => aantrekken; zich; maffiabaas; uitdossen; don; prof; professor; aandoen
trust => vertrouwen; geloof; fiducie hebben in; toevertrouwen; fiducie; vertrouwen hebben in; afgaan op; vertrouwen op; vertrouwen stellen in; trust
tell => vertellen; zeggen; opgeven; voorschrijven; verhalen; bevelen; gelasten; tell; debiteren; opdragen
chris => chris
christopher => christophe
company => bedrijf; gezelschap; firma; zaak; maatschappij; compagnie; vennootschap; bezoek; bezoekers; handelsfirma
spitting => spugen
suppose => veronderstellen; aannemen; vermoeden; stellen; menen; gissen; denken; geloven; inbeelden
face => gezicht; aangezicht; gelaat; zijde; gelaatsuitdrukking; bakkes; de confrontatie aangaan met; mee afrekenen; onder ogen zien; tegemoet gaan
ask => vragen; verzoeken; eisen; aanvragen; inroepen; bestellen; vereisen; vergen; verlangen; opeisen
awkward => onhandig; genant; ongemakkelijk; onbeholpen; log; pijnlijk; plomp; lastig; penibel; stumperig
ranged => varieerden
journalists => journalisten
sure => zeker; stellig; vast; gewis; wis; verzekerd; vaststaand; veilig; jazeker; ongetwijfeld
hours => uur
massive => massief; massaal; enorm; gigantisch; grootscheeps; sterk; stevig; zwaar; geweldig; immens
dozens => tientallen
anymore => niet meer; langer; meer
operative => werkzaam; arbeider; werker; werkkracht; werkman; werkmier; agent; bedrijver; dealer; politieagent
practices => praktijken
changed => veranderd
mean => betekenen; bedoelen; gemeen; gemiddelde; menen; gemiddeld; van plan zijn; willen zeggen; boosaardig; willen
telling => indrukwekkend; krachtig
london => londen
office => kantoor; bureau; dienst; ambt; betrekking; plaats; baan; werkkring; overheidsdienst; bureel
posts => posts
noting => opmerkend
considering => gezien; aangezien
recent => recent; vers; fris; luchtig; onbedorven; laatst; nieuw; jongste; juist gebeurd; van jonge datum
occasional => toevallig; occasioneel; gelegenheids-; af en toe; nu en dan; indicenteel; incidenteel; dungezaaid; gelegenheids‐
whistleblower => klokkenluider
old => oud; bejaard; vergevorderd; antiek; ouderwets; aftands; aloud; bouwvallig; gammel; oudheid
highly => hoog; zeer; hoogst; hogelijk; in hoge mate; uitermate; buitengewoon; erg; heel
facebook => Facebook
scope => bereik; domein; scoop; reikwijdte; omvang; bestek; grootte; strekking; terrein; uitgebreidheid
recently => recentelijk; onlangs; laatst; de laatste tijd; kort geleden; overlaatst; recent; kortelings; kortgeleden
reveal => onthullen; openbaren; afkondigen; kenbaar maken; openbaar maken; publiceren; ruchtbaar maken; ontwikkelen; loslaten; aandienen
seems => lijkt
something => iets; ergens; wat; aanblaffen; aangelegenheid; aansprakelijk; affaire; ding; een duister beeld schetsen; een somber beeld schetsen
unethical => immoreel; infaam; laaghartig; oneerlijk; oneervol; ongehoord; onzedelijk; schandelijk; verdorven; voos
conspicuously => opvallend
did => deden; deed; gedaan
analytica => analytica
directly => direct; meteen; dadelijk; rechtstreeks; zo; rechtuit; aanstonds; rechtop; eerlijk; zodadelijk
blow => blazen; waaien; slag; ontploffen; springen; klap; mep; pijpen; tegenslag; spuiten
avoiding => vermijden
business => zaken; zaak; bedrijf; vak; klandizie; onderneming; zakenleven; aangelegenheid; ding; businessclass
honestly => eerlijk; oprecht; behoorlijk; echt; eigenlijk; exact; fatsoenlijk; gevoeglijk; innig; juist
vibe => vibraties
wylie => wylie
coldness => kou; koude; onverschilligheid; koud; frigiditeit
contact => contact; aanraking; aanraken; contacteren; contact hebben met; contact hebben; voeling; contactpersoon; contact maken met; Omgangsrecht
unusually => ongewoon; ongebruikelijk; abnormaal; afwijkend; onregelmatig; apart
incident => voorval; gebeurtenis; incident; gebeuren; episode; inherent; inslaand; bijkomstig; geval; invals-
happy => gelukkig; blij; tevreden; zegenrijk; verheugd; vrolijk; bedreven; handig; kundig; verblijd
cambridge => cambridge
pissed => dronken; teut; beneveld; beschonken; bezopen; kachel; zat
authorities => overheid; autoriteiten
couple => paar; koppel; koppelen; stel; duo; tweetal; echtelieden; echtpaar; span; paren
doesn => doesn
me => me; mij; ik; mijn; m'n; aan me; aan mij; naar me; naar mij; mezelf
operation => operatie; bewerking; ingreep; handeling; exploitatie; verrichting; werking; bediening; bedrijf; behandeling
leadership => voorzitterschap; leiderschap; leiding
d => D
case => naamval; geval; kist; zaak; kast; aangelegenheid; casus; doos; proces; rechtszaak
acted => gehandeld
superior => superieur; meerdere; prevalent; opperste; baas; chef; aanvoerder; bovenste; voortreffelijk; beter
promises => beloften
role => rol; functie; taak; sociale rol; ambt; hoedanigheid; verantwoordelijkheid; personage; hoofdrol; plicht
points => wissel; punten
look => kijken; uiterlijk; uitzien; blik; lijken; uitzicht; bekijken; verschijning; kijk; schijn
juicy => sappig; smeuïg; pittig; smakelijk
alarm => alarmeren; alarm; beangstigen; alarm slaan; wekker; alarmsignaal; verontrusten; ontsteltenis; verbijstering; alarmklok
spying => spionage; spioneren
private => privé; besloten; particulier; persoonlijk; onderhands; privé-; privaat; ambteloos; soldaat; eigen
federal => federaal; bonds-
reflected => gereflecteerd; réfléchi; weloverwogen
conversation => gesprek; conversatie; onderhoud; bespreking; discussie; dialoog; grapjasserij; scherts
jr => jr
chili => chilipeper; chili; paprika; Spaanse peper; rode peper
quite => tamelijk; nogal; volkomen; vrij; bijster; erg; heel; bijzonder; geheel; helemaal
district => district; wijk; gebied; buurt; gouw; regio; arrondissement; stadswijk; kanton; departement
code => code; coderen; wetboek; programmeren; cijfer; geheimschrift; sleutel; cijferschrift; geheimtaal; reglement
book => boek; boeken; reserveren; album; noteren; te boek stellen; vlammen; bespreken; bestellen; beboeten
day => dag; etmaal; heden; vandaag; zon; daglicht
enforcement => handhaving; Handhaving; dwang; gebruik; toepassing
someone => iemand; een of ander; een of andere; enig; deze of gene; persoon; aanblaffen; een duister beeld schetsen; een somber beeld schetsen; van
clinton => clinton
john => hoerenloper; latrine; prostituant; privaat; toilet; wc; john
brushing => borstelen
fears => angsten
autobiography => autobiografie
biggest => grootst
childhood => kinderjaren; kindsheid; kindertijd; jeugd; kinderachtigheid; kind; childhood; aanvang
revelations => onthullingen
album => album; gedenkboek; muziekalbum; plaat; fotoalbum
believes => gelooft
commercially => commercieel
successful => succesvol; geslaagd; gelukt; voorspoedig; efficiënt; gelukkig; met goed gevolg
anything => iets; alles; wat dan ook
controversial => omstreden; controversieel; betwist; kwestieus; aanvechtbaar; bedenkelijk; dubieus; twijfelachtig; verdacht; polemisch
offer => aanbieden; aanbod; presenteren; voorstellen; bod; aanbieding; aanzoek; indienen; offerte; vertonen
worked => werkte
pilots => pilots
inappropriately => ongepast
chapters => hoofdstukken
truth => waarheid; waarachtigheid; werkelijkheid; eerlijkheid; oprechtheid; echtheid; eed; nauwkeurigheid; bewijs
donald => donald
sees => ziet
temple => tempel; slaap; bedehuis; godshuis; kerk; kerkgebouw; poot; brilmontuur; brilveer; moskee
split => splijten; splitsen; kloven; opsplitsen; klieven; verdelen; spagaat; doorklieven; split; grand écart
name => naam; noemen; benoemen; benaming; naamwoord; roep; kiezen; aanstellen; opnoemen; vermelden
lies => leugens
wrong => verkeerd; fout; onjuist; slecht; mis; foutief; kwaad; onrecht; aandoen; benadelen
beef => rundvlees; biefstuk; klapstuk; bief; donderjagen; emmeren; kankeren; katten; meieren; mopperen
muslim => moslim; mohammedaan
americans => amerikanen
election => verkiezing; keuze; optie; keus; keur; Election; electie; stemming; ballotage; kies-
hillary => hillary
recipe => recept; bereidingswijze; inkomen; ontvangst; ontvangstkamer; opbrengst; procédé; receptie; verdienste; werkwijze
clerk => klerk; kantoorbediende; bediende; schrijver; secretaris; winkelbediende; commies; kantoorklerk; actuaris; griffier
adolescence => adolescentie; puberteit; adolescent; jeugd; jongelingsjaren; jongere
teeth => gebit; tanden; tand
comey => coney
distracted => afgetrokken; verstrooid; dol; krankzinnig; radeloos; uitzinnig; verbijsterd; verward
walker => wandelaar; voetganger; looprek; loper; rollator; Rollator
presidency => presidentschap; college van bestuur; praesidium; voorzitterschap
james => james
fbi => fbi
stone => steen; stenen; stenigen; pit; aarden; rots; van klei; pion; steentje; stuk
mirror => spiegel; afspiegelen; weerspiegelen; speigel; spiegelen; toonbeeld; weerkaatsen; weerspiegeling; mirror; bedenken
broth => bouillon; bouillonsoep; vleesnat; consommé; soep
famous => beroemd; befaamd; alom bekend; vermaard; wijdvermaard; gevierd; roemrijk; gerenommeerd; glorierijk; roemruchtig
higher => hoger
trump => troef; overtroeven; aftroeven; troeven; mondharmonica; Troef; mondharp
director => directeur; regisseur; bestuurder; leider; administrateur; beheerder; chef; director; hoofd; zetbaas
fucking => fakking; focking; kanker; fucking; kut; neuken
details => gegevens
purple => paars; purper; purperen; violet; magenta; pimpelpaars; lila; purperrood; violetkleurig
expect => verwachten; wachten; te wachten staan; afhalen; rekenen; anticiperen; verbeiden; afwachten; bedacht zijn op; denken
presidential => presidentieel
former => voormalig; eerstgenoemde; verleden; vroeger; deze; voorafgaand; voorgaand; gewezen; toenmalig; vorig
records => archief; administratie
judge => oordelen; rechter; beoordelen; schatten; achten; beoordelaar; berechten; taxeren; achting hebben voor; begroten
law => wet; recht; theorema; decreet; politie; rechtspleging; regel; regeling; smeris; wetgeving
inside => binnen; in; binnenkant; te; per; binnenin; aan; daarbinnen; inwendig; binnenste
loyalty => trouw; loyaliteit; oprechtheid; aanhankelijkheid; eerlijkheid; getrouwheid
dining => dining
shut => sluiten; dichtdoen; dichtmaken; toedoen; afsluiten; dichtklappen; dicht; gesloten; toe; op slot doen
pries => pries
pull => trekken; ruk; rukken; trek; slepen; naar zich toe halen; pull; voorttrekken; aantrekkingskracht; haal
visiting => bezoekende
try => proberen; uitproberen; trachten; pogen; beproeven; poging; streven; toetsen; zich inspannen; berechten
itinerary => routebeschrijving; reisgids; route; weg; wegbeschrijving; reisverslag; reisplan; tracé; koers; reisbeschrijving
bartenders => barmannen
piece => stuk; onderdeel; deel; brok; fragment; stukje; eindje; gedeelte; pion; bonk
sad => triest; verdrietig; treurig; bedroefd; droevig; droef; triestig; verdrietelijk; somber; bedroevend
three => drie; drietal; gedrieën
sock => sok; kous; mep; raken; smijten
seem => lijken; schijnen; overkomen; toeschijnen; voorkomen; dunken; er uitzien; het uiterlijk hebben van
copy => kopiëren; kopie; kopij; nabootsen; nadoen; afschrift; exemplaar; imiteren; nabootsing; naäpen
leave => afreizen; zich verwijderen; loslaten; op reis gaan; toelaten; overlaten; vrijaf; in de steek laten; uitgaan; uitlopen
boater => strohoed; boater; strooien hoed
up => omhoog; op; opwaarts; naar boven; aan; bereid; beschikbaar; klaar; langs; mee
prefer => prefereren; verkiezen; voorkeur geven; de voorkeur geven aan; liever hebben; voortrekken; meer houden van; opteren; begunstigen; bevorderen
straw => stro; rietje; strohalm; strohuls; strooien
spouse => echtgenoot; eega; gade; echtgenote; man; gemaal; vrouw; wederhelft; eegade; ga
neck => nek; hals; flessenhals; nekken; wurgen; baarmoederhals; bottleneck; landengte; nikker; worgen
traveling => op reis
travel => reizen; reis; rijden; gaan; varen; karren; lopen; bereizen; verplaatsen; verlopen
trip => reis; struikelen; tocht; toer; trip; uitstapje; uitstap; excursie; fout; tocht trip
thing => ding; voorwerp; object; onderwerp; lijdend voorwerp; mikpunt; punt; zaak; schepsel; Ding
identify => identificeren; vereenzelvigen; determineren; herkennen; onderkennen; beleggen; erkennen; houden; leggen; plaatsen
servers => servers
solo => solo; alleen; een solo spelen; Solo
crane => kraanvogel; hijskraan; kraan; lift; bok; hefkraan; hevel; kraanvogels
terrible => vreselijk; verschrikkelijk; ijselijk; afschuwelijk; schrikaanjagend; vervaarlijk; ontzettend; schrikwekkend; gruwelijk; erg
city => stad; grote stad; plaats; wereldstad; city; binnenstad; stadskern; City; centrum
letting => verhuur
tips => tips
grass => gras; wiet; kruid; weiland; marihuana; grasmat; grazen; verklikker; weiden
extra => extra; figurant; additioneel; aanvullend; supplementair; supplerend; toegevoegd; extraatje; meer; nevenfiguur
feel => voelen; betasten; gevoelen; gewaarworden; tasten; aanvoelen; bevoelen; rieken; ruiken; geuren
re => betreft; wat; betreffende; opnieuw; re
yourself => jijzelf; uzelf; jezelf; zelf
give => geven; schenken; overhandigen; verlenen; cadeau geven; opbrengen; toekennen; aangeven; doneren; aanreiken
things => dingen; spullen; spul; goedje; kledij; kleding; kleren; ding
everywhere => overal; alom; wijd en zijd; allerwegen; overal waar; overall
experience => ervaring; beleven; belevenis; ervaren; ondervinden; ondervinding; meemaken; ondergaan; beleving; kennis
anyone => iemand; iedereen; wie; wie dan ook; een ieder; elkeen; wie ook
mustard => mosterd; mosterdplant; mustard; mostaard
believe => geloven; menen; denken; houden voor; geloven in; in; agnosceren; erkennen; honoreren
happen => gebeuren; geschieden; voorkomen; voorvallen; toegaan; overkomen; aan de hand zijn; voortgang hebben; worden; plaatsvinden
pay => betalen; uitbetalen; dokken; storten; loon; uitkeren; salaris; voldoen; bezoldigen; lonen
remind => herinneren; erop komen; reproduceren; terughalen; aanmanen; doen denken; doen denken aan
meeting => vergadering; bijeenkomst; samenkomst; ontmoeting; zitting; meeting; ontmoetingsplaats; beraad; overleg; treffen
sprig => spruit; takje; gard; roede; spitsroede; stokje; tak
onion => ui; ajuin; kop; onion; ui m
putting => zetten
id => Es; id; Id; legitimatie; winde
suitcases => bagage
suit => pak; kostuum; set; stel; stelletje; kleur; schikken; zaak; complet; passen
throw => gooien; werpen; worp; smijten; keilen; uitspelen; afwerpen; gooi; kleien; omgooien
offers => aanbieden
obligated => verplicht
plaid => geruit; plaid; schotse ruit
died => gestorven
roller => rol; cilinder; roller; scharrelaar; wals
make => maken; doen; bedrijven; aanmaken; brengen; uitvoeren; vormen; bouwen; laten; uitbrengen
entertain => vermaken; amuseren; onderhouden; recipiëren; ontvangen; gastvrijheid verlenen aan; vrijhouden; koesteren; onthalen; afleiden
buildings => gebouwen
traipse => rondzwerven
gawking => gapen
never => nooit; nimmer; helemaal niet
em => em; gedachtestreep; wit
again => opnieuw; weer; alweer; nogmaals; wederom; weder; van voren af aan; ook al weer; terug; verder
friends => vrienden
rewarding => bevredigend; dankbaar; de moeite waard
groups => groepen
trail => spoor; pad; karrespoor; wagenspoor; route; afdruk; voetspoor; slepen; sliert; staart
off => uit; weg; af; heen; over; vandoor; verwijderd; voort; naast; nabij
family => familie; gezin; huis; clan; huisgezin; stam; geslacht; huishouden; serie; bloedverwant
impression => indruk; impressie; effect; deuk; uitbeelding; verbeelding; voorkomen; afdruk; belichting; mening
carrington => carrington
mentally => geestelijk; mentaal; intellectueel; psychisch
scene => scène; toneel; tafereel; tableau; landschap; scherm; blik; schandaal; schouwtoneel; uitzicht
stand => staan; kraam; opstaan; uitstaan; stand; standplaats; verdragen; doorstaan; weerstaan; loods
event => gebeurtenis; evenement; voorval; gebeuren; gelegenheid; geval; incident; belangrijke gebeurtenis; gebeurde; episode
horrified => ontsteld
hangout => chillen
michele => michele
possibility => mogelijkheid; kans; gelegenheid; geluk; opportuniteit; toeval; contingentie; eventualiteit
discussions => discussies
encourages => moedigt
complex => complex; ingewikkeld; samengesteld; gecompliceerd; geheel; samenstel
movies => bios; bioscoop
route => route; weg; tracé; baan; baanvlak; reisplan; leiden; traject; sturen; hoofdweg
absolute => absoluut; onvermengd; volkomen; volstrekt; onvoorwaardelijk; onbetwistbaar; puur; rein; compleet; volledig
action => actie; handeling; werking; daad; optreden; mechanisme; beweging; proces; strijd; geding
instilled => bijgebracht
felt => vilt; vilten; vilthoed
abuse => misbruik; misbruiken; mishandelen; mishandeling; uitschelden; verkrachten; belediging; beschimpen; beschimpingen; onteren
car => auto; wagen; automobiel; wagon; kar; rijtuig; spoorwagen; voertuig; tram; bak
plays => toneelstukken
martha => martha
prevalence => prevalentie; overwicht; Prevalentie; gangbaarheid
recognition => erkenning; herkenning; identificatie; Herkenning
reënacts => reenacts
aesthetic => esthetisch; esthetische; esthetica; schoonheidsleer
girl => meisje; meid; griet; grietje; meidje; meiske; mietje; vrouw; dochter
belief => geloof; overtuiging; vertrouwen; geloven; doctrine; dogma; fiducie; mening; opinie
cinematic => cinematografisch; kinematografisch
suggest => suggereren; voorstellen; aanwijzen; opperen; aangeven; aanduiden; een wenk geven; uitduiden; influisteren; kiezen
drinking => drinken
actor => acteur; toneelspeler; komediant; speler; actrice; toneelspeelster; actor; agent; bedrijver; dealer
observation => waarneming; opmerking; observatie; aanmerking; standje; blaam; waarnemen; berisping; terechtwijzing; aandacht
admits => geeft toe
courageous => moedig; dapper; boud; kloek; koen; vermetel; ferm; onvervaard; stout; stoutmoedig
rapists => verkrachters
similarly => op dezelfde manier; gelijkend; als; desgelijks; evenals; evenzo; gelijk
grotesquely => grotesquely
then => dan; toen; vervolgens; toenmalig; toentertijd; daarop; destijds; trouwens; daarna; dus
cast => werpen; gieten; gooien; rolverdeling; casten; afgietsel; rolbezetting; cast; gips; uitgooien
relation => relatie; betrekking; verband; omgang; verhouding; opzicht; verkeer; verstandhouding; familielid; verhaal
events => events
experiences => ervaringen
sex => geslacht; seks; sekse; vrijen; kunne; sex; sexe; geslachtsgemeenschap; geslachtsdaad; geslachtsdeel
bold => moedig; vet; vetgedrukt; brutaal; dapper; stoutmoedig; gedurfd; stout; ferm; lijvig
series => reeks; serie; set; ris; rist; opeenvolging; Serie; aaneenschakeling; collectie; rij
archives => archief
arises => ontstaat
men => mensen; heren; mannen; lieden; lui; man
itself => zelf; zichzelf; vanzelf; zelve; zich
prevalent => heersend; overheersend; dominant; dominerend; gezaghebbend; maatgevend; toonaangevend; courant; gangbaar
manenti => manenti
viewer => kijker; toeschouwer; weergaveprogramma
girls => meisjes
staging => enscenering; toneelschikking; mise-en-scène; regie; spelleiding; stellage; tribune
anthology => bloemlezing; antologie; anthologie; chrestomathie
filmmaking => filmproductie
before => voor; eerder; vroeger; voordat; voorheen; vóór; alvorens; voordien; vooraleer; vooraf
dramatizes => dramatiseert
en => En; gedachtestreep; hiëroglief
head => hoofd; kop; chef; leiden; leider; krop; baas; de weg wijzen; aanvoeren; geleiden
already => al; reeds; alreeds; alvast; bereids; nu al; already; dan; een keer; eens
sort => soort; sorteren; aard; slag; rangschikken; geslacht; klasse; schiften; uitzoeken; Sort
talking => oratie; rede; redevoering; speech; spraak; spreken; vertoog; gepraat; praat; sprekend
boys => jongens
sophisticates => sophisticates
roommate => medebewoner; Wohngemeinschaft; kamergenoot; slapie; voordeurdeler
establish => oprichten; stichten; vaststellen; vestigen; bevestigen; constateren; inrichten; funderen; bouwen; baseren
driven => gereden
documentary => documentaire; documentair; actualiteiten; iets actueels
arrival => aankomst; komst; aanvoer; bezorging; bevoorrading; leverantie; levering; plaats van aankomst; proviandering; provisie
sophistication => verfijning
performance => voorstelling; optreden; opvoering; prestatie; spel; uitvoering; vervulling; performance; opvoeren; vermogen
herself => zelf; vanzelf; zijzelf; zelve; zichzelf; zich
reënactment => het weer invoeren
raped => verkracht
framework => kader; lijst; framework; geraamte; omlijsting; raam; raamwerk; bouw; samenstelling; vakwerk
shown => getoond
varied => verschillend; menigvoudig; menigvuldig; gevarieerd; afwisselend; bont; divers; gemengd; gevariëerd; veelsoortig
racist => racist; racistisch
effort => inspanning; moeite; poging; worsteling; krachtsinspanning; arbeid; demarche; diplomatieke stap; inzet; prestatie
submerged => ondergedompeld
memories => herinneringen
dismaying => dismaying
streaming => streaming
card => kaart; kaarden; speelkaart; troef; agenda; controleren; kaardplank; kaardrol; plan; schema
feelings => gevoelens
parties => partijen
moment => moment; ogenblik; tijdstip; oogwenk; tel; wijl; wip; stond; wijle; Moment
staged => geënsceneerd; geleidelijk; gradueel
dead => dood; gestorven; overleden; dode; doden; dodelijk; gestorvenen; overledenen; doods; bloed-
eight => acht; achtste
depicted => afgebeeld
brings => brengt
crude => ruw; grof; onbewerkt; primitief; bot; cru; onbehouwen; naakt; onafgewerkt; ongeraffineerd
adolescent => puber; adolescent; pubermeisje; tiener; jongvolwassene; puberaal; jongere; opgeschoten; opgroeiend
discusses => bespreekt
genre => genre; genrestuk; soort; geslacht; aard; klasse; slag; woordgeslacht
misguided => misleid; misplaatst
slut => slet; hoer; snol; lichtekooi; sloerie; stoephoer; publieke vrouw; del; slons; bitch
situation => situatie; stand; toestand; ligging; stand van zaken; plaats; houding; positie; kader; conditie
negotiate => onderhandelen; handeldrijven; handelen; zaken doen; negotiëren; handel drijven; sluiten; tot stand brengen; verhandelen
reflect => reflecteren; weerkaatsen; weerspiegelen; spiegelen; terugkaatsen; nadenken; afspiegelen; bedenken; beschouwen; overdenken
importance => belang; belangrijkheid; betekenis; gewicht; consequentie; importantie; kaliber; gewichtigheid; relevantie; baat
open => openen; open; openmaken; opendoen; opengaan; aansnijden; breedvoerig; groot; omvangrijk; openhartig
precocious => vroegrijp; vroegvolwassen; voorlijk
industry => industrie; nijverheid; vlijt; ijver; sector; naarstigheid; werklust; bedrijfsleven; bedrijfstak; branche
layers => lagen
evoke => oproepen; naar buiten roepen; ten gevolge hebben; uitlokken
merit => verdienste; verdienen; waard zijn; toekomen; waardig zijn; autoriteit; beroemdheid; gezag; glorie; lof
falsification => vervalsen; vervalsing; vervorming; falsificatie
rapes => verkrachtingen
using => gebruik
artistically => kunstzinnig
actual => werkelijk; daadwerkelijk; feitelijk; effectief; eigenlijk; huidig; reëel; actueel; echt; wezenlijk
prep => prep
distortion => distorsie; vervorming; verdraaien; Oversturing; deformatie; distortion; verdraaiing; verstuiking
mores => gebruik; zede; gewoonte; usance; mores; gebruiken; gewoonten
longtime => lang; langdurig; lange tijd
media => media
making => fabricage; aanmaak; fabricatie; gedoe; vervaardiging; farad; formatie; vorming; making
carouse => zuipen
she => zij; ze; hij; haar; d’r; ’r; het; ik; jij; d'r
friend => vriend; vriendin; vriendje; vriendinnetje; medestander; maatje; vrind; bevriend zijn met; amice; geestverwant
light => licht; aansteken; helder; schijn; schijnsel; lichtend; verlichten; bijlichten; lichten; aanmaken
captures => captures
perspectives => perspectieven
reconstruction => wederopbouw; reconstructie; herstel; herstelling; herbouw
school => school; scholen; leerschool; universiteit; kunstrichting; schools; africhten; leren; onderrichten; onderwijsinstelling
embedded => ingebed; vastgebetonneerd; verankerd; ingebouwd
immediately => onmiddellijk; meteen; dadelijk; direct; schielijk; zo; aanstonds; terstond; op staande voet; subiet
alike => gelijk; gelijkend; soortgelijk; gelijksoortig; gelijkvormig; eender; hetzelfde; evenzeer; even; gelijkelijk
course => koers; cursus; gang; baan; loop; route; leergang; parcours; gerecht; tracé
describes => beschrijft
within => binnenin; binnen; in; per; te; aan; daarbinnen; innerlijk
next => volgend; naast; volgende; vervolgens; aanstaand; daarna; eerstkomend; aankomend; dan; eerstvolgend
society => maatschappij; samenleving; gezelschap; sociëteit; club; vereniging; gemeenschap; genootschap; kring; krans
curly => krullenbol; krullig; krullerig; gekruld; gekruld.; kroes; krullend
recovery => herstel; terugwinning; genezing; berging; behoud; heil; redding; uitkomst; uitredding; verlossing
expands => breidt uit
input => invoer; invoeren; ingeven; ingang; input; aandienen; aankondigen; adverteren; annonceren; bijdragen
feature => eigenschap; gelaatstrek; trek; bevatten; hoofdartikel; met; karaktertrek; benadrukken; laten; oplichten
standard => standaard; norm; standaardmaat; banier; regel; vlag; maatstaf; vaandel; veldteken; vendel
empathetic => empathisch
corrective => correctief
expressed => uitgedrukt
converges => convergeert
extraordinarily => buitengewoon; bijzonder; uitzonderlijk
attack => aanval; aanvallen; aanslag; offensief; aangrijpen; attaque; aantasten; aanvalszijde; aanranding; vlaag
looks => uitzicht; air; gelaatsuitdrukking; gezicht; mijne; uiterlijk
trouble => storen; probleem; moeilijkheid; hinderen; last; moeite; bezwaar; strubbeling; zorg; verstoren
talks => gesprekken
sets => verzamelingenleer
pregnant => zwanger; drachtig; in verwachting; pregnant; betekenisvol; pregnant zwanger; veelbetekenend; zwanger worden
saturday => zaterdag
onscreen => op het scherm
scenes => coulissen; schermen
does => doet
expressions => uitdrukkingen
living => levend; levendig; levensonderhoud; levenswijze; bestaan; bestaand; in leven; inkomen; leven; living
stole => stola; stal; stalen; stool; Stola
reflection => reflectie; afspiegeling; weerspiegeling; weerglans; weerkaatsing; weerbeeld; spiegelbeeld; terugkaatsing; beraad; bezinning
memory => geheugen; herinnering; aandenken; heugenis; gedachtenis; computergeheugen; nagedachtenis; herinneringsvermogen; memorie; opslagmedium
recover => genezen; herstellen; helen; beter worden; herkrijgen; terugwinnen; herwinnen; recupereren; terugkrijgen; terugvinden
ideas => ideeën
ordeal => beproeving; kwelling; ontbering; bedroefdheid; droefheid; godsoordeel; hartzeer; pijn; tortuur; verdriet
kiss => kussen; kus; zoen; zoenen; kusje; copuleren; elkaar kussen; elkaar zoenen; naaien; neuken
appalling => ontzettend; ontstellend; verschrikkelijk; verbijsterend; afstotelijk; afzichtelijk; foeilelijk; ijselijk; schrikaanjagend; vervaarlijk
nicknamed => bijgenaamd
artistic => artistiek; kunstzinnig; kunstig; kunstmatig; creatief
dramatization => dramatisering
suddenly => plotseling; ineens; opeens; plots; plotsklaps; pardoes; eensklaps; abrupt
reënactments => reenactments
participate => deelnemen; meedoen; participeren; meemaken; deel hebben; deelhebben; delen
intimate => innig; intiem; vertrouwelijk; gezellig; knus; suggereren; laten doorschemeren; vertrouweling; sexueel; diepzinnig
image => beeld; afbeelding; plaat; voorstelling; prent; beeltenis; plaatje; figuur; imago; beeldkopie
negativity => negativiteit
awareness => bewustzijn; besef; bezinning; bekendheid; kennis; wetenschap; zich bewust zijn van; bekende; gewaarwording; kennen
perform => verrichten; uitvoeren; opdagen; opdraven; te voorschijn komen; verschijnen; bedrijven; doen; spelen; optreden
turns => bochten
rapist => verkrachter; verkrachterin
jim => jim
apartment => appartement; flat; woning; vertrek; appertement; kwartier; logies; onderkomen
blend => mengen; mixen; vermengen; temperen; mengsel; verwarren; wassen; mix; doorlopen; fusie
simulated => artificieel; gekunsteld; gemaakt
practicalities => praktische
films => films
consent => toestemmen; instemmen; instemming; toestemming; het eens zijn; goedvinden; toegeven; aannemen; accepteren; fiat
boy => jongen; knaap; jongens; kerel; boy; mannen; huisboy; kerels; nikker; tsjongejonge
horror => verschrikking; gruwel; gruweldaad; afgrijzen; afschuw; zielsangst; afschrik; walging; weerzin; ontsteltenis
mundstuk => mundstuk
actors => acteurs
enacting => inleidend
classics => De klassieken
innovative => innovatief; vernieuwend; apart; creatief; oorspronkelijk; origineel
shows => shows
anne => Anne
responsibility => verantwoordelijkheid; verantwoording; aansprakelijkheid; toerekenbaarheid; plicht; congruentie; functie; gelijkluidendheid; rol; taak
resistance => weerstand; tegenstand; verzet; tegenweer; tegenkanting; tegengas; weerstandsvermogen; hostiliteit; elektrishe weerstand; ohmse weerstand
sexual => seksueel; geslachtelijk; generatief; sexueel; seksuele; geslachts-
age => leeftijd; ouderdom; tijdperk; verouderen; era; tijd; generatie; oud worden; doen verouderen; oud doen worden
sought => gezocht
half => half; helft; halveren; deel; partij; semester; gedeeltelijk; half-; partieel
challenged => uitgedaagd
described => beschreven
coaxes => coaxes
woman => vrouw; mens; wijf; dame; vrouwelijk; juffrouw; mevrouw; vriendin; vrouwspersoon
set => stel; apparaat; inrichting; groep; hulpmiddelen; hoop; reeks; schare; troep; complet
authentically => echt
unfold => ontvouwen; ontplooien; uitspreiden; afwikkelen; ontrollen; ontwarren; ontwikkelen; uitrollen; besmeren; doorsmeren
reality => werkelijkheid; realiteit; feitelijkheid; waarheid; actualiteit; wezenheid; wezenlijkheid
melodramas => melodrama
york => york
coolidge => coolidge
endured => doorstaan
screen => scherm; beeldscherm; schut; afschermen; zaal; beschermen; doek; raster; rooster; beeldbuis
agreed => akkoord; afgesproken; in orde; goed; OK; okee; top; overeengekomen; accoord; eens
sardonic => sardonisch; cynisch; sarcastisch; bitter
overcome => overwinnen; verslaan; winnen; bevangen; overtreffen; zegevieren; afbreken; afhakken; afhouwen; afkappen
winks => winks
truths => waarheden
film => film; rolprent; filmen; laagje; vlies; fotorolletje; verfilmen; waas; bioscoop; cinematografie
filmmaker => filmmaker; filmer
twenty => twintig; twintigtal
sophisticated => geraffineerd; wereldwijs; geperfectioneerd; verfijnd; gesofisticeerd; ontwikkeld; geavanceerd; sofistisch; subtiel; gecultiveerd
violence => geweld; geweldpleging; agressie; hevigheid; gewelddaad; gewelddadigheid; handtastelijkheid; heftigheid; violentie
remembered => zich herinnerd
june => juni
blame => verwijten; beschuldigen; schuld; wijten; toeschrijven; beschuldiging; terechtwijzen; aangifte; aanklacht; aanrekenen
social => sociaal; maatschappelijk; gezellig
date => dadel; datum; afspraak; dateren; afspraakje; daten; rendez-vous; einde; tijdstip; dactylus
rape => verkrachten; verkrachting; koolzaad; schenden; ontvoering; roof; aanranding; Rape; raapzaad; aanranden
aware => bewust; welbewust; op de hoogte zijn; op zijn hoede; waakzaam; wakker
wide => wijd; breed; groot; ruim; uitgebreid; breedvoerig; royaal; uitgestrekt; omvangrijk; veelomvattend
throughout => overal; dwars door; door heel de; door heel het; het hele ... door; alom; door; door en door; gedurende; geheel
attacked => aangevallen
appropriation => toe-eigening; Appropriation; bestemming; toeëigening
acknowledge => erkennen; bekennen; toegeven; bevestigen; agnosceren; als waarheid aannemen; honoreren; bedanken voor; bekrachtigen; danken voor
archeology => archeologie; oudheidkunde
camera => camera; fototoestel; fotoapparaat; fotocamera; kiektoestel; filmcamera; televisiecamera; videocamera; kamer; toestel
states => staten
teen => adolescent; puber; tiener; jongvolwassene; jongere
proves => bewijst
makes => maakt
viewers => audiëntie
themselves => zichzelf; henzelf; zich; zelf
technically => technisch; strikt genomen; technisch gesproken
adventure => avontuur; riskeren; wagen; risico; lotgeval; perikel; belevenis; escapade; speculatie; voorval
viewing => opbaren; bezichtiging
afterward => achteraf; daarna; naderhand; dan; vervolgens; bijgevolg; derhalve; dus; zodoende; aansluitend
performed => uitgevoerd
approach => benaderen; naderen; benadering; aanpak; aanvliegen; toegang; toenadering; aantocht; komst; laan
punctuated => doorspekt
clear => duidelijk; klaar; helder; verklaren; doorzichtig; verrekenen; doorschijnend; verduidelijken; vrijspreken; helemaal
young => jong; jeugdig; jongeren; jongen; jeugd; kind; aankomend; beginnend; onervaren; pril
moral => zedelijk; moreel; moraal; zedenkundig; strekking; zedenles; deugdelijk; deugdzaam; ethisch; ruggensteun
background => achtergrond; achter; achterkant; achterzijde; belevenis; context; ervaring; experiment; fond
dormitory => slaapzaal; slaapcel; dormitory; dormitorium; slaapvertrek; studentenhuis
implications => implicaties
styles => stijlen
maturity => maturiteit; rijpheid; vervaldag; volwassenheid; geslachtsrijpheid; wasdom; betaaldatum; vervaldatum; vervaltijd
person => persoon; personage; mens; snuiter; vent; kerel; knul; sujet; person; enkeling
arise => ontstaan; verrijzen; opstaan; rijzen; stijgen; worden; opkomen; geboren worden; ontluiken; opgaan
playing => spel; spelen
own => bezitten; eigen; rijk zijn; erop nahouden; hebben; toegeven; verslaan; afgezonderd; afzonderlijk; apart
bunch => bos; tros; bundel; groep; wis; bundelen; afdeling; bosje; detachement; groepering
ranging => variërend
responses => reacties
silent => stil; zwijgend; stilzwijgend; zwijgen; geluidloos; geruisloos; stom; gedempt; stil zijn; kalm
era => tijdperk; era; tijdrekening; periode; tijdsgewricht; jaartelling
borrowed => geleend
long => lang; verlangen; lange tijd; langdurig; lange; voor lange tijd; groot; hunkeren; langdurend; reikhalzen
documentarists => documentarists
place => plaats; plaatsen; oord; zetten; leggen; plek; ruimte; lokaal; steken; zetel
eliciting => uitlokken
hollywood => hollywood
fiction => fictie; verbeelding; verdichtsel; verzinsel; bellettrie; bedenksel; roman; uitvinding; uitvindsel; vinding
movie => film; rolprent; speelfilm; bioscoopfilm; bioscoop; cinematografie; film ''m''; huidschilver; vel
student => student; studente; leerling; scholier; beoefenaar; studerende; cursist; leerlinge
mind => geest; verstand; psyche; intellect; letten op; denkvermogen; toekijken; aandacht schenken aan; geheugen; passen op
nudity => naaktheid
dimension => dimensie; afmeting; grootte; omvang; bestek; uitgebreidheid; maat; mate; afmetingen; coupe
spectators => toeschouwers
man => man; mens; bemannen; heer; pion; vent; kerel; manspersoon; persoon; speelstuk
actress => actrice; toneelspeelster
together => samen; bijeen; tezamen; aaneen; ineen; bij elkaar; gemeenschappelijk; gezamenlijk; tesamen; gezamelijk
demands => eisen
musicals => musicals
josh => plagen
uneasy => onbehaaglijk; ongemakkelijk; ongerust; bang; beducht; bekommerd; bezorgd; druk; gejaagd; onrustig
room => kamer; ruimte; vertrek; zaal; bestek; lokaal; speling; wereldruim; plaats; oorzaak
plans => plannen
blocked => geblokkeerd; afgesloten; afgezet; versperd; verstopt
justify => rechtvaardigen; uitlijnen; uitvullen; billijken; in het gelijk stellen; verdedigen; begenadigen; excuseren; goedpraten; motiveren
forced => gedwongen; gemaakt; onvrijwillig; geforceerd; gekunsteld
deeply => diep; diepzinnig
owing => schuld; schuldig; verschuldigd
psychodramatic => psychodramatische
worried => bezorgd; ongerust; verontrust; angstig; bang; beducht; bekommerd; benauwd; druk; gejaagd
whose => wier; wiens; waarvan; van wie; wie d’r; wie z’n; welks; diens; waarom; waarover
screams => geschreeuw
title => titel; betitelen; kop; onderschrift; titelen; tituleren; Titel; eigendomsbewijs; eigendomsrecht; graad
whom => wie; aan wie; waaraan; die; waarbij
concealed => bedekt; cryptisch; cryptische; duister; obscuur; occult; verborgen; verstopt
falsely => valselijk; vals; hypocriet; onjuist
entertainment => amusement; vermaak; aardigheid; pretje; vermakelijkheid; afleiding; ontspanning; schik; entertainment; verstrooiing
women => vrouwen; vrouw
pans => pannen
desire => verlangen; begeerte; wens; begeren; wensen; lust; zin; zucht; willen; trek hebben in
subsequent => volgend; nagekomen; subsequent; aanstaand; achtereenvolgend; komend; spoedig; aankomend; daarop volgend; aansluitend
youth => jeugd; jeugdigheid; borst; jongeheer; jongeling; jongere; jongeren; adolescentie; jeugdig; jongelingsjaren
conversations => conversaties
subject => onderwerp; subject; onderdaan; stof; vak; onderwerpen; thema; onderdane; vakgebied; apropos
embody => belichamen; representeren; verpersoonlijken; vorm geven; inlijven; uitdrukken
mouthed => mond
observing => observeren
ones => degenen
innovations => innovaties
individual => individueel; individu; enkeling; hoofdelijk; persoon; sujet; afzonderlijk; individuele; apart; afgescheiden
shamed => schamend
both => beide; allebei; allebeide; alletwee; alle twee de; zowel; en; zowel ... als ...
passive => passief; lijdelijk; lijdend; inactief; inert; lijdende vorm; onbeweeglijk; passiva
destructive => destructief; verwoestend; destructieve; verwoestende; vernietigend; vernielzuchtig; fataal
studio => studio; atelier; filmmaatschappij; kunstschool; platenmaatschappij; Studio; werkplaats
too => ook; te; eveneens; evenzeer; mede; al te; te veel; te zeer; overdreven; tevens
secure => veilig; bevestigen; bepalen; fixeren; vastzetten; behouden; beveiligen; geborgen; vastmaken; verstevigen
among => tussen; onder; te midden van; midden; in het midden van; medio; middenin; aan; bij; op
frozen => bevroren; gevroren; koel
calls => calls
force => kracht; dwingen; forceren; macht; afdwingen; noodzaken; troep; sterkte; geweld; overweldigen
closeup => detailopname
happened => gebeurd
personal => persoonlijk; eigen; lichamelijk; gezellig; innig; intiem; knus; personeel; persoonlijk voornaamwoord; vertrouwelijk
observers => waarnemers
version => versie; uitvoering; vertaling; bewerking; uitleg; vertolking
seat => zetel; zitplaats; stoel; zitvlak; bril; zitting; plaats; zitmeubel; zit; bank
inquiry => enquête; vraag; onderzoek; analyse; kwestie; navraag; aanvraag; inquisitie; nasporing; exploratie
source => bron; wel; kwel; welput; oorsprong; fontein; herkomst; wortel; bronvoorziening; aanhalen
observations => waarnemingen
distinction => onderscheiding; verschil; distinctie; onderscheid; aanzien; rang; befaamdheid; elegantie; voornaamheid
remarks => opmerkingen
start => beginnen; starten; begin; aanvangen; aanvang; start; aanzetten; activeren; ontstaan; aanbreken
whispers => fluistert
separate => scheiden; afzonderlijk; afgezonderd; splitsen; delen; bijzonder; verdelen; gescheiden; opsplitsen; schiften
party => partij; feest; fuif; feesten; aanhang; leden; party; viering; vieren; gevolg
simply => eenvoudigweg; slechts; alleen; eenvoudig; maar; enkel; domweg; gewoon; uitsluitend; gewoonweg
korea => korea
generation => generatie; geslacht; voortbrenging; voortplanting; Generatie; Generaties van de materie; aanmaak; verwekking
fission => splitsing; splitsen; atoomsplitsing; deling; verdeling; Binaire deling
see => zien; aanschouwen; bekijken; begrijpen; ontmoeten; aantreffen; blikken; kijken; betreffen; raken
advisor => adviseur; raadgever; mentor; raadsheer; administrateur; beheerder; bestuurder; consulent; directeur; verzorger
expendable => niet essentieel; niet noodzakelijk; nutteloos; onnodig; overbodig; overtollig; vervangbaar
good => goed; goede; lief; okee; verstandig; vriendelijk; wijs; braaf; aardig; dik
leader => leider; aanvoerder; chef; baas; gebieder; hoofd; aanvoerster; leidster; voorman; leidsman
harrowing => verschrikkelijk; verstorend; vreselijk; beklagenswaardig; hartverscheurend; treurig
grinding => malen; maling; slijpen; vermalen
dried => gedroogd; droog
nukes => nukes
attacks => aanvallen
somewhere => ergens; ergens heen; hier of daar
mess => brij; puinhoop; zootje; moes; pap; zooi; mis; rommel; rotzooi; dienst
thin => dun; mager; schraal; slank; sprietig; verdunnen; smal; schriel; fijn; karig
cult => cultus; eredienst; verering; sekte; verheerlijking; Cult; aanbidding
asia => azië
greasy => vet; vettig; dik; olieachtig; vuil
north => noorden; noordelijk; noordwaarts; noord; stijgende; noordenwind
allies => Geallieerden; bondgenoot
human => menselijk; mens; humaan; Luchtpersoon; homo sapiens; human; mensachtige; mensenkind; persoon; sterveling
capable => bekwaam; capabel; kundig; competent; bedreven; behendig; deskundig; handig; vaardig; bevoegd
soot => roet; rookzwart; zoet
commitment => verbintenis; engagement; verplichting; gevecht; inzet; toezegging
cut => snijden; maaien; afsnijden; doorsnijden; snerpen; snijwond; afnemen; afpakken; hakken; korten
layer => laag; aardlaag; legger; legster; legkip; afleggen; aflegger; grondlaag; loot; marcotteren
consequences => gevolgen
numbers => tallen
ultimately => eindelijk; per saldo; ten slotte; uiteindelijk; ten laatste; tenslotte
wave => golf; zwaaien; wuiven; baar; gebaren; onduleren; slingeren; wapperen; gulp; swingen
won => gewonnen; won
change => veranderen; verandering; wisselgeld; wijzigen; aanpassing; wisselen; wijziging; verwisselen; aanpassen; vervangen
dying => sterven; stervend
permanently => permanent; altijd; steeds; voorgoed; voortdurend; aldoor; altoos; bij voortduring; blijvend; immer
upcoming => komend; aankomend; aanstaand; spoedig; volgend
geography => geografie; aardrijkskunde
appointed => aangesteld
admit => toegeven; toelaten; toestaan; bekennen; binnenlaten; erkennen; toegang verlenen; gedogen; aannemen; accepteren
teens => tieners
hordes => menigte
regional => regionaal; gewestelijk; streek-; streek‐
delays => vertragingen
posing => poseren
government => regering; overheid; gouvernement; bewind; bestuur; heerschappij; leiding; bestuursvorm; overheids-; politiek
koreans => koreanen
remarkably => opmerkelijk; merkwaardig; eigenaardig; excellent; opmerkenswaardig
thousands => duizenden
iraq => irak
installed => geïnstalleerd
challenges => uitdagingen
acknowledging => erkennen
term => term; trimester; vakterm; termijn; voet; woord; periode; benaming; bepaling; conditie
despot => despoot; dwingeland; alleenheerser; dictator; onderdrukker; tiran; autocraat
goes => gaat
painless => pijnloos
public => publiek; openbaar; openlijk; ruchtbaar; overheids-; staats-; algemeen; buitenwacht; generaal; openbaarheid
inevitably => onvermijdelijk; noodzakelijkerwijs
commit => bedrijven; begaan; plegen; toevertrouwen; toewijzen; vertrouwen; beleggen; besteden; investeren; toewijden
peninsula => schiereiland
security => veiligheid; beveiliging; onderpand; zekerheid; pand; borgstelling; waarborg; veiligheidsdienst; borg; effecten
architects => architecten
invasion => invasie; inval; schending; agressie; binnendringen
meat => vlees; vleessoort; hansworst; lulvent; substantie; vlees op de botten; vruchtvlees; voedsel; kost; spijs
tens => tientallen
certainly => zeker; beslist; voorzeker; ongetwijfeld; wel degelijk; natuurlijk; bepaald; vast; en of; waarlijk
promised => beloofd; toegezegd
minutes => notulen; proces-verbaal; protocol; bekeuring; minuten; boete; geldboete; proces verbaal; proces‐verbaal; protokol
korean => koreaans
correctly => juist; correct; goed; behoorlijk; eerlijk; eigenlijk; exact; fatsoenlijk; gevoeglijk; louter
bolton => bolton
south => zuiden; zuidelijk; zuid; zuidwaarts; naar het zuiden; Zuiden
personality => persoonlijkheid; aard; karakter; geaardheid; identiteit; een groot man; figuur; inborst; notabele; personage
unique => uniek; enig; unicum; alleen; speciaal; afzonderlijk; alleenstaand; eigenaardig; enige; individueel
cakewalk => cakewalk
stratosphere => stratosfeer
warned => gewaarschuwd
mobilizing => mobiliserende
newly => onlangs; opnieuw; pas; nieuw; daarnet; daarstraks; exact; juist; net; precies
deposed => afgezette
ruled => regeerde
pool => zwembad; vijver; bassin; poel; zweminrichting; bekken; aansluiten; plas; zich aaneensluiten; zich verenigen
metoo => ik ook
lover => minnaar; minnares; geliefde; vrijster; vriendin; vrijer; beminde; lief; liefhebber; liefste
tail => staart; schaduwen; achterste; zitvlak; achtervolger; staartstuk; achtereinde; achterwerk; munt; beschatten
garner => graanschuur; oogsten; verzamelen; cumuleren; opeenhopen; opstapelen; aannemen; accepteren; collecteren; innen
slick => slijk; glad; glad maken; glibberig; handig; uitgeslapen
despondent => moedeloos; wanhopig; hopeloos; neergeslagen; mistroostig; desperaat; radeloos
host => gastheer; hostie; troep; gastgever; gastvrouw; host; heerschaar; leger; herbergier; hosten
waters => vruchtwater
cigarette => sigaret; saffiaantje; peuk; tabak
imaginable => denkbaar; geloofwaardig
gargantuan => immens; enorm; reusachtig; gigantisch; kolossaal
garfunkel => garfunkel
charlie => charlie
looking => op zoek
friedrich => friedrich
water => water; wateren; water geven; begieten; sproeien; gieten; bevloeien; bronwater; besproeien; waterhoudend
homer => postduif; homer; homerus; omer
depardieu => depardieu
video => video; film; televisie; televisieshow; videocassette
syndicated => gesyndiceerde
fog => mist; nevel; damp; floers; rook; sluier; stoom; verbergen; verduiken; verhullen
middle => midden; gemiddeld; middelbaar; centrum; doorsnee; middelmaat; midden-; middel; middelpunt; hart
afflecks => afflecks
aughts => aughts
resignation => berusting; gelatenheid; aftreding; aftreden; uittreding; ontslag; overgave; afstand; afgetreden; dienstbeëindiging
ten => tien; tientje; tiental
month => maand; m
mcgowan => mcgowan
triple => drievoudig; driedubbel; verdrievoudigen; triple; tripleren; drieledig
puppies => puppies
wrapped => verpakt
movement => beweging; zet; slag; stoelgang; deel; gang; omzet; opwelling; voortgang; defecatie
reliable => betrouwbaar; vertrouwd; zeker; zekerheid; getrouwe; geloofwaardig; degelijk; aannemelijk; behouden; beproefd
clichéd => afgezaagd; banaal
distanced => gedistantieerd
hedlund => hedlund
denied => ontkend
reasons => redenen
apologize => zich verontschuldigen; verantwoorden; verontschuldigen; excuseren; zich excuseren
exhaustion => uitputting; moeheid; lethargie; afmatting; aftrek; apathie; bedroefdheid; consternatie; dofheid; droefgeestigheid
beach => strand; stranden; kust; landen; wal; dalen; neerstrijken; oever; zandstrand; zwemplaats
weinstein => weinstein
headlines => headlines
major => majoor; groot; hoofdvak; meerderjarige; belangrijk; voornaamste; hoofd-; aanzienlijk; grote; majeur
visible => zichtbaar; zichtbare; zienlijk; waarneembaar; manifest
separated => gescheiden; afzonderlijk; apart; los; uiteengegaan
fitness => geschiktheid; fitness; fitheid; gepastheid
gone => verdwenen; weg; foetsie; afwezig; dada; heen; zoek
preserver => behoeder; beschermer; bewaarder
towelling => badstof
motivated => gemotiveerd
shooting => schietpartij; schieten; jacht; beschieting; geschiet; salvo; schot; vuren
tattoo => taptoe; tatoeage; tatoeëren; tatoeëring; tattoeage; tattoo; tattoëren
carrying => belastend; geladen met; vervoer
blue => blauw; blauwe; depressief; teneergeslagen; depressieve; groen; terneergeslagen; deerniswekkend; depri; deprimerend
frontier => grens; perk; landsgrens; Frontier (lijn); landgrens; grensgebied
below => onder; beneden; daarbeneden; eronder; daaronder; onderstaand; omlaag; onderX; onderaan; onderin
vanity => ijdelheid; nietigheid; frivoliteit; lichtzinnigheid; vruchteloosheid; wuftheid; absurditeit; arrogantie; eigendunk; hoogmoed
mocking => spotlustig; spottend; spotternij
himself => zelf; vanzelf; zich; zichzelf; hijzelf; zelve; hemzelf
garish => schreeuwlelijk; wansmakelijk; bont; opzichtig; schel
stars => ster
original => origineel; oorspronkelijk; vernieuwend; Oorspronkelijk; afkomstig; unicum; apart; oorsprong; originele; aanvankelijk
screenplay => scenario; draaiboek; script
touch => aanraken; raken; beroeren; aanraking; roeren; aanslag; ontroeren; toucheren; voelen; aankomen
sound => geluid; klinken; klank; gaan; geluid maken; luiden; toon voortbrengen; kleppen; overgaan; toon
sympathy => medelijden; sympathie; medegevoel; deelneming; erbarmen; compassie; mededogen; medeleven; deernis; empathie
lusty => wellustig; ferm; flink; gezond; krachtig; stevig; vitaal; zwaarlijvig
considered => doordacht; bedachtzaam; weldoordacht; weloverwogen
running => administratie; administratiekantoor; beheer; bestuur; toediening; administratiegebouw; hardlopen; lopend; water; loop
marriage => huwelijk; echt; bruiloft; echtverbintenis; huwelijkse staat; huwelijksband; huwelijkssluiting; huwelijksvoltrekking; trouw; trouwerij
shaggy => harig; ruig; ruigharig; borstelig
batman => ordonnans; Batman; batman; oppasser
insisted => aangedrongen
sadness => bedroefdheid; verdriet; droefheid; zieleleed; treurigheid; smart; mistroostigheid; somberheid; droefenis; beproeving
heart => hart; harten; kern; pit; liefde; ziel; koenheid; moed; vruchtbaarheid; cardiaal
since => sinds; aangezien; sedert; omdat; daar; vanaf; wijl; vermits; want; sindsdien
midlife => midlife
smoking => roken; nicotineverslaving
paparazzi => Paparazzo; paparazzo
rags => lompen; Lompen
midsection => midsection
decades => tientallen jaren
induces => induceert
gray => grijs; grauw; grijzen; gray; grijze; schimmel; donker; somber
cavill => cavill
reflexively => reflexively
david => david; koning david
bless => zegenen; wijden; inzegenen; consacreren; inwijden; loven; verheerlijken
resulting => consequent
celebrity => beroemdheid; beroemd persoon; ster; filmster; roem; coryfee; celebrity; grootheid; vedette; vermaardheid
youtube => youtube
spoke => spaak; sport; sprak; spraken; straal
denials => ontkenningen
seeming => ogenschijnlijk; schijn; schijnbaar
towel => handdoek; afdrogen; afdroogdoek; keukenrol; theedoek
interview => interview; interviewen; vraaggesprek; ondervraging; samenkomst; audiëntie; onderhoud
mario => mario
country => land; platteland; staat; open veld; plattelands; boeren-; country; land-; natie; actie
past => verleden; voorbij; verleden tijd; voorbije; afgelopen; verder; over; aan; achter; langs
appeared => opgedoemd
silence => stilte; stilzwijgen; rust; rustigheid; kalmte; zwijgen; stilte!; vergetelheid; antigeluid; bedaardheid
celebrities => beroemdheden
gérard => gérard
protected => beschermd; immuun
roman => romeins
award => prijs; onderscheiding; toekennen; premie; bekroning; beloning; geven; uitspraak; gunning; toekenning
fair => rechtvaardig; beurs; kermis; eerlijk; billijk; mooi; redelijk; fair; jaarmarkt; schappelijk
dipping => dompelen
winner => winnaar; winnares; kampioen; winner; overwinnaar; succes; welslagen
simpsonesque => simpsonesque
complete => compleet; volledig; voltooien; aanvullen; algeheel; afwerken; heel; volkomen; geheel; totaal
ourselves => zelf; onszelf; ons; wij
rumored => gekletst
vaping => vaping
anti => anti; anti-
gave => gaf; gaven
fascist => fascistisch; fascist; fasciste
referred => gerefereerd
alongside => naast; behalve; bezijden; aan de zijde van; met; langs; aan; bij; binnen; dichtbij
rejection => afwijzing; verwerping; wraking; weigering; afkeuring; declinatie; afkeuren; afslaan; afslag; afwijzen
superman => übermensch; superman; LSD; lyserginezuurdiëthylamide
breakup => scheiden; uiteengaan; vaneengaan; zich verspreiden; breuk
crimes => misdrijven
latin => Latijns; latijn; latijns
sat => gezeten; zat; zaten
husband => echtgenoot; man; gemaal; eega; vrouw; gade; echtelieden; zuinig beheren
march => mars; marcheren; lopen; tippelen; grensmark; mark; betoging; defilé; loop; Mark
groped => betast
waistband => gordel; ceintuur; band; broeksband; riem
overlaid => overlay
activist => activist; onruststoker; agitator; ophitser; twiststoker; stokebrand
ve => ve
internet => internet; Internet
plainly => duidelijk; eenvoudig; gewoonweg; simpel; bij uitstek; blijkbaar; botweg; gewoon; ronduit; zonder meer
shallow => ondiep; oppervlakkig; licht; ondiepte; wad; hol; laag; vluchtig; zandbank
fiancée => verloofde; bruid; meisje; aanstaande
told => verteld; vertelde; vertelden
move => bewegen; verplaatsen; verhuizen; aangrijpen; ontroeren; verroeren; verhuizing; beweging; zet; roeren
romantic => romantisch; dichterlijk; poëtisch; romantiek
honolulu => honolulu
wake => wekken; ontwaken; wakker maken; wakker worden; kielzog; opwekken; wake; dodenwake; zog; kielwater
enlightened => geciviliseerd; verlicht
rose => roos; roze; rozenstruik; rooskleurig; rozig; roosgekleurd; bleekrood; rose; Rose; rosarium
success => succes; voorspoed; geluk; welstand; bloei; welslagen; welvaart; welvarendheid; welgang; hit
virile => viriel; mannelijk
senator => senator
older => ouder
prankster => schavuit
post => post; posten; paal; ambt; aanplakken; betrekking; plaats; posterijen; baan; op de post doen
ben => ben
behind => achter; achteraan; achterste; na; achterwerk; zitvlak; aan; over; achterkant; kont
images => afbeeldingen
phoenix => feniks; phoenix
scenario => scenario; draaiboek; script
publicly => openbaar; in het openbaar; publiek
argo => argo
popular => populair; veelgeliefd; getapt; geliefd; volks; gewild; volk; in trek; algemeen; bemind
animatedly => geanimeerd
purebred => rasecht
caspar => caspar
marquee => luifel; lichtkrant; tent; luif
recalibration => herijking
beside => naast; bij; dichtbij; nabij; aan; behalve; bezijden; op; ten huize van; binnen
camp => kamperen; kamp; legeren; Camp; bivak; legerkamp; camp
multicolored => veelkleurig; bont; meerkleurig; bonte; veelkleurige; polychrome
bearded => baardig; bebaard; gebaard; baardman
depends => hangt er van af
flatten => pletten; aandrukken; afplatten; afvlakken; nivelleren; platstrijken; rechten; rechtmaken; rechttrekken; verlagen
distance => afstand; eind; verte; verwijderen; distantie; end; verschiet; traject; distantiëren; tussenruimte
affleck => affleck
lopez => lopez
enormous => enorm; gigantisch; geweldig; kolossaal; reusachtig; ontzettend; afschuwelijk; astronomisch; ferm; immens
meme => meme; meem
caricature => karikatuur; karikaturiseren; vertekenen; beeldverhaal; spotprent; strip
remaining => resterend; overig; verder; blijvend; over; rest; ander; resterende
recalling => herinnerend
flailing => zwaaiende
garrett => garrett
photographed => gefotografeerd
approached => benaderde
early => vroeg; vroegtijdig; tijdig; pril; bijtijds; matineus; spoedig; vroeger; weldra; op tijd
domesticated => huis-; huiselijk; huis‐
gut => darm; buik; ingewanden; uitbranden; uithalen; vernietigen; maag-darmstelsel; spijsverteringskanaal; abdomen; duodenum
silently => zwijgend; stil; stilletjes; geluidloos; kalm
academy => academie; hogeschool; universiteit; genootschap; college; instituut
kids => kinderen
outward => buitenwaarts; eruit; naar buiten; uitwaarts; uiterlijk; buiten-; buiten; uitwendig; zichtbaar
asked => gevraagd
staring => staren
faux => faux
exactly => precies; exact; nauwgezet; accuraat; juist; eigenlijk; OK; nauwkeurig; net; okay
arouse => opwekken; wekken; opwinden; wakker maken; agiteren; ophitsen; opruien; opstoken; schudden; aanstoken
feeds => feeds
white => wit; blank; blanke; blanco; zuiverheid; white; blankheid; bleek; doorzichtig; eiwit
swim => zwemmen; drijven; varen; overzwemmen; zwemmer
run => rennen; lopen; hollen; hardlopen; aanrijden; functioneren; in zijn werk gaan; voorrijden; vlucht; werken
shy => verlegen; bedeesd; timide; schuchter; schroomvallig; beschroomd; bevangen; blo; gooien; eenkennig
am => ben; zijn; am
aged => oud; bejaard; aftands; bouwvallig; gammel; uitgeleefd; uitgewoond; vergevorderd; wrak; hoogbejaard
surf => surfen; branding; surf
hedging => hedging
co => co
younger => jongere; junior
red => rood; blozend; ros; rosse; kleur; blos; rode; oranje; roodachtig; rossig
simon => simon
mock => bespotten; spotten; honen; imiteren; nadoen; namaak; naäpen; afgietsel; imitatie; namaak-
gossip => roddel; roddelen; kletsen; babbelen; kletspraatje; roddelaar; roddelaarster; kletspraat; zeveren; zwetsen
ex => Ex; ex; ex-man; ex-vriend; ex-vriendin; ex-vrouw; ex-; gewezen; voormalig; vroeger
trunks => onderbroek; zwembroek; broek; kniebroek; korte broek
depressed => terneergeslagen; depressief; neerslachtig; somber; gedrukt; zwaarmoedig; depri; down; gedeprimeerd; bedrukt
poignancy => felheid; guurheid; pikantheid; schelheid; scherpheid; scherpte; schrilheid; acuutheid; bitterheid; helderheid
magazine => tijdschrift; magazine; magazijn; krant; blad; revue; periodiek; dagblad; courant; journaal
bird => vogel; griet; vogels; grootvaderlijk; babe; brok; kanjer; kist; shuttle; spetter
schadenfreude => leedvermaak; schadevreugde; Leedvermaak
quick => snel; vlug; haastig; rap; gauw; spoedig; gezwind; levend vlees; kwiek; ras
contrary => strijdig; tegengesteld; tegenstrijdig; tegendeel; tegenliggend; tegenstaand; dwars; recalcitrant; tegengestelde; eigenzinnig
henry => henry; hendrik
ashes => as; resten; asse
became => werd
hunnam => hunnam
height => hoogte; lengte; stand; hoogtepunt; Hoogte; lichaamslengte; top; toppunt; verhevenheid; kroon
pictures => afbeeldingen
exhausted => uitgeput; op; uitverkocht; afgemat; vermoeid; bekaf; doodmoe; afgepeigerd; doodop; gaar
damon => damon
boston => boston
jennifer => jennifer
eyes => ogen
kind => soort; aardig; vriendelijk; lief; aard; slag; type; voorkomend; beminnelijk; leuk
tv => televisie
forty => veertig; veertigtal
matt => mat
male => mannelijk; mannetje; man; jongen; masculien; mannetjesdier; mannetjesplant; mannelijk exemplaar; kerel; gast
amusement => amusement; vermaak; vertier; ontspanning; afleiding; schik; plezier; verzet; tijdverdrijf; vermakelijkheid
hometown => vaderstad; geboortestad
rounds => rondes
haunt => spoken; achtervolgen; kwellen; beklemmen; rondspoken; trefpunt; vervolgen; verblijven; wonen; bezoeken
stands => staan; staat
prime => eerste; voornaamste; priem; priemgetal; prima; uitstekend; beste; primair; primen; prime
dryly => droog
protectively => beschermend
children => kinderen; kind
comment => commentaar; opmerking; becommentariëren; commentaar leveren op; aantekening; annoteren; uitleg; kritiek; aanmerking; commentariëren
returned => teruggekeerd; terug
existence => bestaan; voorkomen; aanzijn; aanwezigheid; wezen; zijn; existentie
obscure => duister; obscuur; onbekend; donker; onduidelijk; verborgen; onbegrijpelijk; ondoorzichtig; raadselachtig; verdoezelen
father => vader; papa; vadertje; ouder; pater; eerwaarde; ouders; pap; mijnheer pastoor; pappa
panic => paniek; in paniek raken; Paniek; over zijn toeren raken; panikeren
fodder => veevoeder; veevoer; kanonnenvoer; voeder; voer; foerage; voedsel; beemd; kost; voederen
v => v
harvey => harvey
onetime => eenmaal; eens; één keer
crisis => crisis; breekpunt; keerpunt
oscar => oscar
fake => nep; vals; vervalsen; imiteren; voorwenden; nabootsen; nadoen; namaken; onecht; namaak
hunting => jacht; jagen
unfaithful => ontrouw; afvallig; trouweloos; dubbelhartig; verraderlijk
identification => identificatie; legitimatiebewijs; identiteitsbewijs; herkenning; Identification; determinatie; identificeren; vereenzelving; vereenzelviging
wanderer => dwaler; wandelaar; zwermer; zwerver; landloper; nomade; vagebond; clochard
empty => leeg; leegmaken; legen; ledigen; ledig; hol; loos; lens; leeglopen; lenzen
wrestled => worstelde
netflix => netflix
loves => houdt
nanny => kinderjuffrouw; kindermeisje; Kinderjuffrouw; gouvernante; au pair
france => Frankrijk; frankrijk
mask => masker; maskeren; dekmantel; mom; bemantelen; bewimpelen; mombakkes; verbergen; verbloemen; camoufleren
story => verhaal; verdieping; etage; vertelling; vertelsel; geschiedenis; relaas; historie; sprookje; verhaaltje
gaze => staren; turen; aanstaren; aanschouwen; blik; kijken
fall => vallen; herfst; najaar; val; ondergang; worden; afvallen; neervallen; storten; dalen
pooching => pooching
late => laat; late; wijlen; vergevorderd; dood; te laat; laatst; vorig; doodgegaan; gestorven
temporary => tijdelijk; voorlopig; voorbijgaand; van voorbijgaande aard; vergankelijk; ad interim; vooralsnog
dated => verouderd; achterhaald; gedateerd; ouderwets
meanness => gemeenheid; gierigheid; krenterigheid; laaghartigheid; laagheid; lelijkheid; schanddaad; schunnigheid; smeerlapperij; vuigheid
instances => instanties
tends => neigt
brief => kort; bondig; kortstondig; beknopt; samengevat; kernachtig; summier; mandaat; samenvatting; breve
question => vraag; ondervragen; kwestie; bestrijden; navraag; thema; twijfel; verhoren; motie; aanvechten
power => macht; kracht; vermogen; mogendheid; heerschappij; elektriciteit; grootmacht; sterkte; stroom; spanning
smiles => glimlacht
president => president; voorzitter; preses; praeses; bondspresident; directeur
lose => verliezen; kwijtraken; afvallen; verbeuren; opgeven; verspelen; vermageren; verslagen worden; missen; achterlopen
led => led
drops => druppels
myself => mijzelf; mezelf; ikzelf; zelf; mij
ended => beëindigde
loosely => ruim; losjes; los
dwight => dwight
shaped => gevormd
branding => huisstijl
user => gebruiker; gebruikster; druggebruiker; verbruiker; gebruikersnaam
alenfall => alenfall
insert => invoegen; insteken; steken; indoen; inleggen; inschuiven; instoppen; inzetten; plaatsen; inbrengen
extraction => extractie; afkomst; uittreksel; onttrekking; Extractie; winning; herkomst; uittrekken
academic => academisch; academicus; universitair; akademisch; student; geleerde; abstract; hoogleraar; intellectueel; wetenschapper
duly => behoorlijk; fatsoenlijk; naar behoren; netjes; passend; eerlijk; eigenlijk; exact; gevoeglijk; juist
specially => in het bijzonder; inzonderheid; speciaal; vooral; bijzonder; specifiek; bewust; expres; hoofdzakelijk; met opzet
holy => heilig; gewijd; sacraal; geheiligd; foutloos; perfect; volmaakt
patient => patiënt; geduldig; patiënte; zieke; lijdzaam; geduld; Patiëns; patiëns; cliënt; geduldige
therapeutics => therapie; geneeswijze
apart => afzonderlijk; bijzonder; apart; afgezonderd; terzijde; gescheiden; vaneen; los; afgescheiden; separaat
named => genaamd; heet
imagine => zich verbeelden; inbeelden; bedenken; zich voorstellen; fantaseren; raden; veronderstellen; speculeren; voorstellen; verbeelden
conditions => omstandigheden; voorwaarden
fifty => vijftig
senses => bewustzijn; verstand
accidentally => toevallig; per ongeluk; toevalligerwijze; bij toeval; bij ongeluk; onverwachts; zonder opzet; bijkomstig
prepared => bereid; klaar; genegen; gereed; paraat; verdacht; voorbereid
spade => spade; schop; schoppen; spa; schup; graven; spitten; woelen; schuppen; schep
controlled => beheerst; gecontroleerd
growth => groei; toename; aangroei; aanwas; ontwikkeling; wasdom; gestalte; plantengroei; accres; gezwel
organization => organisatie; ordening; inrichting; associatie; structuur; Semioverheid; organizatie
understand => begrijpen; verstaan; snappen; bevatten; beseffen; vatten; geloven; inzien; aannemen; nemen
parasite => parasiet; klaploper; profiteur; woekerplant
suffers => lijdt
vaguely => vaag; onduidelijk; afwezig; duister; onbepaald; verstrooid
holding => bestel; bestuur; bewind; gedrag; heerschappij; houding; leiding; manieren; onderhoud; regering
hot => heet; warm; geil; gloeiend; smoorheet; snikheet; lekker; pittig; pikant; porno
histogen => histogen
rings => ringen
generate => verwekken; genereren; ontwikkelen; voortbrengen; opbrengen; aanmaken; opwekken
e => e
dermal => huid-
sensations => sensaties
unrealistic => irreël; onrealistisch
robot => robot; Robot; automaat; verkeerslicht; automatisch
machine => machine; apparaat; automobiel; automaat; toestel; werktuig; naaimachine; rijwiel; auto; draaibank
dream => dromen; droom; mijmeren; hoop; droombeeld; fantaseren; dagdroom; wensdroom; dagdromen; ambiëren
effective => effectief; doeltreffend; werkzaam; afdoend; efficiënt; krachtig; werkdadig; werkelijk; actief; adequaat
hold => vasthouden; houden; ruim; scheepsruim; bijhouden; bevatten; aanhouden; tegenhouden; macht; bekleden
market => markt; marktplein; afzetgebied; afzetmarkt; marktplaats; bazaar; beurs; markt-; jaarbeurs; kermis
bets => weddenschappen
grays => grijzen
collective => collectief; gemeenschappelijk; gezamenlijk; gemeenschappelijk wonen; verzamelnaam; gemeenschap
latent => latent; verborgen; potentieel; sluimerend; slapend
slow => langzaam; traag; sloom; vertragen; ophouden; langzame; slome; achter; laat; afremmen
isolate => isoleren; afzonderen; afscheiden; afsluiten
arteriosclerosis => arteriosclerose; aderverkalking; atheromatose
medication => medicatie; geneesmiddel; medicament; medicijn; artsenij; behandeling; geneeskunst
finding => vinding; vondst; uitspraak; bevinding; toewijzing; het vinden
eisenhower => eisenhower
nod => knikken; knik; ja knikken; knikkebollen; wenk; doen schommelen; laten balanceren
george => george; joris
pluck => plukken; pluimen; moed; doorzettingsvermogen; afbreken; afrukken; kaalplukken; pluk; tokkelen; gepluk
nineteen => negentien
packed => overvol; afgeladen; stampvol
frenzy => razernij; waanzin; gekheid; uitzinnigheid; zinneloosheid; zinsverbijstering; aberratie; afwijking; extase; frenzy
compared => vergeleken
doing => toedoen; doen; werk; daad; handeling; bezig zijn; zeker
character => karakter; aard; teken; personage; persoonlijkheid; geaardheid; letter; merkteken; bewijs; blijk
thanks => dank u; bedankt; dank; dank je; dankjewel; dankzegging; dank u wel; dankuwel; merci; dank betuigen
paw => poot; been; onderbeen; klauw; betasten; voet; pootje; hand; handschrift; krabben
confused => verward; in de war; onthutst; ontzet; paf; perplex; sprakeloos; verbijsterd; verbluft; verbouwereerd
interested => geïnteresseerd; belangstellend; belanghebbend; geïnteresseerde
quincy => quincy
efficacy => doeltreffendheid; werkzaamheid; uitwerking; efficiëntie; rendement
minimalist => minimalistisch
crudely => grof; grofweg
above => boven; over; bovenstaand; meer dan; ten noorden van; hierboven; bovenste; bovenvermeld; daarenboven; benoorden
sudden => plotseling; plotselinge; bruusk; plots; abrupt; onverwacht; onverhoeds; onverwachts; onvoorzien; kortaf
health => gezondheid; welzijn; status; gezond; gezondheidstoestand; gezondheidszorg
progress => vooruitgang; voortgang; vordering; vorderen; vooruitgaan; beterschap; verbetering; opschieten; vorderingen maken; veld winnen
rectangular => rechthoekig; rechthoekige
follicular => folliculair
smiling => glimlach; lach
cursed => vervloekt; vermaledijd
ads => advertenties
outcropping => outcropping
injections => injecties
caterpillar => rups; larve; rupsband; made; Rups
irregularly => onregelmatig
unabashed => onbeschaamd; schaamteloos
join => verenigen; samenvoegen; toetreden; verbinden; aansluiten; samenkomen; verbinding; bijeenbinden; bijeenbrengen; lid worden
definable => definieerbaar
building => gebouw; bouwwerk; constructie; bouw; bouwen; aanbouw; perceel; bouwsel; opbouw; aanleg
inchoate => embrionaal; beginnend; onvolledig gevormd; pas begonnen; rudimentair
faire => faire
tidy => proper; net; ordelijk; rein; opruimen; aardig; ruimen; inrichten; niet onbeduidend; regelen
unknown => onbekend; ongekend; ongeweten; onbekende; vreemd; duister; obscuur; unknown
dishes => afwas; servies; serviesgoed
founder => oprichter; stichter; grondlegger; zinken; kelderen; metaalgieter; mislukken; vader; vergaan; verongelukken
shepard => shepard
kindness => vriendelijkheid; liefheid; voorkomendheid; aardigheid; goedheid; goedhartigheid; welwillendheid; begunstiging; bereidvaardigheid; genadigheid
ashton => ashton
splits => spagaat; grand écart; split
window => venster; raam; ruit; loket; interval; etalage; opening; vitrine; uitstalraam; Venster
balding => kalen; kalend
veteran => veteraan; oudgediende; ervaren; oud-strijder
adams => adams
products => goederen; waar
hims => hims
famed => befaamd; beroemd; vermaard
mimic => nabootsen; kopiëren; imiteren; nadoen; namaken; afdrukken; naäpen; imitator; nabootsend; nabootser
casually => terloops; toevallig
pointed => spits; puntig; scherp; bijtend; doordringend; fel; guur; schel; schril; snerpend
international => internationaal; internationale; International; extern; externe
curls => krullen; lokken
enzyme => enzym; enzyme; ferment
anxiety => angst; bezorgdheid; ongerustheid; verlangen; spanning; zorg; vrees; anxietas; agonie; bekommernis
gould => gould
issue => uitgeven; emitteren; kwestie; nummer; uitvaardigen; uitgang; afkondigen; nageslacht; proclameren; verkondigen
record => record; verslag; plaat; grammofoonplaat; schijf; register; vastleggen; opnemen; discus; registreren
youthful => jeugdig; jong
twice => tweemaal; twee keer; dubbel
developed => bezonken; ontwikkeld
minute => minuut; minuscuul; nietig; notulen; notuleren; minuscule; minuutje; nietige; onbeduidend; onbeduidende
destroyed => vernietigd
pcp => pcp
robert => robert
inundated => overspoeld
false => vals; onwaar; fout; bedrieglijk; onecht; onjuist; loos; dubbelhartig; verkeerd; vervalst
naughton => naughton
exposed => naakt; blootgesteld; kwetsbaar; onbeschut; bloot; kaal
boxy => boxy
hummed => neuriede
brain => hersenen; brein; hersens; verstand; intellect; de kop inslaan; denkvermogen; geestvermogen; genie; op z'n kop slaan
matures => rijpt
transplant => omplanten; verplanten; overplanten; ent; transplantatie; transplanteren
bodies => lichamen
horrific => afschuwelijk; vreselijk; ontzettend; schrikwekkend; verschrikkelijk; gruwelijk; schrikbarend
chimed => chimed
roughly => grofweg; ongeveer; zowat; ruw; ruwweg; ruig; approximatief; omtrent; rond; bars
published => gepubliceerd
confided => toevertrouwd
easy => gemakkelijk; makkelijk; licht; vlot; eenvoudig; simpel; moeiteloos; bemiddeld; gegoed; gerust
becomes => wordt
befuddled => perplex; dronken; in de war; stomverbaasd; verdoofd; zat; onthutst; ontzet; paf; sprakeloos
century => eeuw; centurie; centennium; centuria; century
formed => gevormd
originally => oorspronkelijk; van oorsprong; indertijd; origineel; in het begin; op een nieuwe manier; aanvankelijk; afkomstig; allereerst; in eerste instantie
hamilton => hamilton
injectable => injecteerbare
chin => kin; Kin; chinchilla; kaak
rogaine => rogaine
handsome => knap; fijn; mooi; fraai; net; schoon; prachtig; aantrekkelijk; attractief; begeerlijk
opening => opening; gat; mond; begin; première; vacature; aanhef; apertuur; bres; hiaat
hair => haar; haardos; beharing; haren; pluis; wol; borstel; hoofdhaar; vacht
grow => groeien; wassen; kweken; aangroeien; stijgen; raken; gedijen; worden; gebeuren; toegaan
tattoos => tattoos
regeneration => regeneratie; gedaanteverwisseling; herschepping; metamorfose; vervorming; vernieuwing; wedergeboorte; herstel; aanpassing; adaptatie
consumer => consument; verbruiker; gebruiker; afnemer
punctured => lek
writing => geschrift; schrijfsel; schrijven; schrift; schriftuur; handschrift; geschrijf; oeuvre; werk; schrijf-
needle => naald; wijzer; kompasnaald; speld; naaien; pesten; plagen; stangen; spuit; injectienaald
epidermis => opperhuid; epidermis
declaration => declaratie; verklaring; aangifte; bekendmaking; betuiging; uitspraak; assertie; exposé; uitroepen
assume => aannemen; veronderstellen; innemen; vermoeden; menen; stellen; aanvaarden; overnemen; ervan uitgaan; nemen
suite => suite; gevolg; reeks; optocht; stoet
dog => hond; reu; Duna mi dolo di kabes; achternazitten; achtervolgen; kerel; klauw; mannetje; vent; vervolgen
seventy => zeventig
finasteride => Finasteride
pills => pillen
odd => vreemd; raar; oneven; bizar; merkwaardig; eigenaardig; gek; wonderlijk; vreemdsoortig; bij benadering
phase => fase; schijngestalte; kwartier; bouwfase; kapittel; stadium; faseren
neonatal => neonataal
week => week; wekelijks
develop => ontwikkelen; ontplooien; uitgroeien; zich ontwikkelen; maken; doen ontstaan; evolueren; formeren; ontwarren; uit elkaar halen
roses => rozen
pathways => paden
forties => jaren 1940; jaren 40; jaren veertig; quarantaine; veertig; veertigtal
steel => staal; stalen; balein; harden; temperen; uithoudingsvermogen; Bourgondisch vuurstaal; hard maken; indompelen; indopen
historian => historicus; chroniqueur; kroniekschrijver; geschiedkundige; geschiedschrijver
ruthless => onbarmhartig; meedogenloos; medogenloos; halsstarrig; hard; hardvochtig; onbuigzaam; onmeedogend; star; volhoudend
ager => ager
drawbacks => nadelen
woke => ontwaakte; ontwaakten; wekte; wekten
inversely => omgekeerd
delightfully => heerlijk; verrukkelijk
remarkable => opmerkelijk; merkwaardig; markant; opvallend; prominent; op de voorgrond tredend; uitstekend; vooruitstekend; bewonderenswaardig; bijtend
scrub => boenen; schrobben; kreupelhout; struikgewas; boender; schuren; stumper; wassen; afgelasten; afkrabben
neuroscientist => neurowetenschapper
meetings => vergaderingen
platelet => bloedplaatje
coast => kust; kustlijn; zeekust; zeekant; oever; kuststreek; glijbaan; boord; kant; kust-
promptly => prompt; stipt; accuraat; exact; gauw; hard; in allerijl; juist; nauwgezet; onmiddellijk
cream => room; crème; crèmekleurig; zalf; vla; crème de la crème; crèmewit; afromen; puikje; romen
technology => technologie; techniek; technology
falling => vallen; val
provide => voorzien van; voorzien; bevoorraden; stijven; verschaffen; provianderen; spekken; bezorgen; leveren; afleveren
dr => dr
units => eenheden; duizend; twaalf; twintig; zes
claim => claimen; opeisen; aanspraak; beweren; aanspraak maken op; claim; bewering; eis; pretentie; vordering
buren => buren
inject => injecteren; inspuiten; spuiten; injectie
partners => partners
followed => gevolgd
taken => genomen
technologies => technologieën
cheap => goedkoop; betaalbaar; ordinair; schamel; waardeloos; afgeprijsd; in aanbieding; laagwaardig; onduur; voordelig
regenerate => inschrijven; intekenen; vernieuwen; wedergeboren
replicel => replicel
lost => verloren; kwijt; verdwaald; vervlogen; de weg kwijt; verdwenen; weg; bijster; foetsie; onthutst
shirt => overhemd; hemd; shirt; map; ordner; T-shirt; badpak; kiel; trui; windsel
elected => gekozen; select; uitgelezen; uitgezocht; uitverkoren; verkozen
penises => penissen
texture => textuur; structuur; bouw; weefsel
favorite => favoriet; geliefkoost; lievelings-; uitverkoren; lieveling; geliefkoosd; gunsteling; kanshebber; favoriete
wildly => wild
follicles => follikels
wants => afwachting; verwachting
indicating => wijzend op
developmental => ontwikkelingsstoornissen
entrancing => bekoorlijk; charmant
repeatedly => herhaaldelijk; meermaals; telkens; keer op keer; meermalen; aanhoudend
gravity => zwaartekracht; gravitatie; ernst; gewicht; zwaarte; aantrekkingskracht; diepte; gewichtigheid; impact
mocked => bespotten
disorder => wanorde; stoornis; janboel; rommel; rotzooi; disorde; kwaal; verwarring; ontregelen; puinhoop
slim => slank; afslanken; dun; vermageren; tenger; rank; aan de lijn doen; lijnen; diëten; mager
whipped => slagroom
cloning => klonen; het klonen; kloneren
quest => zoektocht; speurtocht; queeste; speurwerk; streeftocht; onderzoek; zoeken; Queeste; nasporing
unit => eenheid; unit; afdeling; detachement; team; eendracht; groep; groepering; samenhang; toestel
physician => dokter; arts; geneesheer; medicus; doctor
east => oosten; oost; oostelijk; oostwaarts; oosters; oriënt; naar het oosten; ten oosten
product => product; opbrengst; resultaat; gewrocht; reactieproduct; voortbrengsel; productie; produkt; handelswaar; vrucht
quickly => gauw; vlug; snel; schielijk; in allerijl; spoedig; hard; gezwind; haastig; ras
refined => fijn; verfijnd; gevoelig; delicaat; iel; kies; teder; kieskeurig; tactvol; teer
unremarked => onopgemerkt
valley => dal; vallei; rivier; keteldal
ears => oren
dermatologist => dermatoloog; huidarts; huidspecialist
female => vrouwelijk; vrouw; wijfje; vrouwtje; wijf; dame; moer; vrouwtjes-; feminien; juffrouw
ticked => aangevinkt
massage => massage; masseren; manipuleren; vervalsen
partnered => partnered
majority => meerderheid; merendeel; meerderjarigheid; gros; majoriteit
bernanke => bernanke
eighty => tachtig; tachtigst
stepped => getrapt
altman => altman
bumps => drempels
implantation => implantatie; inplanting
farrellhair => farrellhair
abundance => overvloed; abundantie; onbekrompenheid; rijkdom; uitbundigheid; weligheid; abondantie; menigte; bij de vleet; in overvloed
smiled => glimlachte
stomach => maag; buik; dulden; velen; verdragen; zin; abdomen; dragen; gedogen; harden
tokyo => tokio
largely => grotendeels; ruimschoots; doorgaans; gemeenlijk; gewoonlijk; in het algemeen; over het algemeen; überhaupt; op grote schaal; gedeelte
root => wortel; stam; aanslaan; wortel schieten; machtswortel; radix; wroeten; aanvuren; administrator; beheerder
doctors => artsen
works => werken; fabriek; oeuvre; daden; metaalfabriek; bedrijf; mechanisme; werk
demand => eisen; vraag; eis; opeisen; vereisen; vragen; verlangen; voorschrijven; verzoeken; rekenen
prisoners => gevangenen
form => formulier; vorm; vormen; formeren; vormgeven; aangaan; gedaante; stand; gestalte; klas
yanking => yanking
trial => beproeving; probeersel; proef; proces; rechtzaak; proefstuk; trialis; berechting; test; onderzoek
investors => investeerders
displays => displays
surgery => chirurgie; heelkunde; operatie; wondheelkunde; spreekkamer; ingreep; operatiekamer; bewerking
wearing => vermoeiend; vervelend
spare => sparen; ontzien; besparen; bezuinigen; uitsparen; uitwinnen; uitzuinigen; toegeeflijk zijn voor; zich laten vermurwen; extra
papilla => tepel; papil
counter => balie; toonbank; aanrecht; teller; loket; stuk; tegen; tegengesteld; tegenmaatregel; tegenover
jutting => jutting
candidates => kandidaten
marked => een; op; merkbaar; opvallend; drukken; invloed; stempel; stempelen; uitoefenen; duidelijk
gang => bende; schare; troep; gang; ploeg; compagnie; rot; stel; vendel; gaan
surly => bars; nors; honds; nurks; onaardig; onvriendelijk; knorrig; mistroostig; stuurs; zuur
destination => bestemming; doel-; doel; doelvoorziening; reisbestemming; reisdoel; toepassing; meet
proven => bewezen
use => gebruiken; gebruik; nut; toepassing; aanwenden; benutten; aanwending; functie; toepassen; genot
follicle => follikel; Kokervrucht; kokervrucht
peak => piek; top; spits; tip; toppunt; hoogtepunt; neus; punt; topje; climax
medicine => medicijn; geneeskunde; artsenij; geneesmiddel; medicament; medicijnen; medium; geneeskunst; medicatie; medikament
administration => administratie; bestuur; beheer; toediening; administratiekantoor; bewind; regering; heerschappij; gouvernement; overheid
cancer => kanker; kreeft; kankergezwel; cancer; carcinoom; krab; mondkanker
meltdown => kernsmelting; meltdown
anatomist => anatoom; ontleedkundige
twenties => jaren 1920; jaren 20; jaren twintig
bit => bit; beetje; stuk; hapje; boortje; beting; brok; stukje; ietsje; snufje
clinical => klinisch
hairs => haren; haar
cord => koord; touw; kabel; snaar; zeel; snoer; stemband; koorde; lijn; draad
main => hoofd-; voornaamste; hoofdzakelijk; belangrijkste; belangrijk; belangrijkst; hoofdzakelijke; voornaam; eerste; hoofdleiding
whisker => snor; baardhaar; bakkebaarden; ei zo na; op een haar na; Whisker; bakkebaard; snorhaar
follicum => follicum
secretary => secretaresse; secretaris; scriba; sekretaresse; minister; sekretaris; schrijftafel; secretariaat; vertrouweling; beheerder
testosterone => testosteron
beautiful => mooi; schoon; fraai; fijn; aantrekkelijk; knap; prachtig; net; bekoorlijk; bevallig
procedure => procedure; werkwijze; bereidingswijze; procédé; methode; handelwijze; formaliteit; manier; gebeurtenis; gedrag
house => huis; pand; geslacht; kamer; onderbrengen; onderkomen; familie; woning; herbergen; huisvesten
hairdresser => kapper; kapster; coiffeur; barbier; herenkapper
pattern => patroon; sjabloon; knippatroon; schablone; schema; model; tekening; staal; toonbeeld; voorbeeld
penetrate => doordringen; binnendringen; penetreren; doorstoten; binnengaan; binnenkomen; binnenlopen; binnenvallen; doorgronden; doortrekken
jason => jason
usage => gebruik; gewoonte; usance; zede; baan; aanwending; aanwensel; bediening; behandeling; benutting
sheath => schede; huls; foedraal; terugtrekken; bladschede; condoom; in de schede steken; bezoldiging; etui; gage
workshop => werkplaats; atelier; workshop; Workshop; garage; werklokaal
help => helpen; hulp; bijstaan; bijstand; assisteren; assistentie; ter zijde staan; help; baten; steun
patients => patiënten
perceive => waarnemen; bespeuren; bemerken; ontwaren; merken; in de smiezen krijgen; in het oog krijgen; gewaar worden; gewaarworden; vernemen
counsels => raadgevingen
therapy => therapie; behandeling; geneeswijze
having => scherp; zoet
understood => begrepen; verstaan; begreep; verstond; verstonden
existing => bestaande; bestaand; aanwezig; existent
scientists => wetenschappers
psychological => psychologisch; zielkundig; psychisch
tiny => klein; minuscuul; piepklein; miniem; minuskuul; propperig; kleintje; diminutief; dwergachtig; fijne
dysfunction => dysfunctie
involved => betrokken; ingewikkeld; gecompliceerd; geëngageerd
dax => dax
toupees => pruiken
theoretically => theoretisch
drenched => doornat; doorweekt; drijfnat; kletsnat; poedelnat; zeiknat; doorweekte; kleddernat; nat
injuries => verwondingen
potent => machtig; krachtig; sterk; fiks; geducht; straf; zwaar; krukkenvair; invloedrijk
screens => screens
expired => verlopen; vervallen; afgelopen
bomber => bommenwerper
obsessed => bezeten; geobsedeerd; geobsedeerde; verdiept
fat => vet; dik; corpulent; gezet; vetlaag; lijvig; vetmesten; zwaarlijvig; volslank; vettig
thick => dik; dikke; dicht; dichte; gezet; gebonden; lijvig; dichtopeengepakt; dichtopeengepakte; gezette
belt => riem; gordel; ceintuur; omgorden; veiligheidsgordel; klap; broeksband; brullen; dreun; insnoeren
huge => enorm; gigantisch; reusachtig; kolossaal; geweldig; ontzaglijk; breedvoerig; royaal; groot; omvangrijk
modified => gemodificeerde
patents => patenten
scalp => kruin; scalp; hoofdhuid; scalperen; Kruin
caution => voorzichtigheid; waarschuwing; waarschuwen; omzichtigheid; voorzorg; manen; borg; borgsom; garantie; waarborg
god => god; godheid; afgod; idoliseren; verafgoden; God; godenbeeld; idool
attractive => aantrekkelijk; aanlokkelijk; bevallig; aanminnig; grappig; interessant; lekker; bekoorlijk; aardig; attractief
artas => artas
com => com
targeting => gericht op
lip => lip; grote bek; grote mond; tegenspraak; onbeschaamdheid; rand; Lip; mompelen
done => klaar; gedaan; gaar; afgelopen; afgewerkt; beëindigd; op; gebeuren
dozed => dommelde
therapies => therapieën
singapore => singapore
obsession => obsessie; bezetenheid; fixatie; dwangvoorstelling; nachtmerrie
vancouver => vancouver
pseudonymous => pseudoniem
rich => rijk; vermogend; gefortuneerd; overvloedig; rijkelijk; ruim; machtig; uitbundig; volop; weelderig
podcast => podcast; podcastuitzending
paraffin => paraffine; alkaan; parafine; kerosine
punched => geponst
topically => actueel; tegenwoordig; thematisch
hamburgers => hamburgers
commercial => commercieel; reclamespot; commercial; advertentie; reclame spotje; reclameboodschap; handels-; zakelijk
always => altijd; steeds; immer; altoos; constant; almaar; alsmaar; continu; elke keer; iedere keer
rat => rat; bruine rat; rioolrat; zwarte rat; rot; muis; overloper; muizen en ratten van de Oude Wereld; gluiperd; rattus
savoir => savoir
newspaper => krant; dagblad; nieuwsblad; courant; blad; krantenpapier; gazet; tijdschrift; dagblad '' ''; magazine
shoot => schieten; scheut; vuren; paffen; doodschieten; spruit; uitloper; stik; loot; uitspruitsel
baldness => kaalheid; haaruitval; kaalhoofdigheid; alopecia androgenetica; alopecie
awe => ontzag; vrees; angst; eerbied; consternatie; ontsteltenis; respect; stupor; verbijstering; verslagenheid
doctor => dokter; arts; doctor; geneesheer; medicus; dokteren; valsificeren; genezen; gezond maken; helen
programmed => geprogrammeerd
plasma => plasma; bloedplasma
wood => hout; woud; bos; houtsoort; bebossen; brandhout; houten; woudland; foreest; aangelegd bos
generic => generiek; algemeen; generiek product; gemeenschappelijk; geslachtelijk; gezamenlijk
bloody => bloederig; bloederige; bloedig; stomme; verdomd; bloedend; bebloed
sites => plaatsen
traditional => traditioneel; traditionele
discovered => ontdekt
grown => gegroeid; gekweekt; volwassene
bubbled => geborreld
cure => genezen; helen; remedie; behandelen; cureren; geneesmiddel; kuur; beter worden; genezing; herstellen
oklahoma => oklahoma
high => hoog; high; verheven; lang; hard; luid; groot; krachtig; opperst; sterk
mankind => mensheid; mensdom; mensengeslacht; mens; aard; geslacht; humaniteit; klasse; menselijkheid; slag
publicity => publiciteit; ruchtbaarheid; propaganda; reclame; verspreiding; openbaarheid; openbaarmaking; bekendheid
stockholm => stockholm
regulating => regelend
techniques => technieken
ride => rijden; gaan; varen; karren; rit; lopen; verlopen; zich begeven; berijden; auto
function => functie; functioneren; fungeren; ambt; dienen; het doen; baan; betrekking; plaats; in zijn werk gaan
tops => maximaal; maximum; aas; beste; crack; grootmeester; kanjer; kei; kraan; raspaardje
watched => bekeken
parker => parker
canadian => Canadees; canadees
consider => beschouwen; overwegen; bedenken; nemen; bekijken; betreffen; gelden; kijken; aannemen; in acht nemen
poked => prikte
dude => kerel; vent; maat; knul; kwast; saletjonker; dandy; fat; modepop; makker
leather => leer; leder; leren; lederen; leerachtig; taai; zemen; huid; leder-; leer-
iconically => iconisch
takes => neemt
booming => donder; donderend; dreunend
site => ligging; plaats; zetel; ruimte; oord; plek; locatie; site; dorp; lokaliteit
adult => volwassene; volwassen; meerderjarig; volgroeid; mondig; rijp; adult; groot; aanmerkelijk; aanzienlijk
risky => gewaagd; riskant; bedenkelijk; gevaarlijk; waaghalzerig; hachelijk; link; bedreigend; gevaarvol; gis
artfully => geslepen; gewiekst; handig; leep; uitgekookt; doortrapt; glad; kunstmatig; listig
thirty => dertig
grafts => transplantaten
modify => modificeren; wijzigen; veranderen; aanpassen; bewerken; altereren; changeren; converteren; afstellen; bepalen
churns => karnen
credibility => geloofwaardigheid; betrouwbaarheid
spotty => puistig; gevlekt
practice => praktijk; oefenen; oefening; uitoefening; gebruik; aanwenden; gewoonte; doorvoeren; in de praktijk brengen; beoefen
suffer => lijden; dragen; ondergaan; naar buiten brengen; doorstaan; velen; verdragen; uithouden; uitstaan; dulden
identified => geïdentificeerd
candidate => kandidaat; kandidate; sollicitant; aspirant; gegadigde; kandideren; verkiezingskandidaat
c => C
civilization => beschaving; civilisatie; beschaven; bewoonde wereld; cultuur
cup => kopje; beker; kop; tas; mok; bekertoernooi; bokaal; jat; cup; kelk
reminded => herinnerde
sell => verkopen; verhandelen; overdoen; tappen; vervreemden; wegdoen; verraden; afzetten; afzetterij; bedriegen
clutch => koppeling; grijpen; vastgrijpen; aangrijpen; ontkoppelingspedaal; bemachtigen; klauw; greep; beetpakken; beetnemen
pop => pap; plop; pappa; knal; knallen; plek; populair; schieten; frisdrank; pop-bewerking uitvoeren
tore => torus; scheurde; scheurden
jacket => jas; jasje; colbert; buis; omslag; vest; kaft; bedekking; deken; deksel
dissecting => ontleden
liberating => bevrijdende
compound => samenstelling; verbinding; samengesteld; complex; mengsel; compositie; chemische verbinding; compound; composiet; erf
lead => leiden; lood; aanvoeren; leiding; vooroplopen; begeleiden; besturen; de weg wijzen; geleiden; voeren
extended => groot; uitgebreid; chronisch; langdurig; breedvoerig; omvangrijk; royaal; ruim; uitgestrekt; veelomvattend
formation => formatie; vorming; rotsformatie; samenstelling; configuratie; Formatie; Formation; wording
hallway => gang; corridor
tweezers => pincet; nijptang; tang; veertangetje
stopped => gestopt
nuts => bah; gek; dolzinnig; geschift; getikt; krankzinnig; waanzinnig; dol; getroebleerd; getroubleerd
cures => kuren
gash => jaap; houw; snede; snijden
till => tot; kas; totdat; ploegen; fonds; geldkist; kassa; voor; bebouwen; bewerken
picked => uitgekozen; uitgelezen; uitgezocht
cloned => gekloond
disputed => betwist; kwestieus; omstreden
fingers => vingers
shampoos => shampoos
beat => afranselen; winnen; klappen; pols; halen; houwen; meppen; overtreffen; polsslag; swingen
locks => sluizen
castrated => gecastreerd
embryonic => embryonaal; kiem; onrijp
agency => agentschap; bureau; kracht; macht; agentschapsbureau; agentuur; medium; middel; remedie; weg
pizza => pizza
results => bevinding
manhattan => manhattan
regenerative => herstellend
geneticist => geneticus
chicken => kip; hen; kippenvlees; kuiken; lafaard; hoen; angsthaas; wezel; kippevlees; lafbek
claims => eisen
sewn => genaaid
flashy => flitsend; opzichtig; kleurrijk; opvallend; voyant
propecia => propecia
gap => opening; bres; gaping; gat; hiaat; lacune; leemte; kloof; afwezigheid; euvel
fund => fonds; kapitaal; financieren; kas; geldkist; voorraad; bak; bekostigen; bezitting; boerderij
assault => aanranden; aanval; aanvallen; aanranding; vergrijpen; aangrijpen; aantasten; aanslag; bestorming; attaque
beginning => begin; aanvang; ontstaan; start; vertrek; aanhef; bron; genese; intrede; inzet
nothing => niets; niks; niemendal; nihil; nul; helemaal niet; niemand
skin => huid; vel; villen; skin; afstropen; onthuiden; pels; schil; vacht; dierevel
convicted => veroordeeld; veroordeelde
trotted => draafde
specializing => gespecialiseerd
entered => ingevoerde
incision => incisie; hak; inkerving; insnijding; kerf; snede
nerve => zenuw; geduld; lef; moed; durf; nerf; neuron; neuronenbundel; stalen zenuwen; sterke zenuwen
quietly => rustig; op zijn gemak; kalm; stil; zachtjes; kalmpjes; bedaard; gerust; zoetjesaan
beautifully => mooi; net; schoon
laser => laser; laserstraal
true => waar; echt; trouw; gelijk hebbend; juist; eigenlijk; gegrond; heus; waarachtig; rechttrekken
minoxidil => Minoxidil
paper => papier; document; krant; behangen; papieren; akte; bescheid; werk; eindwerk; schriftuur
blitz => blitz
stabilize => stabiliseren
invented => fictief
obviously => klaarblijkelijk; duidelijk; blijkbaar; vanzelfsprekend; overduidelijk; natuurlijk; uiteraard; kennelijk; begrijpelijkerwijs; dat spreekt vanzelf
elliott => elliott
supply => leveren; aanvoer; bevoorraden; aanvoeren; bevoorrading; bezorging; stijven; voorraad; voorziening; voorzien van
sandwich => sandwich; boterham; broodje
united => verenigd; gezamelijk; verbonden; eendrachtig
giant => reus; reusachtig; gigantisch; enorm; reuzen-; kolossaal; gigant; kerel; Reus; giantisch
learned => geleerd; knap; ontwikkeld; aangeleerd; belezen; academisch; erudiet
nonsense => onzin; nonsens; flauwekul; zever; gekheid; ongerijmdheid; kletspraat; absurditeit; onding; zottenklap
lee => lij; lijzijde; luwte; lijzij; lee
marriott => marriott
especially => vooral; in het bijzonder; inzonderheid; voornamelijk; speciaal; hoofdzakelijk; specifiek; met name; bijzonder; apart
sunday => zondag
reporting => berichtgeving; melding
met => ontmoet; ontmoette; ontmoetten
stuff => spul; stof; vullen; goedje; dingen; opzetten; spullen; waar; materiaal; opvullen
saying => gezegde; spreekwoord; spreuk; zegswijze; aforisme; citaat; frase; zinspreuk; adagium; judicium
beers => bieren
capillus => capillus
martin => zwaluw; huiszwaluw; martin; martinus
converts => bekeerlingen
kutcher => kutcher
bottom => bodem; onderkant; zitvlak; kont; grond; ondergrond; bottom; bil; bips; achtergrond
worker => arbeider; werker; werkkracht; werkman; arbeidskracht; werkmier; werkster; arbeidster; bewerker; employé
substance => substantie; stof; goedje; spul; zelfstandigheid; essentie; kern; wezen; inhoud; vermogen
casper => casper
pleasurable => plezierig; genotvol; prettig; aangenaam; genoeglijk
horn => hoorn; claxon; toeter; horen; trompet; horn; gewei; Jachthoorn; hoornen; orkesthoorn
robotic => robot
strip => strook; strippen; reep; strip; band; uitkleden; windsel; landingsbaan; afstropen; streep
questions => vragen
nurses => verpleegkundigen
customers => klanten; klantenkring
transplantation => transplantatie; overplanting; verplanting
space => ruimte; spatie; bestek; speling; wereldruim; plaats; afstand; heelal; tijdje; Space
places => plaatsen
applied => aangewend; aangebracht; toegepast
presidents => presidenten
buckler => beukelaar; schild
none => geen; niemand; niet een; niets; geen enkel; geen enkele; niks; niemendal; geen zier
primary => primair; voornaamste; hoofd-; oorspronkelijk; eerst; eerste; primaire; eerstegraads; elementair; grond-
carpet => tapijt; vloerkleed; karpet; kleed; leggen; bedekken; loper; vloerbedekking; mat; tapijten
risk => risico; riskeren; wagen; risico nemen; op het spel zetten; kans lopen; gewaagdheid; waagstuk; gevaar; risico lopen
communicate => communiceren; meedelen; mededelen; berichten; overbrengen; aansteken; besmetten; infecteren; voortzeggen; schrijven
currently => momenteel; tegenwoordig; huidig; nu; thans; op het ogenblik; heden ten dage; nou; vooralsnog
parts => delen; talent; deel; gebied; streek
stick => stok; kleven; plakken; staf; stekken; lijmen; vastkleven; tak; aanhangen; blijven steken
duplicating => dupliceren
companies => bedrijven
creation => creatie; schepping; uitvinding; aanstelling; formatie; genese; oeuvre; geboorte; manifestatie; ontstaan
thatchy => thatchy
community => gemeenschap; gemeente; commune; maatschappij; community; samenleving; buitenwacht; communiteit; gemeenschappelijkheid; bevolkingsgroep
laughed => lachte
patterns => patronen
problem => probleem; vraagstuk; opgave; vraagpunt; oefening; kwaal; moeilijkheid; opgaaf; problematiek; kwestie
shrink => krimpen; verschrompelen; zielknijper; ineenkrimpen; ineenkronkelen; psychiater; slinken; zielenknijper; ineenschrompelen; inkorten
hole => gat; kuil; opening; holte; put; leemte; gracht; greppel; groef; groeve
grew => groeide; groeiden
iia => iia
walked => wandelde
daniels => daniels
stimulate => stimuleren; prikkelen; aansporen; ophitsen; aanstoken; aanvuren; aanwakkeren; irriteren; zwepen; opwekken
stop => stoppen; ophouden; aanhouden; halte; beëindigen; halthouden; stilstaan; stop; afbreken; punt
norman => normandisch
took => nam; namen
bathroom => badkamer; toilet; badhuis; zwembad; bad; badplaats; privaat; wasgelegenheid; wc; W.C.
dalliance => flirt; gelanterfanter; tijdverlies; verspilling
spinach => spinazie
treatments => behandelingen
silicon => silicium; kiezel
earnestly => serieus; ernstig; in ernst
hairy => harig; behaard; ruig; ruigharig
removed => verwijderd
heads => kruis; koppen
protects => beschermt
sells => verkoopt
richard => richard
specific => specifiek; soortelijk; bijzonder; kenmerkend; bepaald; expliciet; afzonderlijk; concreet; eigen; eigenaardig
versions => versies
microscope => microscoop
base => basis; base; baseren; hoofdkwartier; honk; kazerne; vertrekpunt; gronden; fundament; grond
padded => gewatteerd
imbalance => onbalans
hippopotamus => nijlpaard; hippopotamus; Nijlpaard
magazines => tijdschriften
rolling => walsen; meeklinkend; resonerend; rollend
article => artikel; lidwoord; handelsartikel; bericht; handelswaar; object; onderdeel; stuk; waar; bijdrage
malaysia => maleisië
mcdonald => mcdonald
option => optie; keus; keuze; alternatief; verkiezing; voorkeur; keur; Option; keuzemogelijkheid; voorliefde
christiano => christiano
danger => gevaar; bedreiging; hachelijkheid; onraad; nood; perikel; gevaarlijkheid; kans; dreiging; onheil
advertises => adverteert
prostates => prostates
pours => giet
unexpectedly => onverwachts; eensklaps; onverwacht; bij ongeluk; per ongeluk; zonder opzet; plotseling
grafted => geënt
competing => concurrerend
topical => actueel; tegenwoordig; topisch; plaatselijk; huidig; in de mode; in zwang; modieus; thematisch
recruiting => rekruteren
orentreich => orentreich
dollars => dollars
satiating => verzadigend
seeking => onderzoek; queeste; speurtocht; speurwerk; zoektocht
disruptors => verstoorders
artificial => artificieel; kunstmatig; onnatuurlijk; nagemaakt; gekunsteld; gewrongen; gemaakt; artistiek; gezocht; kunstig
michael => michaël
particular => bijzonder; afzonderlijk; speciaal; afgezonderd; los; bepaald; bijzonderheid; detail; precies; specifiek
snake => slang; serpent; slangen; Slang; cobra
creating => het creëren van
creative => creatief; kunstzinnig; scheppend; artistiek; creatiev; oorspronkelijk; productief; produktief
called => heten; genaamd; heet
dedicated => toegewijd; gewijd; geëngageerd
reading => lezen; lezing; uitlezing; lectuur; voorlezen; inschatting; lees; interpretatie; leesvaardigheid
harmless => ongevaarlijk; onschadelijk; veilig; goedaardig; gevaarloos; behouden; betrouwbaar; bona fide; geborgen; gewis
confronted => geconfronteerd
fifties => jaren 1950; jaren 50; jaren vijftig
extracts => extracten
approaches => benaderingen
flight => vlucht; vliegen; vliegtocht; loop; troep; zwerm; ontsnapping; escape; flight; lek
alexander => alexander
knows => weten
process => proces; verloop; werkwijze; bewerking; procédé; bereidingswijze; ontwikkelingsgang; bewerken; behandelen; procedure
stumbled => struikelde
dihydrotestosterone => Dihydrotestosteron; dihydrotestosteron
ii => ii
worst => slechtst; ergst; slechtste; verslaan
stigma => stigma; olifantssnuit; slurf; snuit; stempel; tromp; Stempel; schandvlek
enlarged => gezwollen
methods => methodiek
semester => semester; kwartaal; trimester
weird => bizar; vreemd; raar; eigenaardig; merkwaardig; bovennatuurlijk; vreemdsoortig; geschift; ongewoon; getikt
began => begon
angela => Angela
freeing => emancipatie
non => niet; vrij
far => ver; verwijderd; ververwijderd; veraf; verafgelegen; afgelegen; heen; over; weg; vandoor
parm => parm
paused => onderbroken
colors => vlag; kleuren; standaard; ICOVA; colors; vaandel; vendel
erectile => erectiel
offered => aangeboden
salesmen => verkopers
pioneering => baanbrekend
readership => lezers; lezerskring; lezerspubliek
fully => volledig; geheel; volkomen; heel; compleet; ten volle; helemaal; voluit; finaal; totaal
started => begonnen
bernstein => bernstein
petri => petri
boxes => dozen
spinal => spinaal
lab => laboratorium; lab; labo
theory => theorie; hypothese; veronderstelling; idee; leer
road => weg; baan; straat; route; eenbaansweg; heerbaan; hoofdweg; rijweg; spoor; straatweg
san => san
level => niveau; vlak; waterpas; verdieping; etage; egaliseren; hoogte; peil; effen; gelijk
packaging => verpakking; omhulsel; emballage; verpakken; verpakkingsindustrie; verpakkingsmateriaal
trotting => draven
penis => penis; lul; lid; piemel; mannelijk lid; pik; jongeheer; leuter; fallus; plasser
serendipity => serendipiteit; toevalstreffer; gelukkig toeval
ugly => lelijk; rot; shit; shit-; vervelend; bedenkelijk; grotesk; kwaad; miezerig; schamel
stitch => steek; stikken; naaien; steken; pikken; priemen; prikken; panorama maken; borduren; breisteek
sweden => zweden
nice => aangenaam; fijn; mooi; aardig; lekker; leuk; vriendelijk; behaaglijk; heerlijk; genoeglijk
portion => portie; deel; aandeel; dosis; rantsoen; dosering; toewijzen; uitdelen; verdelen
areata => areata
race => ras; afkomst; geslacht; stam; race; rennen; racen; volksstam; razen; soort
kuntzman => kuntzman
slap => oorveeg; mep; meppen; lel; draai om de oren; klets; kletsen; neerkwakken; klap; slaan
executive => uitvoerende macht; bestuur; directeur; regering; bevel; bewind; commando; heerschappij; uitvoerend; kader
protein => proteïne; eiwit; eiwitstof
walking => lopen; wandelen; ambulant; gaan; loop; opstap; opstapje; rit; tocht; trede
regrowth => hergroei
dermis => Dermis; dermis; huid; lederhuid; vel
receding => terugwijkende
warby => warby
hands => handen; handen-
xeljanz => xeljanz
arthritis => artritis; gewrichtsontsteking; jicht
impaired => verstoord; beschadigd; verminderd; verzwakt
boots => laars; laarzen
ancient => antiek; aloud; ouderwets; oeroud; oud; eeuwenoud; eertijds; weleers; oudheid; antediluviaal
attempting => proberen
boom => giek; boem; dreunen; hoogconjunctuur; hausse; donderen; bloeien; boom; floreren; kaboem
ronald => ronald
pre => pre
efforts => bemoeienis; geploeter; gesjouw; streven
black => zwart; negerin; neger; zwarte; donker; duister; somber; aardedonker; gitzwart; pikdonker
loop => strik; lus; breisteek; maas; steek; herhaling; repetitie; strop; herhalen; boog
proselytizer => proselytizer
hail => hagel; hagelen; begroeten; toejuichen; roep; bij acclamatie benoemen tot; halen; uitroepen tot; zijn bijval betuigen; aanhalen
lifelong => levenslang
fourth => vierde; kwart; vierendeel; Kwart
experimenting => experimenteren
density => dichtheid; dikte; waarschijnlijkheid; compactheid; Aptenocanthon wollumbin; Dichtheid; densiteit; soortelijk gewicht; soortelijke massa
ago => geleden; eertijds; voorbij; verleden
luscious => wulps; delicieus; obsceen; smaakvol; verleidelijk; zoet; verrukkelijk; aanbiddelijk; aantrekkelijk; begerenswaardig
solution => oplossing; uitkomst; solutio; antwoord; resultaat; solutie
six => zes; zestal; six
lund => lund
hairlines => haarlijnen
following => volgend; volgende; aanhang; leden; aanstaand; navolgend; volgeling; aankomend; gevolg; komend
go => gaan; lopen; rijden; go; verdwijnen; varen; weggaan; poging; van stapel lopen; verlopen
sleeves => mouwen
particularly => in het bijzonder; inzonderheid; vooral; speciaal; hoofdzakelijk; voornamelijk; bijzonder; afzonderlijk; apart; bepaald
automatically => automatisch; vanzelf; zelfwerkzaam
identity => identiteit; persoonlijkheid; identiteiten; overeenstemming; Identiek; Identiteit; individualiteit
coverage => dekking; omvang
rheumatoid => reumatoïde
proprietor => eigenaar; bezitter; mede-eigenaar; partner; baas; grondbezitter; huisbaas; uitbater; bezitster; eigenares
dark => donker; duister; ongewisse; somber; onwetendheid; duisternis; geheim; het vallen van de avond; nachtval; onbekend
snug => nauwsluitend; Snug; behaaglijk; gezellig; knap; knus; lekker; netjes
bald => kaal; kaalhoofdig; afgesleten; kalen; bloot; kaal worden; naakt
german => Duits; Duitse; Duitser; Germaan; duits; duitser; vol
pressure => druk; aandrang; pressie; drang; knel; benauwdheid; bezetting; dwang; spanning; belasting
lightly => licht; lichtjes; zwak; zwakjes; voorzichtig; zachtjes; gemakkelijk; handig; luchtig
birds => gevogelte; vogelstand; vogelwereld
win => winnen; overwinnen; behalen; overwinning; verdienen; succes; baat; gewin; verdienste; verkrijgen
web => web; net; vlies; koord; Web; spinnenweb; baard; spinneweb; weefsel; weven
signal => signaal; sein; teken; seinen; een sein geven; signaleren; blijk; merkteken; bewijs; wenk
science => wetenschap; ervaring; kennis; weten; natuurwetenschap; natuurwetenschappen; kunde; wetenschappelijk; techniek
stormy => stormachtig; onweerachtig; ontstuimig
mails => mailen
aesthetics => esthetica; schoonheidsleer
wife => echtgenote; vrouw; gemalin; man; eega; echtgenoot; gemaal; gade; wederhelft; wijf
diego => diego
clients => klanten
project => project; projecteren; ontwerp; plan; concept; blauwdruk; onderneming; opzet; plattegrond; plannen
stylist => stilist
cap => pet; muts; dop; baret; hoed; kapje; deksel; kap; bedekken; kornet
pressing => dringend; brandend; spoedeisend; urgent; nijpend; persen; aandrang; aandrukken; drang; dreigend
managed => beheerd
obsessives => obsessives
clockwise => met de klok mee; rechtsom; in wijzerzin; Met de wijzers van de klok mee; wijzerzin
alopecia => alopecie; haaruitval; kaalhoofdigheid; kaalheid; Alopecia
expression => uitdrukking; gelaatsuitdrukking; uiterlijk; spreekwijze; gezegde; zegswijze; bewoording; expressie; wijze van spreken; gezicht
ad => advertentie; aankondiging; bericht; reclame; openbaarheid; publiciteit; ruchtbaarheid
implanted => geïmplanteerd
hoping => hoop
confident => zelfverzekerd; zelfbewust; vertrouweling; overtuigd; vol vertrouwen; zeker
prepped => prepped
proprietary => particulier; bedrijfseigen; bezit; eigenaar
summer => zomer; zomertijd; slijten; verbrengen; verslijten
pads => pads
anybody => iemand; een of ander; een of andere; enig; een ieder
counterclockwise => linksom draaiend; tegen de klok in
conference => conferentie; bespreking; congres; overleg; vergadering; conference; conventie; seminar; assemblage; assemblee
seated => gezeten
often => vaak; dikwijls; gedurig; veeltijds; menigmaal; veel; veelal; veelvuldig; dikwerf; frequent
dht => dht
engineered => gemanipuleerde
liars => leugenaars
notice => opmerken; bemerken; merken; bericht; aanplakbiljet; aankondiging; opmerking; affiche; kennisgeving; waarnemen
garfield => garfield
rocket => raket; vuurpijl; raketsla; rucola
farrell => farrell
curl => krul; rotatie; krullen; kappen; lok; friseren; doorroeren; haarkrul; haarlok; omroeren
strange => vreemd; raar; wonderlijk; buitenlands; onbekend; eigenaardig; gek; onwennig; vreemdsoortig; bizar
trillion => biljoen; triljoen
dropping => achteruitgang; besnoeiing; daling; debâcle; degeneratie; degradatie; kleinering; ondergang; ontaarding; rampspoed
hormonal => hormonaal
optional => optioneel; facultatief; niet verplicht; vrijblijvend
osteopontin => osteopontine
overflowing => overbodig; overtollig; alluvium; overlopen
focusses => richt
feet => voeten; voet
hanging => verhanging; hangend; hangende; behang; verhangen; ophanging; wandtapijt; hangen
buy => kopen; aanschaffen; aankopen; koop; overnemen; verwerven; afnemen; behalen; inkopen; verkrijgen
able => competent; bekwaam; handig; bedreven; kundig; in staat; aanmerking; capabel; de; hebben
benchmarks => benchmarks
lifer => levenslang veroordeelde
european => europese
reported => gerapporteerd
moved => bewogen; aangedaan; verplaatst; geroerd; verschoven
brooklyn => brooklyn
wigs => pruiken
cylinders => cilinders
grail => graal; kelk
twentieth => twintigste; twinstigste
worldwide => wereldwijd; universeel; over de hele wereld; wereldwijde; algemeen; globaal; wereld-; mondiaal; internationaal; wereldlijk
jan => januari
dramatically => ineens; opeens; plotseling; allemachtig; extreem; hoogst; in hoge mate; meest; uitermate; uiterst
moving => ontroerend; aandoenlijk; aangrijpend; roerend; bewegend; bewegende; emotioneel; ontroerende; treffend; beweeglijk
appointment => afspraak; aanstelling; rendez-vous; benoeming; ambt; baan; betrekking; post; plaats; uitrusting
solved => opgelost
cruelly => wreed
puncturing => doorprikken
studied => geleerd; gezocht; opzettelijk
money => geld; poen; valuta; money; munten; zilver
partner => partner; vennoot; lid; associé; maat; makker; compagnon; deelgenoot; bondgenoot; gezellin
van => bestelwagen; wagon; bestelauto; voorhoede; vrachtwagen; rijtuig; wagen; bestelbus; bus; camionette
onto => op; aan; bij; in; naar; binnen; dichtbij; elk; erop; ieder
midtown => midtown
thirties => jaren 1930; jaren 30; jaren dertig
eyebrows => wimpers
botox => botox
tofacitinib => tofacitinib
trials => trials
houses => huizen
factors => factoren
startup => opstarten; opstart
perfectly => perfect; helemaal; volledig; volmaakt; uitstekend; absoluut; compleet; faliekant; finaal; geheel
bountiful => mild; overvloedig; rijkelijk; weldadig
mechanical => mechanisch; werktuiglijk; mechanische; machinaal; gedachteloos; gedachteloze; automatisch
robs => robs
chatted => babbelden
trace => spoor; opsporen; voetspoor; calqueren; afdruk; overtrekken; afbakenen; sporen; nazoeken; spoorzoeken
chunk => brok; klomp; stuk; klont; kluit; prop; bal; dot; blok; bonk
prominently => prominent
affected => aangedaan; aanstellerig; onnatuurlijk; aangegrepen; gekunsteld; gemaakt; gewrongen; onecht; onwaar; aangetast
emotional => emotioneel; gevoelsmatig; aangrijpend; emontioneel; ontroerend; roerend; geëmotioneerd; psychisch
eternal => eeuwig; eindeloos; altijddurend; eeuwigdurend; onveranderlijk; voortdurend; Eeuwig; blijvend; doorlopend; eeuwige
migrate => trekken; rondreizen; rondtrekken; zwerven; migreren; verhuizen; dwalen; werken
initiate => beginnen; ingewijde; de stoot geven tot; aanvangen; initiëren; beginner; starten; het initiatief nemen tot; inleiden; inwijden
bears => beren
slice => schijf; plak; moot; snede; snee; snijden; filet; sneetje; snerpen; deel
arm => arm; bewapenen; wapen; wapenen; wapenschild; hand; bovenarm; armleuning; been; leuning
placards => plakkaten
regular => regelmatig; gelijkmatig; regelmatige; gewoon; geregeld; vast; stamgast; gewone; vaste; steevast
semi => gedeeltelijk
offering => offer; aanbod; offerande; offergave; aanbieden; aanbieding; gift; opoffering
toward => naar; bij; aan; tegen; tot; voor; betreffende; in verband met; op het stuk van; ten opzichte van
quality => kwaliteit; eigenschap; allooi; hoedanigheid; klasse; aanleg; attribuut; bekwaamheid; kaliber; rang
informed => onderlegd; welingelicht
seventeen => zeventien
injected => geïnjecteerd
giving => genereus; gul
vote => stemmen; stem; kiezen; verkiezen; stembusgang; balloteren; zijn stem uitbrengen; stemming
appreciated => geschat
columbia => columbia
surprise => verrassing; verrassen; verbazing; verbazen; betrappen; bevreemding; verwondering; snappen; verwonderen; surprise
distinct => duidelijk; klaar; uitgesproken; helder; transparant; afzonderlijk; apart; onderscheiden; ongelijk; verschillend
aforementioned => eerder vernoemde; voorgenoemde; voornoemde; eerdergenoemd; voormeld; voornoemd; voorgemeld; voorgenoemd; bovengenoemd; bovenvermeld
mid => midden; middel; te midden van; medio
put => zetten; stellen; leggen; plaatsen; doen; aanspannen; brengen; steken; stoppen; aanbrengen
rustled => ritselde
splotched => splotched
warmly => heet; warm; warmpjes; hartelijk; in der minne; vriendschappelijk; vriendelijk
origins => oorsprongen
puberty => puberteit; adolescentie; rijpheid
costanza => costanza
bounced => stuiterde
donor => donor; gever; schenker; Donateur; begunstiger; donateur; steunlid; weldoener
top => bovenkant; top; topje; deksel; draaitol; tol; afknotten; bovenkleding; uitmunten; van kant maken
providing => het verstrekken van
autoimmune => auto-immuun
inhibits => remt
starts => starts
francisco => francisco
mouse => muis; computermuis; muizen; muisje; muizen vangen; rat; muizen en ratten van de Oude Wereld
founded => gesticht
explains => legt uit
molds => mallen
elisha => elisha
astonishing => verbazingwekkend; verwonderlijk; bevreemdend; wonderbaarlijk; schitterend; verrassend; verbazend
duration => duur; tijdsduur; lengte
solutions => oplossingen
cynicism => cynisme
fun => plezier; pret; vermaak; amusement; leuk; lol; plezierig; lollig; ontspanning; plezant
disorders => aandoeningen
kings => Koningen
plugs => plugs
gail => gail
pill => pil; tablet; bal; kanonskogel; kogel; pluis; plunderen; tennisbal
gravitational => gravitationeel
sometime => eens; ooit; eenmaal; wel eens; weleens; soms; voorheen; voormalig; vroeger
hotel => hotel; pension; eethuis
wealth => rijkdom; vermogen; fortuin; overvloed; weligheid; weelde; abundantie; fortuinlijkheid; geluk; levenslot
lotion => balsem; lotion; Lotion
abdomen => onderbuik; abdomen; buik; onderlijf; achterlijf; buikholte; onderlichaam; Buik
held => gehouden; hield; hielden
nurse => verpleegster; verplegen; verpleegkundige; verpleger; zogen; verzorgen; kinderjuffrouw; zoogmoeder; ziekenverpleger; zorgen voor
enthusiasm => enthousiasme; geestdrift; uitbundigheid; animo; verrukking; enthousiast; geestdriftig; begeestering; ijver; vuur
tupperware => tupperware
systems => systemen
burden => last; belasten; bezwaren; beladen; inladen; laden; lading; belasting; vracht; bewijslast
eyeballs => oogbollen
college => college; universiteit; faculteit; academie; hogeschool; college in Canada; genootschap; gevangenis
wrote => schreef; schreven
retention => retentie; memorie; behoud; bewaring; handhaving; instandhouding; geheugen; herinnering; herinneringsvermogen; retentievermogen
regrow => teruggroeien
write => schrijven; neerschrijven; uitschrijven; componeren; maken; scheppen; pennen; opschrijven; neerpennen; opslaan
highlights => Highlights
restoration => herstel; restauratie; herstelling; teruggave; hernieuwing; renovatie; reveil; vernieuwing
captured => gevangen genomen
tempting => aanlokkelijk; verleidelijk; lekker; aantrekkelijk; verlokkend
convinced => overtuigd
either => of; hetzij; ofwel; ook; beide; een van beide; allebei; evenmin
color => kleur; kleuren; verf; blozen; tint; verven; inkleuren; color; huidskleur
clarified => verduidelijkt
gersh => gersh
lord => heer; landheer; lord; meneer; heerschap; overste; meester; heerser; mijnheer; beheerser
professional => professioneel; beroeps; professional; beroeps-; deskundige; expert; deskundig; vakman; beoefenaar; ambtshalve
bruiser => krachtmens
strong => sterk; krachtig; straf; geconcentreerd; fiks; geducht; zwaar; stevig; standvastig; kras
skeptic => scepticus; sceptisch; twijfelzuchtig
prophet => profeet; ziener; voorspeller; voorzegger; waarzegger; waarzegster; profete; zieneres; helderziende
front => front; voorzijde; voorkant; façade; voorgevel; gevel; voor; voorgaan; eerste; het hoofd bieden
oil => olie; oliën; petroleum; aardolie; invetten; smeren; vet; vetlaag; ruwe olie
postmenopausal => postmenopauzaal
rivertown => rivertown
today => vandaag; heden; tegenwoordig; vandaag de dag; heden ten dage; nu; op het ogenblik; op vandaag
fell => vellen; hakken; afhakken; kappen; neervellen; omhakken; wreed; fjell; afbreken; afhouwen
sun => zon; zonneschijn; Zon; zonnebaden; zonnen; zonnig; zonneglans; koperen ploert
guy => kerel; vent; knul; snuiter; gast; gozer; persoon; sujet; gasten; jongens
designed => met voorbedachte rade; opzettelijk
dimensions => afmeting
fontan => fontana