restriction => restrictie
they => hen
cellular => cellulair
you => jou
what => wat; dat; wat!; what
regime => regime; regering
cell => cel
hope => hopen; hoop
better => beter; betere
daily => dagblad
side => zijde
evolutionary => evolutionair
redman => rode man
reduction => reductie
meal => meel; maal
zdemir => zdemir
idea => idee
during => gedurende
advertisement => advertentie
ate => at; aten
cholesterol => cholesterol
seemed => schenen
also => alsmede
show => show
your => jouw
reference => referentie; referent; referente
sleep => slapen; slaap; sluimeren; sleep
night => nacht; nachtje
research => research
libido => libido
an => aan; in
study => studeren; studie
to => tot; te
was => was
biomedical => biomedisch
louisiana => louisiana
as => als; as
around => rond
university => universiteit; universitair
even => even; effen
longer => langer
center => centrum; centreren; centraal; concentreren; center
analysing => analyseren
resting => resting
pennington => pennington
scarce => schaars; schraal; schriel
second => seconde; secondant; secunde
lot => lot; noodlot; lood
feeling => gevoelens; gevoelig; beleving
very => erg
drop => drop
samples => samples
findings => bevinding
leanne => leanne
time => tijd
small => smal
metabolism => metabolisme
cent => cent; Cent
cmet => cmet
work => werk; werken
lives => levens
interesting => interessant
janine => janine
diets => diëten
glucose => glucose
in => in
washington => washington
eating => eten
diet => dieet
seen => gezien
per => per
include => inhouden; insluiten
cold => koud
respond => responderen
can => kan
mice => muizen
key => klep
mechanism => mechanisme; mechaniek; techniek; machine
eyeem => eyeem
how => hoe; how
calories => calorie
further => verder
on => op; in; om
isn => isn
dramatic => dramatisch
save => sparen
ll => ll
or => of; or
luigi => luigi
levels => levels
j => j
stress => stress
dna => dna
now => nou
energy => energie
calorie => calorie
live => leven; levend; live
cells => cellen
he => hem; ie; het
worms => wormen
byproducts => bijproducten
if => of; If
but => buiten
it => ’t
oxidative => oxidatieve
we => we
journal => courant; journaal
for => voor
two => twee
reduced => gereduceerd; reduceren
normal => normaal; normale
temperature => temperatuur; kamertemperatuur
than => dan
are => are
studies => studie
s => s
less => Less
blood => bloed; bloeden
well => wel; opwellen
others => the others
limit => limiet
t => t
planning => planning
when => toen
doi => doi
her => haar
cutting => Cutting
colleagues => collega's
year => jaar
first => eerste; eerst
missouri => missouri
is => is
more => More
that => dat; wat
some => sommige; sommigen
significant => significant
break => breken; breuk
organisms => organismen
rest => rust; rusten; rest
spotting => spotting
square => square
bacteria => bacteriën; bacterie; bacil
mystery => mysterie
another => ander; andere
not => niet
matthew => matthew
nets => netten
ships => schepen
ocean => oceaan
alamy => alamy
japan => japan
kilometres => kilometer
down => dons; down; droppen
plymouth => plymouth
laboratory => laboratorium
underestimated => onderschat
million => miljoen; millioen
kilogram => kilogram; kilo
millions => miljoenen
including => inclusief; incluis
patch => patch
suggestion => suggestie
paulo => paulo
still => stil
into => in
oceanic => oceanisch
so => zo
computer => computer; personal computer
most => meest; hoogst; meeste; -st
label => label
part => Part
sinking => daling; kleinering
instance => instantie
one => ene
model => model; modelleren
evolving => evoluerende
accumulates => accumuleert
netherlands => Nederlands; nederland
tsunami => tsunami; tsoenami
suggests => suggereren
team => team
washed => gewassen
hawaii => hawaii; hawaï
great => groot
exist => existeren
laurent => laurent
invasive => invasief
were => ware
little => luttel
oliveira => oliveira
fishing => vissen; visvangst
reports => rapporten
detected => gedetecteerd
sea => sea
come => komen
organisation => organisatie
floor => vloer; vloeren; gehoor
greatly => groots
eaten => gegeten; opgegeten
outer => extern; buiten-; buiten; buiten‐
data => data
made => maken
marine => maritiem; marien; marinier; marine; Marien; marine-
photo => foto
latest => laatst
tohoku => tohoku
delft => delft
sixteen => zestien
find => vinden
alone => alleen; allenig
centre => centrum; centreren
basins => bekkens
least => kleinste
like => gelijkend
after => achter; achterna
earlier => eerder
conclusions => conclusies
california => californië
stock => stock; op stock
tonnes => ton
where => waartoe; warheen
land => land; landen; aanlanden
oceans => oceanen
us => us
had => gehad
based => gebaseerd
microscopic => microscopisch
ingested => ingeslikt
area => areaal
uk => uk
member => leuter
kilometre => kilometer
real => reëel; real; reële
growing => groeiend
breaking => breuk
plastic => plastic; plastisch; plastiek; van plastic
mass => massa; mis
lebreton => lebreton
floating => vlottend
simultaneously => simultaan
who => Who
conflicts => conflicten
billion => biljoen
arlington => arlington
victory => victorie
mark => mark; markeren; merken
fought => vocht
world => wereld; wereld-; werelds
troops => troepen
medical => medisch; medicinaal
global => globaal
streets => straten
chiefs => chiefs
command => commanderen; commando
urban => urbaan
ensure => assureren
chemical => chemisch; chemicalie; chemicaliën; chemische stof
stretches => strekt
end => einde; eind; end
libya => libië
china => china
resource => ressource
jungles => jungles
budget => budget; budgetteren; budgettair
bomb => bom; Bomb
field => veld
stretch => strekken
potential => potentieel; Potentiaal; Potentialis; latent
all => alle; al; alles; allen
regimes => regimes
coming => komend
expansive => expansief
population => populatie
oppose => opponeren
later => later; achter
drug => drug
africa => afrika
declared => verklaard
consolidate => consolideren
crater => krater; trechter
jets => jets
disagree => ciseleren
last => laatst; laatste; leest
present => presenteren; heden; present
cost => kosten; kost
decree => decreet; decreteren; Decreet
joseph => jozef
organizations => organisaties
bombing => bombardement; bomaanslag
nation => natie
engagement => engagement
barren => bar
russia => rusland
table => tabel; tabelleren
operating => opererend
va => va
though => toch
might => macht
enough => genoeg; genoeg!
single => single
bombings => bomaanslagen
arsenals => arsenalen
career => carrière
necessity => necessity
glorious => glorierijk; glorieus
america => amerika
corpse => corpus
fire => afvuren
officer => officier
total => totaal
historic => historisch
hills => heuvels
overhead => overhead
fury => furie; fury
pakistan => pakistan
picture => portret; figuur
i => ik; i
military => militair; militairen
names => namen
foundations => fundering
forward => voorwaarts
troop => troep; hoop
best => best; beste
mobilize => mobiliseren; mobiel maken
over => over; boven
campaign => campagne
take => pakken
tanks => tanks
planet => planeet
marching => marcheren
assembled => geassembleerd
hearts => harten
deep => diep; diepte
triumphant => triomfant; triomfantelijk
sum => som; summa
debt => debet
beneath => beneden
bullet => bullet
pause => pauzeren; pauze; pause
seven => zeven; zevental
them => hen
eastern => oosters; oosten; oosterling
theater => theater
drones => drones
establishment => etablissement; establishment
general => generaal; generiek; gemeen; General
separatists => separatisten
soldiers => soldaten
remains => resten
pentagon => pentagoon; pentagon; Pentagon
arsenal => arsenaal; wapenarsenaal
comrades => kameraden
u => u
will => wil
political => politiek
annual => annaal
indeed => inderdaad
bullets => bullets
strategy => strategie; strateeg
stood => stond; stonden
wounds => wonden
leftover => over
american => Amerikaan; Amerikaans; Amerikaanse; american; amerikaan; amerikaans
cartels => kartels
horizon => horizon; horizont
downtown => downtown
national => nationaal; national
price => prijs; prijzen
nuclear => nucleair
disease => ziekte
fighter => vechter
additional => additioneel
exploit => exploiteren; exploit
given => gegeven
confront => confronteren
continents => continenten
right => rechts; recht
chorus => Chorus
corner => corner
words => woorden
mexico => mexico; mexico-stad
wading => waden
grenade => granaat; granaatappel; grenada
humanity => humaniteit
taking => pakkend
scores => scores
fallen => gevallenen; gevallen; fallen
plains => vlaktes
percentage => procent; percentage; percent; rente
niger => niger
hand => hand; handgreep
pyongyang => pyongyang
planned => gepland
bring => brengen
weapon => wapen
heard => gehoord
venezuela => venezuela
rivals => rivalen
state => staat; situatie
financed => gefinancierd
valleys => valleien
iran => iran
arms => armen
windswept => winderig
plan => plan; plannen
order => orde; order; ordenen
preemptive => preventief
continue => continueren
offensive => offensief
every => iedere
parade => parade; paraderen; pralen
air => air
just => juist; zojuist
exploding => exploderende
ash => as; asse; ash
terror => terreur
syria => syrië
suggested => suggereerde
intended => intentioneel
joint => joint
justice => justitie
must => most; must
serious => serieus
usurping => usurping
hundreds => honderden
length => lengte; lengtemaat
philippines => filipijnen
officers => officieren
northwest => noordwest; noordwesten; noordwestelijk
beloved => geliefd; bemind
service => servies; service
antarctic => antarctisch
quarter => kwart; buurt; kwartier; kwartje; inkwartieren
weapons => wapens
epic => episch; epos; epiek
possession => possessie; possession
centers => centers
dunford => dunford
staff => staf
ravage => ravage
final => finale; finaal
fronts => fronten
under => onder; beneden; onderste; onderdoor
become => betamen
lasting => bestendig; continu; vast
do => doen; do
wouldn => wouldn
fact => feit
mo => mo
bus => bus; autobus
working => bewerking; poging; werking; bebouwing
o => o
friday => vrijdag
him => hem; hij
news => nieuws
hugh => hugo
individually => individueel
new => nieuw; opnieuw; nieuwe
wenzel => wenzel
going => gang
hard => hard; harde
whether => hetzij; weder
press => pers
drinks => drankjes
fallon => vallen op
representative => representatief
group => groep; groeperen; troep
send => zenden
ripple => rimpeling; repelen
inform => informeren
assure => assureren
knew => kenden
miss => missen; misser
job => job
email => e-mail; e-mailen; mailen; mail; email; E-mail
goodbye => houdoe
here => hier; hierheen; hierzo; heden; hiero
opportunity => opportuniteit
local => lokaal
m => m
want => wens
instagram => instagram
claimed => geclaimd
don => don; aandoen
trust => trust
tell => vertellen; tell
chris => chris
christopher => christophe
company => compagnie
journalists => journalisten
massive => massief; massaal
practices => praktijken
changed => veranderd
mean => gemeen; menen
london => londen
posts => posts
recent => recent
occasional => occasioneel
old => oud
facebook => Facebook
scope => scoop
recently => recentelijk; recent
did => deed
analytica => analytica
directly => direct
business => businessclass
vibe => vibraties
wylie => wylie
contact => contact; contacteren; contact hebben; contactpersoon; contact maken met
incident => incident; inherent
cambridge => cambridge
authorities => autoriteiten
couple => koppelen
doesn => doesn
me => me
operation => operatie
leadership => leiderschap
case => kast; casus
superior => superieur
role => rol
alarm => alarmeren; alarm; alarm slaan; alarmsignaal; alarmklok
spying => spionage
private => privé; privé-; privaat
federal => federaal
reflected => gereflecteerd; réfléchi
conversation => conversatie
jr => jr
chili => chilipeper; chili
district => district
code => code; coderen
book => boek; boeken
day => dag
clinton => clinton
john => john
autobiography => autobiografie
childhood => childhood
album => album; muziekalbum; fotoalbum
commercially => commercieel
successful => succesvol
controversial => controversieel
offer => offerte
worked => werkte
pilots => pilots
donald => donald
temple => tempel
split => splijten; splitsen; opsplitsen; spagaat; split
name => naam; noemen
lies => leugens
beef => bief
muslim => moslim
americans => amerikanen
election => Election; electie
hillary => hillary
recipe => recept; receptie
clerk => klerk
adolescence => adolescentie; adolescent
comey => coney
walker => wandelaar
presidency => presidentschap; praesidium
james => james
fbi => fbi
stone => stenen; stenigen; steentje
mirror => mirror
higher => hoger
director => directeur; director
fucking => fakking; focking; fucking
purple => purper; purperen
presidential => presidentieel
former => vroeger
loyalty => loyaliteit
dining => dining
shut => sluiten
pries => pries
pull => pull
bartenders => barmannen
sock => sok
boater => boater
up => op
prefer => prefereren; opteren
straw => stro; strohalm
neck => nek; nekken
trip => trip
thing => ding; Ding
identify => identificeren
servers => servers
solo => solo; Solo
city => city; City
tips => tips
grass => gras; grasmat; grazen
extra => extra; extraatje
re => re
yourself => uzelf
give => geven
things => ding
mustard => mosterd; mosterdplant; mustard; mostaard
believe => geloven
meeting => vergadering; ontmoeting; zitting; meeting
sprig => spruit
onion => onion
putting => zetten
id => id; Id
suit => set
plaid => plaid
roller => rol; roller
make => maken; aanmaken
gawking => gapen
never => nimmer
em => em
friends => vrienden
groups => groepen
family => familie
impression => impressie
carrington => carrington
mentally => mentaal
scene => scène; scherm
stand => staan; opstaan; stand; standplaats
event => evenement
michele => michele
discussions => discussies
complex => complex; gecompliceerd
route => route
absolute => absoluut
action => actie
felt => vilt
car => kar
martha => martha
prevalence => prevalentie; Prevalentie
reënacts => reenacts
aesthetic => esthetisch; esthetische; esthetica
belief => geloof; geloven
cinematic => cinematografisch; kinematografisch
suggest => suggereren
drinking => drinken
actor => acteur; actrice; actor
observation => observatie
grotesquely => grotesquely
then => toen
cast => casten; cast
relation => relatie
events => events
experiences => ervaringen
sex => seks; sex; sexe
series => serie; ris; Serie
archives => archief
men => mensen; mannen; man
itself => zelf; zichzelf; vanzelf
manenti => manenti
viewer => kijker
anthology => antologie; anthologie
dramatizes => dramatiseert
en => En
already => reeds; alreeds; alvast; bereids; already
sort => soort; sorteren; Sort
sophisticates => sophisticates
driven => gereden
documentary => documentaire; documentair
performance => performance
herself => zelf; vanzelf; zijzelf
framework => framework; raamwerk; vakwerk
varied => verschillend; gevarieerd; gevariëerd
racist => racist; racistisch
dismaying => dismaying
streaming => streaming
card => kaarden
feelings => gevoelens
parties => partijen
moment => moment; oogwenk; Moment
dead => dood
brings => brengt
crude => cru
adolescent => adolescent
genre => genre; genrestuk
misguided => misleid
slut => slet
situation => situatie
negotiate => negotiëren
reflect => reflecteren
importance => importantie
open => openen; open; openmaken; opendoen; opengaan
industry => industrie
layers => lagen
falsification => falsificatie
actual => actueel
prep => prep
distortion => distorsie; distortion
mores => mores
longtime => lange tijd
media => media
making => vorming; making
friend => vriend; vriendin; vriendje; vrind
light => licht; lichtend; lichten
captures => captures
perspectives => perspectieven
reconstruction => reconstructie
school => school; scholen; leerschool; schools
alike => gelijkend
course => koers; cursus; route; parcours
describes => beschrijft
society => sociëteit
input => input
feature => gelaatstrek
standard => standaard; standaardmaat
empathetic => empathisch
corrective => correctief
converges => convergeert
attack => attaque
trouble => probleem
pregnant => pregnant; pregnant zwanger
saturday => zaterdag
scenes => schermen
does => doet
living => levend; levendig; leven; living
stole => stola; stal; stalen; stool; Stola
reflection => reflectie
memory => memorie
recover => recupereren
ideas => ideeën
ordeal => godsoordeel
kiss => kussen; kus
artistic => artistiek
dramatization => dramatisering
reënactments => reenactments
participate => participeren
intimate => intiem
image => imago
negativity => negativiteit
jim => jim
apartment => appartement; appertement; kwartier
practicalities => praktische
films => films
boy => boy; huisboy
mundstuk => mundstuk
actors => acteurs
innovative => innovatief
shows => shows
anne => Anne
resistance => weerstand
sexual => seksueel; sexueel; seksuele
half => half; helft; half-
described => beschreven
coaxes => coaxes
set => stel
reality => realiteit
melodramas => melodrama
york => york
coolidge => coolidge
screen => scherm; afschermen; beschermen
agreed => goed
sardonic => sardonisch; sarcastisch
overcome => overwinnen; overtreffen
winks => winks
film => film; filmen; verfilmen
filmmaker => filmmaker; filmer
twenty => twintig
sophisticated => gesofisticeerd; sofistisch
violence => violentie
june => juni
social => sociaal
date => dadel; datum; dateren; daten
rape => Rape
wide => wijd
appropriation => Appropriation
archeology => archeologie
camera => camera; fotocamera; filmcamera; videocamera; kamer
states => staten
teen => tiener
technically => technisch
adventure => avontuur
afterward => achteraf; naderhand
clear => klaar
young => jong
moral => moreel; moraal
background => achtergrond
dormitory => dormitory; dormitorium
implications => implicaties
styles => stijlen
maturity => maturiteit
person => persoon; personage; person
bunch => bundel
responses => reacties
silent => stilzwijgend
era => era
long => lang; lange
documentarists => documentarists
place => plaats; plaatsen
hollywood => hollywood
fiction => fictie
student => student; studente; studerende
dimension => dimensie
man => man; mens
actress => actrice
musicals => musicals
plans => plannen
blocked => geblokkeerd
forced => geforceerd
deeply => diep
psychodramatic => psychodramatische
title => titel; betitelen; titelen; tituleren
falsely => valselijk; vals
entertainment => entertainment
women => vrouwen
pans => pannen
desire => begeren
subsequent => subsequent
conversations => conversaties
subject => subject
mouthed => mond
observing => observeren
innovations => innovaties
individual => individueel; individu; individuele
shamed => schamend
passive => passief; passiva
destructive => destructief; destructieve
studio => studio; Studio
frozen => bevroren; gevroren
calls => calls
force => forceren
personal => persoonlijk; personeel
version => versie; vertaling
inquiry => enquête; inquisitie
distinction => distinctie
start => starten; start
whispers => fluistert
party => partij; party
korea => korea
generation => generatie; Generatie
advisor => adviseur
good => goed; goede
leader => leider; gebieder; leidster
nukes => nukes
mess => moes; mis
cult => cultus; Cult
asia => azië
north => noorden
allies => Geallieerden
human => humaan; human
capable => capabel
soot => roet; zoet
layer => legger; legster
wave => zwaaien; wuiven
won => won
change => vervangen
permanently => permanent
geography => geografie
teens => tieners
regional => regionaal
posing => poseren
government => overheid; gouvernement
koreans => koreanen
iraq => irak
installed => geïnstalleerd
term => term; vakterm; termijn
despot => despoot
painless => pijnloos
public => publiek
architects => architecten
invasion => invasie; inval
minutes => minuten
korean => koreaans
correctly => correct
bolton => bolton
personality => persoonlijkheid; personage
unique => uniek; unicum; enige
cakewalk => cakewalk
stratosphere => stratosfeer
mobilizing => mobiliserende
pool => poel
slick => slijk
despondent => desperaat
host => hostie; host; hosten
cigarette => sigaret
garfunkel => garfunkel
charlie => charlie
friedrich => friedrich
water => water; wateren; water geven; bronwater; waterhoudend
homer => homer; homerus; omer
depardieu => depardieu
video => video
syndicated => gesyndiceerde
middle => midden; gemiddeld; middelbaar; middelmaat; midden-; middel; middelpunt
afflecks => afflecks
aughts => aughts
ten => tien; tientje; tiental
mcgowan => mcgowan
triple => triple; tripleren; drieledig
puppies => puppies
distanced => gedistantieerd
hedlund => hedlund
weinstein => weinstein
headlines => headlines
major => majoor; majeur
separated => apart
fitness => fitness; fitheid
preserver => beschermer
motivated => gemotiveerd
shooting => beschieting
tattoo => taptoe; tattoeage; tattoo; tattoëren
blue => blauw; blauwe
frontier => Frontier (lijn)
himself => zelf; vanzelf; zichzelf; hijzelf; hemzelf
stars => ster
original => origineel; originele
touch => toucheren
sympathy => sympathie; empathie
lusty => wellustig
batman => Batman; batman
heart => hart; harten
since => sinds; sindsdien
midlife => midlife
smoking => roken
paparazzi => Paparazzo; paparazzo
midsection => midsection
induces => induceert
gray => grauw; gray
cavill => cavill
reflexively => reflexively
david => david; koning david
celebrity => celebrity
youtube => youtube
spoke => sport; spraken
interview => interview; interviewen; ondervraging
mario => mario
country => country
appeared => opgedoemd
silence => stilte
gérard => gérard
roman => romeins
fair => fair
winner => winnaar; winnares; winner; overwinnaar
simpsonesque => simpsonesque
complete => compleet
vaping => vaping
anti => anti; anti-
gave => gaf; gaven
fascist => fascistisch; fascist; fasciste
referred => gerefereerd
alongside => langs
superman => superman
breakup => breuk
latin => Latijns; latijn; latijns
sat => zat
march => mars; marcheren; mark
waistband => band
overlaid => overlay
activist => activist
ve => ve
internet => internet; Internet
told => verteld
romantic => romantisch; romantiek
honolulu => honolulu
wake => wekken; ontwaken; wake; dodenwake
rose => roos; roze; rose; Rose
success => succes
virile => viriel
senator => senator
older => ouder
post => post; posten
ben => ben
phoenix => phoenix
scenario => scenario
publicly => publiek
argo => argo
popular => populair
caspar => caspar
beside => behalve; bezijden
camp => kamp; Camp; camp
bearded => baardig; bebaard; baardman
flatten => pletten; afplatten; afvlakken; platstrijken; rechten
distance => afstand; distantie; distantiëren
affleck => affleck
lopez => lopez
enormous => enorm
meme => meme; meem
caricature => karikatuur; karikaturiseren
garrett => garrett
photographed => gefotografeerd
academy => academie
outward => buitenwaarts; uitwaarts
staring => staren
faux => faux
exactly => exact
feeds => feeds
white => wit; white
am => am
surf => surfen; surf
hedging => hedging
co => co
younger => jongere; junior
red => rood; rode
simon => simon
ex => Ex; ex; ex-
depressed => depressief; depri; gedeprimeerd
magazine => magazine; magazijn
schadenfreude => schadevreugde
henry => henry; hendrik
ashes => asse
hunnam => hunnam
damon => damon
boston => boston
jennifer => jennifer
matt => mat
male => man; masculien
amusement => amusement
rounds => rondes
stands => staan; staat
prime => priem; priemgetal; prima; primair; primen; prime
children => kinderen
comment => commentaar; becommentariëren; commentariëren
existence => existentie
obscure => obscuur
father => vader; pater
panic => paniek; Paniek; panikeren
fodder => veevoeder; voeder; voer; voedsel; voederen
v => v
harvey => harvey
crisis => crisis
oscar => oscar
fake => namaken
identification => identificatie; identiteitsbewijs; Identification; determinatie; identificeren
wanderer => wandelaar; landloper
wrestled => worstelde
netflix => netflix
france => frankrijk
mask => masker; maskeren
story => historie
fall => vallen; val; afvallen
pooching => pooching
late => laat; late; laatst
dated => gedateerd
instances => instanties
question => kwestie
president => president; preses; praeses; bondspresident
led => led
drops => druppels
myself => mijzelf; mezelf; ikzelf; zelf
loosely => losjes; los
dwight => dwight
alenfall => alenfall
insert => insteken; inzetten
extraction => extractie; Extractie
academic => academisch; academicus; akademisch
specially => speciaal; specifiek
patient => patiënt; patiënte; Patiëns; patiëns; cliënt
therapeutics => therapie
apart => apart; separaat
named => genaamd
fifty => vijftig
spade => spade; spa; spitten
controlled => gecontroleerd
growth => groei
organization => organisatie; organizatie
understand => verstaan
parasite => parasiet; profiteur
holding => houding; leiding
hot => heet
histogen => histogen
rings => ringen
generate => genereren
e => e
sensations => sensaties
unrealistic => onrealistisch
robot => robot; Robot
machine => machine; naaimachine
dream => droom
effective => effectief; efficiënt
hold => houden
market => markt; marktplein; marktplaats; markt-
collective => collectief
latent => latent; slapend
slow => sloom; slome
isolate => isoleren
arteriosclerosis => arteriosclerose
medication => medicatie; medicament; medicijn
finding => vinding; bevinding
eisenhower => eisenhower
george => george
pluck => plukken; pluimen; pluk; gepluk
nineteen => negentien
frenzy => frenzy
doing => doen; handeling
character => karakter
thanks => bedankt; dank
interested => geïnteresseerd; geïnteresseerde
quincy => quincy
efficacy => efficiëntie
minimalist => minimalistisch
above => boven; hierboven; daarenboven
follicular => folliculair
outcropping => outcropping
injections => injecties
irregularly => onregelmatig
definable => definieerbaar
faire => faire
unknown => unknown
founder => vader
shepard => shepard
ashton => ashton
splits => split
balding => kalen; kalend
veteran => veteraan
adams => adams
hims => hims
famed => befaamd
pointed => puntig; bijtend; doordringend
international => internationaal; internationale; International
enzyme => enzym; enzyme
anxiety => angst; anxietas
gould => gould
record => record
minute => minuut; minuscuul; minuscule; minuutje
pcp => pcp
robert => robert
false => vals
naughton => naughton
boxy => boxy
brain => brein
transplant => transplantatie; transplanteren
chimed => chimed
published => gepubliceerd
century => centurie; centuria; century
formed => gevormd
originally => origineel
hamilton => hamilton
injectable => injecteerbare
chin => kin; Kin
rogaine => rogaine
opening => opening; begin
hair => haar; haardos
grow => groeien
tattoos => tattoos
regeneration => regeneratie
consumer => consument; afnemer
epidermis => epidermis
declaration => declaratie
suite => suite
seventy => zeventig
finasteride => Finasteride
pills => pillen
phase => fase
neonatal => neonataal
week => week; wekelijks
roses => rozen
steel => staal; stalen
historian => historicus
ager => ager
woke => wekte; wekten
remarkable => markant
scrub => schrobben; schuren
promptly => prompt
technology => technologie; techniek; technology
falling => vallen
provide => provianderen
dr => dr
claim => claimen; claim
buren => buren
inject => injecteren; injectie
partners => partners
technologies => technologieën
replicel => replicel
shirt => shirt; T-shirt
elected => select
penises => penissen
texture => textuur
favorite => favoriet; favoriete
wildly => wild
follicles => follikels
gravity => gravitatie
disorder => wanorde; disorde
cloning => klonen
quest => queeste; Queeste
unit => unit
east => oost
product => product; reactieproduct; productie; produkt; vrucht
refined => verfijnd
valley => vallei
dermatologist => dermatoloog
female => feminien
massage => massage; masseren
partnered => partnered
majority => majoriteit
bernanke => bernanke
altman => altman
implantation => implantatie; inplanting
farrellhair => farrellhair
abundance => abundantie; abondantie
tokyo => tokio
root => wroeten
works => werken; werk
form => formulier; vorm; vormen; formeren
yanking => yanking
trial => trialis
investors => investeerders
displays => displays
spare => sparen; besparen; uitsparen
papilla => papil
jutting => jutting
candidates => kandidaten
gang => gang; gaan
follicle => follikel
peak => piek
medicine => medicijn; medicament; medicijnen; medium; medicatie; medikament
administration => administratie; administratiekantoor
cancer => kanker; cancer
meltdown => meltdown
anatomist => anatoom
bit => bit
clinical => klinisch
hairs => haar
cord => koord; koorde
whisker => Whisker
follicum => follicum
secretary => secretaresse; secretaris; scriba; sekretaresse; sekretaris; secretariaat
testosterone => testosteron
procedure => procedure; procédé
pattern => patroon
penetrate => penetreren
jason => jason
usage => usance
workshop => workshop; Workshop
help => helpen; hulp; help
patients => patiënten
therapy => therapie
understood => verstond
existing => existent
psychological => psychologisch; psychisch
dysfunction => dysfunctie
dax => dax
theoretically => theoretisch
screens => screens
bomber => bommenwerper
obsessed => geobsedeerd; geobsedeerde
modified => gemodificeerde
patents => patenten
scalp => scalp; scalperen
god => god; godheid; afgod; God
attractive => attractief
artas => artas
com => com
lip => lip; Lip
dozed => dommelde
therapies => therapieën
singapore => singapore
obsession => obsessie
vancouver => vancouver
pseudonymous => pseudoniem
rich => rijk
podcast => podcast; podcastuitzending
paraffin => paraffine; parafine
hamburgers => hamburgers
commercial => commercieel; commercial
always => altoos; almaar; alsmaar
rat => rat; rot; rattus
savoir => savoir
newspaper => krantenpapier
shoot => scheut; loot
doctor => dokter; doctor; dokteren
programmed => geprogrammeerd
plasma => plasma; bloedplasma
wood => woud
generic => generiek; generiek product
bloody => bloederig; bloedig; bloedend; bebloed
traditional => traditioneel; traditionele
cure => cureren
oklahoma => oklahoma
high => high
publicity => publiciteit
stockholm => stockholm
regulating => regelend
techniques => technieken
ride => rijden; rit; berijden
function => functie; functioneren; fungeren
parker => parker
canadian => Canadees; canadees
leather => leer; leder; leren; lederen; leder-; leer-
iconically => iconisch
site => ruimte; site
adult => adult
risky => riskant
modify => modificeren
practice => praktijk
identified => geïdentificeerd
candidate => kandidaat; kandidate; kandideren
civilization => civilisatie
cup => cup
reminded => herinnerde
pop => pap; plop
tore => torus
jacket => jasje
compound => complex; compositie; compound; composiet
lead => leiden; lood; leiding
formation => formatie; vorming; rotsformatie; Formatie; Formation
cures => kuren
fingers => vingers
shampoos => shampoos
castrated => gecastreerd
embryonic => embryonaal
agency => agentschap; agentuur
pizza => pizza
manhattan => manhattan
geneticist => geneticus
chicken => hen; kuiken; hoen
propecia => propecia
gap => gaping; gat
fund => fonds
beginning => begin
nothing => nihil
skin => skin
specializing => gespecialiseerd
incision => incisie
nerve => nerf; neuron
laser => laser; laserstraal
true => trouw
minoxidil => Minoxidil
paper => papier; papieren
blitz => blitz
stabilize => stabiliseren
elliott => elliott
sandwich => sandwich
giant => gigantisch; gigant; giantisch
nonsense => nonsens
lee => lee
marriott => marriott
especially => speciaal; specifiek
sunday => zondag
reporting => melding
met => ontmoet
stuff => stof
beers => bieren
capillus => capillus
martin => martin; martinus
kutcher => kutcher
bottom => bodem; bottom
worker => werker; werkman; werkmier; werkster; bewerker
substance => substantie
casper => casper
horn => hoorn; horen; horn; hoornen
robotic => robot
strip => strook; strippen; strip; afstropen; streep
transplantation => transplantatie
space => spatie; Space
places => plaatsen
presidents => presidenten
buckler => beukelaar
primary => primair; primaire
carpet => karpet
risk => risico; riskeren
communicate => communiceren
stick => stok; stekken
duplicating => dupliceren
creation => creatie
thatchy => thatchy
community => commune; community; communiteit
laughed => lachte
problem => probleem; problematiek
shrink => slinken
hole => holte
grew => groeide
iia => iia
walked => wandelde
daniels => daniels
stimulate => stimuleren
stop => stoppen; stop
norman => normandisch
spinach => spinazie
silicon => silicium
earnestly => ernstig
hairy => behaard
richard => richard
specific => specifiek
versions => versies
microscope => microscoop
base => basis; base; baseren
imbalance => onbalans
hippopotamus => hippopotamus
rolling => rollend
article => artikel
malaysia => maleisië
mcdonald => mcdonald
option => optie; Option
christiano => christiano
advertises => adverteert
prostates => prostates
topical => topisch
orentreich => orentreich
dollars => dollars
artificial => artificieel; artistiek
michael => michaël
snake => slangen
creative => creatief; creatiev
reading => lezing
confronted => geconfronteerd
extracts => extracten
flight => vlucht; vliegen; vliegtocht; flight
alexander => alexander
process => proces; procédé; procedure
dihydrotestosterone => Dihydrotestosteron; dihydrotestosteron
ii => ii
stigma => stigma
methods => methodiek
semester => semester; trimester
began => begon
angela => Angela
parm => parm
colors => colors
erectile => erectiel
bernstein => bernstein
petri => petri
spinal => spinaal
lab => lab; labo
theory => theorie
san => san
penis => penis
serendipity => serendipiteit
stitch => stikken
sweden => zweden
portion => portie
areata => areata
race => ras; race; racen; razen
kuntzman => kuntzman
slap => klap; slaan
protein => proteïne
dermis => Dermis; dermis; lederhuid
warby => warby
hands => handen; handen-
xeljanz => xeljanz
arthritis => artritis
ancient => antiek
boom => boem; boom; kaboem
ronald => ronald
pre => pre
loop => boog
proselytizer => proselytizer
hail => hagel; hagelen
lifelong => levenslang
experimenting => experimenteren
density => densiteit
luscious => delicieus
solution => solutio; solutie
six => six
lund => lund
hairlines => haarlijnen
following => volgeling
go => go
automatically => automatisch
identity => identiteit; identiteiten; Identiek; Identiteit
rheumatoid => reumatoïde
snug => Snug; knus
german => Germaan
pressure => pressie
lightly => licht; lichtjes; luchtig
win => winnen; gewin
web => web; Web
signal => signaal; signaleren
stormy => stormachtig
mails => mailen
aesthetics => esthetica
wife => wijf
diego => diego
project => project; projecteren
stylist => stilist
cap => kap
pressing => persen
obsessives => obsessives
alopecia => alopecie; Alopecia
expression => expressie
implanted => geïmplanteerd
prepped => prepped
summer => zomer
pads => pads
conference => conferentie; congres; conference; conventie
seated => gezeten
dht => dht
notice => affiche
garfield => garfield
rocket => raket
farrell => farrell
trillion => triljoen
dropping => daling
hormonal => hormonaal
optional => optioneel
osteopontin => osteopontine
overflowing => overbodig; overtollig; overlopen
feet => voet
hanging => verhanging; hangend; hangende; verhangen; ophanging; hangen
benchmarks => benchmarks
european => europese
reported => gerapporteerd
brooklyn => brooklyn
cylinders => cilinders
grail => graal
twentieth => twintigste; twinstigste
worldwide => wereldwijd; wereldwijde; wereldlijk
jan => januari
money => money; munten
partner => partner; makker
midtown => midtown
botox => botox
tofacitinib => tofacitinib
trials => trials
factors => factoren
startup => opstarten; opstart
perfectly => perfect
mechanical => mechanisch; mechanische; machinaal
robs => robs
prominently => prominent
emotional => emotioneel; emontioneel; geëmotioneerd
migrate => migreren
initiate => ingewijde; initiëren
slice => snijden
arm => arm
placards => plakkaten
regular => regelmatig; regelmatige
offering => offer; offerande; offergave; opoffering
quality => kwaliteit
informed => onderlegd
seventeen => zeventien
injected => geïnjecteerd
columbia => columbia
surprise => surprise
aforementioned => voorgenoemd
mid => midden; middel
splotched => splotched
warmly => warm; warmpjes
puberty => puberteit
costanza => costanza
donor => donor; donateur; weldoener
top => top; topje; tol
autoimmune => auto-immuun
starts => starts
francisco => francisco
mouse => muisje
elisha => elisha
cynicism => cynisme
plugs => plugs
gail => gail
pill => pil
gravitational => gravitationeel
hotel => hotel
wealth => weelde
lotion => lotion; Lotion
abdomen => abdomen
held => hield; hielden
enthusiasm => enthousiasme; enthousiast
tupperware => tupperware
systems => systemen
burden => beladen; inladen; laden
college => college; college in Canada
retention => retentie; retentievermogen
highlights => Highlights
restoration => restauratie; renovatie
color => color
gersh => gersh
lord => lord
professional => professioneel; professional
strong => straf; stevig
skeptic => scepticus; sceptisch
prophet => profeet; profete
front => front
oil => olie
postmenopausal => postmenopauzaal
rivertown => rivertown
fell => vellen; fjell
fontan => fontana