restriction => restrictie
cellular => cellulair
you => jou
what => wat; dat; wat!; what
regime => regime
cell => cel
hope => hopen; hoop; Hoop
better => beter; betere
side => zijde
evolutionary => evolutionair
redman => rode man
reduction => reductie
meal => meel; maal; griesmeel
a => aan
zdemir => zdemir
idea => idee
during => gedurende
advertisement => advertentie
ate => at; aten
cholesterol => cholesterol
show => show
your => jouw
reference => referentie; referent; referente
sleep => sleep
night => nacht; nachtje
research => research
this => dit; die
libido => libido
an => aan
study => studeren; studie
eat => eten; opeten
to => tot; te
was => was
biomedical => biomedisch
louisiana => louisiana
at => te; aan
food => voedsel; voeder
as => als; as
around => rond
the => de
university => universiteit; universitair
even => even
longer => langer
center => centreren; centraal; center
analysing => analyseren
resting => resting
pennington => pennington
scarce => schaars; schriel
second => seconde; secondant; secunde
lot => lot; lood
feeling => gevoelens; gevoelig; gevoelen; beleving
drop => drop
samples => samples
findings => bevinding
leanne => leanne
small => smal
metabolism => metabolisme
cent => cent; Cent
cmet => cmet
work => werk; werken; werkstuk
by => bij
lives => levens
interesting => interessant
janine => janine
diets => diëten
glucose => glucose
in => in
washington => washington
these => deze
eating => eten
diet => dieet
per => per
include => inhouden
rate => graad
cold => koud; koude; koel
respond => responderen
can => kan
mice => muizen
mechanism => mechanisme; mechaniek
eyeem => eyeem
how => hoe; how
calories => calorie
further => verder
many => menig
isn => isn
thousand => duizend
dramatic => dramatisch
life => leven; levend
save => sparen
ll => ll
or => or
luigi => luigi
levels => levels
j => j
stress => stress
dna => dna
now => nou
energy => energie
calorie => calorie
live => leven; levend; live
cells => cellen
he => hij; hem; ie; ’ie; het
worms => wormen
byproducts => bijproducten
years => jaar
but => buiten
it => het
oxidative => oxidatieve
we => wij; we
journal => journaal
for => voor
two => twee
reduced => gebradeerd; gereduceerd; reduceren
normal => normaal; normale
temperature => temperatuur; kamertemperatuur
than => dan; dat
are => are
there => er; d’r; hier
studies => studie
s => s
less => Less
blood => bloed; bloeden
well => wel; opwellen
limit => limiet
t => t
planning => planning
doi => doi
her => haar
cutting => Cutting
colleagues => collega's
year => jaar
first => eerste
missouri => missouri
is => is
more => meer; More
that => dat; wat; datgene
some => sommige; sommigen
significant => significant
break => breken; breuk
organisms => organismen
rest => rust; rusten; rest
spotting => spotting
square => square
bacteria => bacteriën; bacterie
mystery => mysterie
another => ander; andere
not => niet
matthew => matthew
nets => netten
ships => schepen
cole => kool
ocean => oceaan
alamy => alamy
japan => japan
kilometres => kilometer
down => down
plymouth => plymouth
laboratory => laboratorium
million => miljoen; één miljoen; millioen; een miljoen
kilogram => kilogram
millions => miljoenen
including => inclusief; incluis
patch => patch
suggestion => suggestie
paulo => paulo
still => stil
oceanic => oceanisch
computer => computer
most => meest; meeste
label => label
part => Part
instance => instantie
one => ene
model => model
evolving => evoluerende
accumulates => accumuleert
third => derde; terts
netherlands => Nederlands; nederland
tsunami => tsunami; tsoenami
suggests => suggereren
team => team
washed => gewassen
hawaii => hawaii; hawaï
great => groot; grote
exist => existeren
laurent => laurent
invasive => invasief
were => ware
little => luttel
oliveira => oliveira
fishing => vissen; visserij
reports => rapporten
detected => gedetecteerd
sea => zee; oceaan; sea
come => komen
organisation => organisatie
floor => vloer; vloeren; gehoor
greatly => groots
outer => buiten-; buitenste; buiten; buitenaf; buiten‐
data => data
made => gemaakt
marine => maritiem; marien; marinier; marine; Marien; marine-
photo => foto
latest => laatst
tohoku => tohoku
delft => delft
sixteen => zestien
find => vinden; bevinden
centre => centrum; centreren
fed => gevoed; voedde
least => kleinste
near => dierbaar
like => gelijk; gelijkend
after => achter; achterna
earlier => voorheen
conclusions => conclusies
california => californië
stock => stock; op stock
out => buiten; uit
land => land; landen; aarde
oceans => oceanen
us => ons; us
boats => boten
based => gebaseerd
microscopic => microscopisch
area => areaal
uk => uk
kilometre => kilometer
real => reëel; real; reële
growing => groeiend
plastic => plastic; plastisch; plastiek; van plastic
came => kwam
mass => massa
lebreton => lebreton
floating => vlottend
who => Who
conflicts => conflicten
billion => biljoen
arlington => arlington
victory => victorie
mark => mark; markeren; merken
fought => gevochten; vocht; vochten
world => wereld; wereld-; werelds
troops => troepen
medical => medisch; medicinaal
global => globaal
streets => straten
chiefs => chiefs
command => commanderen; commando
urban => urbaan
chemical => chemisch; chemicalie; chemicaliën
end => einde; eind; end
libya => libië
china => china
resource => ressource
jungles => jungles
budget => budget; budgetteren; budgettair
bomb => bom; Bomb
field => veld
stretch => strekken
potential => potentieel; Potentiaal; Potentialis
all => alle; al; alles; allen
regimes => regimes
coming => komend; aankomend
expansive => expansief
population => populatie
skulls => schedels
later => later
drug => drug
days => dagen
africa => afrika
declared => verklaard
consolidate => consolideren
crater => krater
jets => jets
worth => duurte
last => laatst; laatste
present => presenteren; present
cost => kosten; kost; onkosten
decree => decreet; Decreet
joseph => jozef
organizations => organisaties
nation => natie
engagement => engagement
table => tafel; tabel
fight => vechten; gevecht; bevechten; uitvechten
operating => opererend
va => va
though => toch
might => macht; kracht
upon => op
single => enkel; single
back => dekken
let => laten; toelaten
arsenals => arsenalen
career => carrière
necessity => necessity
glorious => glorieus
america => amerika
corpse => corpus
fire => vuur
officer => officier
total => totaal
historic => historisch
hills => heuvels
overhead => overhead
fury => furie; fury
pakistan => pakistan
picture => figuur
i => i
ready => gereed; bereid
military => militair; militairen
names => namen
foundations => fundering
forward => voorwaarts
troop => troep
best => best; beste
mobilize => mobiliseren
over => over
campaign => campagne
take => pakken
tanks => tanks
planet => planeet
marching => marcheren
assembled => geassembleerd
hearts => harten
deep => diep; diepte
triumphant => triomfant; triomfantelijk
sum => som
debt => debet
beneath => beneden
bullet => bullet
pause => pauzeren; pauze; pause
seven => zeven; zevental
eastern => oosters; oosten; oosterling
theater => theater
drones => drones
establishment => etablissement; establishment
general => generaal; generiek; General
separatists => separatisten
soldiers => soldaten
pentagon => pentagoon; pentagon; Pentagon
arsenal => arsenaal; wapenarsenaal
comrades => kameraden
u => u
will => wil
political => politiek
annual => annaal
bullets => bullets
strategy => strategie; strateeg
stood => stond; stonden
wounds => wonden
american => Amerikaan; Amerikaans; Amerikaanse; american; amerikaan; amerikaans
cartels => kartels
horizon => horizon; horizont
downtown => downtown
national => nationaal; national
price => prijs; prijzen
nuclear => nucleair
fighter => vechter; kampvechter
cities => steden
additional => additioneel
exploit => exploiteren; exploit
given => gegeven
confront => confronteren
continents => continenten
right => rechts; recht; rechterkant; rechter-
chorus => Chorus
corner => corner
words => woorden
mexico => mexico
wading => waden
grenade => granaat; grenada
fighting => vechten; vecht
humanity => humaniteit
taking => pakkend
scores => scores
flesh => vlees
fallen => gevallen; fallen
percentage => procent; percentage; percent
niger => niger
hand => hand
pyongyang => pyongyang
full => vol
firefights => vuurgevechten
weapon => wapen
venezuela => venezuela
rivals => rivalen
state => staat; situatie
financed => gefinancierd
valleys => valleien
iran => iran
arms => armen
plan => plan; plannen
order => orde; order; ordenen
continue => continueren
offensive => offensief
parade => parade; paraderen
air => air
just => juist; zojuist
exploding => exploderende
ash => as; asse; ash
terror => terreur
syria => syrië
suggested => suggereerde
earth => aarde; aarden
joint => joint
justice => justitie
must => moeten; most; must
serious => serieus
usurping => usurping
hundreds => honderden
length => lengte
philippines => filipijnen
officers => officieren
northwest => noordwest; noordwesten; noordwestelijk
weeks => weken
beloved => geliefd; geliefde
service => servies; service
antarctic => antarctisch
quarter => kwart; kwartaal; kwartier; kwartje; inkwartieren
unlike => ongelijk
weapons => wapens
epic => episch; epiek
possession => possessie; possession
centers => centers
dunford => dunford
staff => staf
ravage => ravage
final => finale; finaal
fronts => fronten
under => onder; onderste
cry => schreien
do => doen; gedoe; do
wouldn => wouldn
mo => mo
bus => bus
working => bewerking; werking
o => o
friday => vrijdag
him => hem; hij; het
news => nieuws; nieuwtje
hugh => hugo
individually => individueel
think => denken; nadenken; vinden; bedenken
new => nieuw; opnieuw; nieuwe
wenzel => wenzel
hard => hard; harde
whether => weder
way => weg
drinks => drankjes
representative => representatief
group => groep; troep
send => zenden; opzenden; afzenden
ripple => repelen
decision => beslissing
inform => informeren
assure => assureren
knew => kenden
miss => missen; misser
job => job
email => e-mail; e-mailen; mailen; mail; email; E-mail
here => hier; hierheen; alhier; hierzo; hiero
opportunity => opportuniteit
his => hun
local => lokaal; lokaaltrein
m => m
want => wensen
instagram => instagram
claimed => geclaimd
don => don
trust => trust
tell => tell
chris => chris
christopher => christophe
company => compagnie
journalists => journalisten
massive => massief
practices => praktijken
mean => gemeen
london => londen
posts => posts
recent => recent
occasional => occasioneel
old => oud
facebook => Facebook
scope => scoop
recently => recentelijk; recent
did => deed
analytica => analytica
directly => direct
business => businessclass
wylie => wylie
contact => contact; contacteren; contact hebben; contactpersoon
incident => incident; inherent
cambridge => cambridge
authorities => autoriteiten
couple => koppel; koppelen
doesn => doesn
me => me
operation => operatie
leadership => leiderschap
case => kast
superior => superieur
role => rol
points => punten
look => lijken
alarm => alarmeren; alarm
private => privé; privé-; privaat
federal => federaal
reflected => gereflecteerd
conversation => conversatie
jr => jr
chili => chili
district => district
code => code; coderen
book => boek; boeken; beboeten
day => dag
clinton => clinton
john => john
autobiography => autobiografie
childhood => childhood
album => album
commercially => commercieel
successful => succesvol
controversial => controversieel
offer => offerte
worked => werkte
pilots => pilots
donald => donald
temple => tempel
split => splijten; splitsen; opsplitsen; split
name => naam; noemen
beef => bief
muslim => moslim
americans => amerikanen
election => Election; electie
hillary => hillary
recipe => recept; receptie
clerk => klerk
adolescence => adolescentie; adolescent
comey => coney
presidency => presidentschap
james => james
fbi => fbi
stone => steen; stenen; stenigen; steentje
mirror => mirror
higher => hoger
director => directeur; director
fucking => fakking; focking; fucking
purple => purper; purperen
presidential => presidentieel
former => vroeger
loyalty => loyaliteit
dining => dining
shut => sluiten
pries => pries
pull => pull
three => drie
sock => sok
copy => kopie; kopij
boater => boater
up => op
prefer => prefereren
straw => stro; strohalm
neck => nek; nekken
trip => trip
thing => ding; Ding
identify => identificeren
servers => servers
solo => solo; Solo
crane => kraan; hefkraan
city => city; City
tips => tips
grass => gras; grazen
extra => extra; extraatje
feel => voelen; gevoelen; bevoelen
re => re
yourself => jijzelf; uzelf; jezelf
give => geven
things => dingen; ding
mustard => mosterd; mustard; mostaard
believe => geloven
meeting => zitting; meeting
sprig => spruit
onion => onion
id => id
suit => schikken
plaid => plaid
roller => roller
make => maken; aanmaken
never => nimmer
em => em
friends => vrienden
groups => groepen
family => familie
impression => impressie
carrington => carrington
mentally => mentaal
scene => scène; scherm
stand => staan; uitstaan; stand
event => evenement
michele => michele
discussions => discussies
complex => complex; gecompliceerd
route => route
absolute => absoluut
action => actie
felt => vilt; vilten
car => kar
martha => martha
prevalence => prevalentie; Prevalentie
reënacts => reenacts
aesthetic => esthetisch; esthetische; esthetica
belief => geloof
cinematic => cinematografisch
suggest => suggereren
drinking => drinken
actor => acteur; actor
observation => observatie
grotesquely => grotesquely
then => dan; toen
cast => casten; cast
relation => relatie
events => events
sex => seks; sekse; sex; sexe
series => serie; Serie
archives => archief
men => mensen; man
itself => zelf; zichzelf; vanzelf
manenti => manenti
anthology => antologie; anthologie
dramatizes => dramatiseert
already => alreeds; bereids; already
sort => soort; sorteren; schiften; Sort
sophisticates => sophisticates
driven => gereden
documentary => documentaire; documentair
performance => performance
herself => zijzelf; zichzelf
framework => framework; raamwerk; vakwerk
varied => gevarieerd; gevariëerd
racist => racist; racistisch
dismaying => dismaying
streaming => streaming
card => kaart; kaarden; kaardrol
feelings => gevoelens
parties => partijen
moment => moment; Moment
eight => acht
brings => brengt
crude => cru
adolescent => adolescent
genre => genre; genrestuk
slut => slet
situation => situatie
negotiate => negotiëren
reflect => reflecteren
importance => importantie
open => openen; open
industry => industrie
layers => lagen
merit => verdienen
falsification => falsificatie
actual => actueel
prep => prep
distortion => distorsie; distortion
mores => mores
media => media
making => making
friend => vriend; vriendin; vriendje; vrind
light => licht; lichtend; verlichten; bijlichten; lichten
captures => captures
perspectives => perspectieven
reconstruction => reconstructie
school => school; scholen; schools
alike => gelijk; gelijkend
course => koers; parcours
describes => beschrijft
society => sociëteit
input => input
feature => gelaatstrek
standard => standaard; standaardmaat
empathetic => empathisch
corrective => correctief
converges => convergeert
attack => attaque; aantasten
trouble => probleem
pregnant => pregnant
saturday => zaterdag
scenes => schermen
does => doet
living => levend; levendig; leven; living
stole => stola; stal; stalen; stool
reflection => reflectie
memory => memorie
ideas => ideeën
kiss => kussen
nicknamed => bijgenaamd
artistic => artistiek
dramatization => dramatisering
reënactments => reenactments
participate => participeren
intimate => intiem
image => imago
negativity => negativiteit
jim => jim
apartment => appartement; appertement
practicalities => praktische
films => films
boy => boy
mundstuk => mundstuk
actors => acteurs
innovative => innovatief
shows => shows
anne => Anne
sexual => seksueel; sexueel; seksuele
half => half; half-
described => beschreven
coaxes => coaxes
unfold => ontvouwen
reality => realiteit; actualiteit
melodramas => melodrama
york => york
coolidge => coolidge
screen => scherm
sardonic => sardonisch
winks => winks
film => film; filmen; verfilmen
filmmaker => filmmaker; filmer
twenty => twintig; twintigtal
sophisticated => gesofisticeerd; sofistisch
violence => violentie
june => juni
social => sociaal
date => dateren; daten
rape => Rape
wide => wijd
appropriation => Appropriation
archeology => archeologie
camera => camera; videocamera; kamer
states => staten
teen => tiener
makes => maakt
technically => technisch
adventure => avontuur
afterward => achteraf
clear => klaar; helemaal
young => jong; jongen
moral => moreel; moraal
background => achtergrond
dormitory => dormitory; dormitorium
implications => implicaties
styles => stijlen
maturity => maturiteit
person => persoon; personage; person
era => era
long => lang; lange
documentarists => documentarists
place => plaats; plaatsen; plek
hollywood => hollywood
fiction => fictie
student => student; studente; studerende
dimension => dimensie
man => man; bemannen
musicals => musicals
plans => plannen
blocked => geblokkeerd
forced => geforceerd
deeply => diep
psychodramatic => psychodramatische
title => titel; betitelen; titelen; Titel
falsely => valselijk
entertainment => entertainment
pans => pannen
subsequent => subsequent
conversations => conversaties
subject => subject
observing => observeren
innovations => innovaties
individual => individueel; individu; individuele
shamed => schamend
passive => passief; passiva
destructive => destructief; destructieve
studio => studio; Studio
too => te
frozen => bevroren; gevroren
calls => calls
force => forceren
personal => persoonlijk; personeel
version => versie
seat => zetel
inquiry => inquisitie
distinction => distinctie
start => starten; start
party => partij; party
korea => korea
generation => generatie; Generatie
advisor => adviseur
good => goed; goede
leader => leider; gebieder; leidster; leidsman
dried => gedroogd
nukes => nukes
thin => dun; fijn
cult => cultus; Cult
asia => azië
north => noorden; noord
human => humaan; human
capable => capabel
soot => roet; zoet
layer => legger
wave => zwaaien; wuiven
won => won
permanently => permanent
upcoming => komend
geography => geografie
teens => tieners
regional => regionaal
government => gouvernement
koreans => koreanen
thousands => duizenden
iraq => irak
installed => geïnstalleerd
term => term; termijn
despot => despoot
painless => pijnloos
public => publiek
architects => architecten
invasion => invasie
minutes => minuten
korean => koreaans
correctly => correct
bolton => bolton
personality => persoonlijkheid; personage
unique => uniek; unicum
cakewalk => cakewalk
stratosphere => stratosfeer
mobilizing => mobiliserende
newly => nieuw
ruled => regeerde
pool => poel
slick => slijk
host => hostie; host; hosten
cigarette => sigaret
garfunkel => garfunkel
charlie => charlie
friedrich => friedrich
water => water; wateren; bronwater
homer => homer; homerus; omer
depardieu => depardieu
video => video
syndicated => gesyndiceerde
middle => midden; gemiddeld; midden-; middel
afflecks => afflecks
aughts => aughts
ten => tien
mcgowan => mcgowan
triple => triple; tripleren
puppies => puppies
distanced => gedistantieerd
hedlund => hedlund
weinstein => weinstein
headlines => headlines
major => majoor; majeur
fitness => fitness
motivated => gemotiveerd
shooting => schieten; beschieting
tattoo => taptoe; tatoeage; tattoeage; tattoo; tattoëren
blue => blauwe
himself => zichzelf; hijzelf; hemzelf
stars => ster
original => origineel; originele
sympathy => sympathie; empathie
lusty => wellustig
batman => Batman; batman
heart => hart; harten
midlife => midlife
paparazzi => Paparazzo; paparazzo
midsection => midsection
induces => induceert
gray => gray
cavill => cavill
reflexively => reflexively
david => david
celebrity => celebrity
youtube => youtube
spoke => spraken
interview => interview; interviewen
mario => mario
country => country
silence => stilte
gérard => gérard
roman => romeins
fair => fair
winner => winnaar; winnares; winner
simpsonesque => simpsonesque
complete => compleet
vaping => vaping
anti => anti; anti-
gave => gaf; gaven
fascist => fascistisch; fascist; fasciste
referred => gerefereerd
alongside => langs
superman => superman
latin => Latijns; latijn; latijns
sat => zat; zaten
march => mars
overlaid => overlay
activist => activist
ve => ve
internet => internet; Internet
told => vertelde
romantic => romantisch; romantiek
honolulu => honolulu
wake => wekken; ontwaken; wake
rose => roos; roze; rose; Rose
success => succes
virile => viriel
senator => senator
older => ouder
post => post; posten
ben => ben
phoenix => feniks; phoenix
scenario => scenario
publicly => publiek
argo => argo
popular => populair
caspar => caspar
beside => bezijden
camp => kamp; Camp; camp
bearded => baardig; bebaard; baardman
flatten => pletten; afplatten; verlagen
distance => distantie; distantiëren
affleck => affleck
lopez => lopez
enormous => enorm
meme => meme; meem
caricature => karikatuur; karikaturiseren
garrett => garrett
photographed => gefotografeerd
academy => academie
kids => kinderen
outward => buitenwaarts; uitwaarts
staring => staren
faux => faux
exactly => exact
feeds => feeds
white => wit; white
am => am
surf => surfen; surf
hedging => hedging
co => co
younger => jongere; junior
red => rode
simon => simon
ex => ex; ex-
depressed => depressief; gedeprimeerd
magazine => magazine; magazijn
schadenfreude => schadevreugde
quick => kwiek
henry => henry; hendrik
ashes => asse
hunnam => hunnam
damon => damon
boston => boston
jennifer => jennifer
forty => veertig
matt => mat
male => man
amusement => amusement
rounds => rondes
stands => staan
prime => priem; prima; primen; prime
children => kinderen
comment => commentaar; becommentariëren; commentariëren
existence => existentie
obscure => obscuur
father => vader; pater
panic => paniek; Paniek
fodder => veevoeder; voeder; voer; voedsel; voederen
v => v
harvey => harvey
crisis => crisis
oscar => oscar
fake => namaken
identification => identificatie; Identification; determinatie; identificeren
wanderer => wandelaar
wrestled => worstelde
netflix => netflix
mask => masker; maskeren
story => historie
fall => vallen; val; afvallen
pooching => pooching
late => laat; late; te laat; laatst
dated => gedateerd
instances => instanties
question => kwestie
president => president; bondspresident
led => led
myself => mijzelf; mezelf; ikzelf; zelf
dwight => dwight
alenfall => alenfall
insert => insteken; inleggen; inzetten
extraction => extractie; Extractie
academic => academisch; academicus; akademisch
specially => speciaal
patient => patiënt; patiënte; Patiëns; patiëns
therapeutics => therapie
apart => apart
fifty => vijftig
spade => spade; spa
controlled => gecontroleerd
organization => organisatie; organizatie
understand => verstaan
parasite => parasiet
holding => houding; leiding
histogen => histogen
rings => ringen
generate => genereren
e => e
sensations => sensaties
unrealistic => onrealistisch
robot => robot; Robot
machine => machine; naaimachine
dream => dromen; droom; dagdroom; wensdroom
effective => effectief
hold => houden
market => markt; marktplein; markt-
collective => collectief
latent => latent
slow => sloom
isolate => isoleren
arteriosclerosis => arteriosclerose
medication => medicatie; medicament; medicijn
finding => vinding; bevinding
eisenhower => eisenhower
george => george
pluck => plukken; pluimen; afrukken; pluk; gepluk
nineteen => negentien
frenzy => frenzy
doing => doen
character => karakter
thanks => dank u; dank; dankuwel
interested => geïnteresseerd; geïnteresseerde
quincy => quincy
efficacy => efficiëntie
minimalist => minimalistisch
above => boven; daarenboven
follicular => folliculair
outcropping => outcropping
injections => injecties
irregularly => onregelmatig
faire => faire
unknown => unknown
founder => vader
shepard => shepard
ashton => ashton
splits => split
balding => kalend
veteran => veteraan
adams => adams
hims => hims
international => internationaal; internationale; International
enzyme => enzym; enzyme
anxiety => anxietas
gould => gould
record => record
minute => minuut; minuscule; minuutje
pcp => pcp
robert => robert
false => vals
naughton => naughton
boxy => boxy
brain => brein
transplant => omplanten; verplanten; overplanten; transplantatie; transplanteren
chimed => chimed
published => gepubliceerd
century => centurie; centuria; century
originally => origineel
hamilton => hamilton
injectable => injecteerbare
chin => kin; Kin
rogaine => rogaine
opening => opening
hair => haar
tattoos => tattoos
regeneration => regeneratie
consumer => consument
epidermis => epidermis
declaration => declaratie
suite => suite
seventy => zeventig
finasteride => Finasteride
pills => pillen
phase => fase
neonatal => neonataal
week => week
roses => rozen
forties => veertig
historian => historicus
ager => ager
woke => wekte; wekten
remarkable => markant
promptly => prompt
cream => room; crème; afromen; romen
technology => technologie; technology
falling => vallen
provide => provianderen
dr => dr
claim => claimen; claim
buren => buren
inject => injecteren; injectie
partners => partners
technologies => technologieën
replicel => replicel
shirt => shirt; T-shirt
elected => select
penises => penissen
texture => textuur
favorite => favoriet; favoriete
wildly => wild
follicles => follikels
gravity => gravitatie
disorder => disorde
cloning => klonen; kloneren
quest => queeste; Queeste
unit => unit
east => oosten; oost; oosters
product => product; productie; produkt
refined => verfijnd
valley => vallei
dermatologist => dermatoloog
massage => massage; masseren
partnered => partnered
majority => majoriteit
bernanke => bernanke
eighty => tachtig; tachtigst
altman => altman
implantation => implantatie; inplanting
farrellhair => farrellhair
abundance => abundantie; abondantie
tokyo => tokio
root => wroeten
works => werken; werk
form => vorm; vormen; formeren; vormgeven
yanking => yanking
trial => trialis
investors => investeerders
displays => displays
spare => sparen; besparen
papilla => papil
jutting => jutting
candidates => kandidaten
gang => gang; gaan
follicle => follikel
peak => piek
medicine => medicijn; medicijnen; medicatie
administration => administratie; administratiekantoor
cancer => kanker; cancer
meltdown => meltdown
bit => bit
clinical => klinisch
hairs => haar
cord => koord; koorde
whisker => Whisker
follicum => follicum
secretary => secretaresse; secretaris; sekretaresse; sekretaris; secretariaat
testosterone => testosteron
procedure => procedure; procédé
house => huis
penetrate => penetreren
jason => jason
usage => usance
sheath => schede
workshop => workshop; Workshop
help => helpen; hulp; help
patients => patiënten
therapy => therapie
understood => verstond; verstonden
existing => existent
psychological => psychologisch; psychisch
dysfunction => dysfunctie
dax => dax
theoretically => theoretisch
screens => screens
obsessed => geobsedeerd
fat => vet
thick => dik; dikke; dichte
modified => gemodificeerde
patents => patenten
scalp => scalp
caution => garantie
god => god; God
attractive => attractief
artas => artas
com => com
lip => lip; Lip
done => gedaan
dozed => dommelde
therapies => therapieën
singapore => singapore
obsession => obsessie
vancouver => vancouver
pseudonymous => pseudoniem
podcast => podcast
paraffin => paraffine; parafine
hamburgers => hamburgers
commercial => commercieel; commercial
rat => rat; rot
savoir => savoir
shoot => schieten; scheut
doctor => dokter; doctor; dokteren
programmed => geprogrammeerd
plasma => plasma
wood => woud
generic => generiek
bloody => bloederig; bloederige; bloedig; bloedend; bebloed
traditional => traditioneel; traditionele
cure => kuur
oklahoma => oklahoma
high => high
publicity => publiciteit
stockholm => stockholm
regulating => regelend
techniques => technieken
ride => rijden; rit; berijden
function => functie; functioneren
parker => parker
canadian => Canadees; canadees
leather => leer; leder; lederen; leder-
iconically => iconisch
site => site
adult => adult
risky => riskant
thirty => dertig
practice => praktijk
identified => geïdentificeerd
candidate => kandidaat; kandidate; gegadigde; kandideren
civilization => civilisatie
cup => cup
pop => pap; plop
compound => compound; composiet
lead => leiden; geleiden
formation => formatie; vorming; rotsformatie; Formatie; Formation
cures => kuren
cloned => gekloond
fingers => vingers
shampoos => shampoos
castrated => gecastreerd
embryonic => embryonaal
agency => agentuur
pizza => pizza
manhattan => manhattan
geneticist => geneticus
chicken => kuiken
propecia => propecia
gap => gaping; gat
fund => fonds
skin => skin
specializing => gespecialiseerd
incision => incisie
nerve => nerf
laser => laser
true => trouw
minoxidil => Minoxidil
paper => papier; papieren
blitz => blitz
stabilize => stabiliseren
elliott => elliott
sandwich => sandwich
giant => gigant
nonsense => nonsens
lee => lee
marriott => marriott
especially => speciaal
sunday => zondag
beers => bieren
capillus => capillus
martin => martin; martinus
kutcher => kutcher
bottom => bottom
worker => werker; werkman; werkmier; werkster; bewerker
substance => substantie
casper => casper
horn => hoorn; horen; horn; hoornen
robotic => robot
strip => strook; strippen; strip; streep
transplantation => transplantatie
space => spatie; Space
places => plaatsen
presidents => presidenten
buckler => beukelaar
primary => primair; primaire
carpet => karpet; tapijten
risk => riskeren
communicate => communiceren
stick => stok; stekken
duplicating => dupliceren
creation => creatie; formatie
thatchy => thatchy
community => commune; community; communiteit
laughed => lachte
problem => probleem; problematiek
shrink => slinken
hole => holte
iia => iia
walked => wandelde
daniels => daniels
stimulate => stimuleren
stop => stop
spinach => spinazie
silicon => silicium
hairy => harig
richard => richard
specific => specifiek
versions => versies
microscope => microscoop
base => base
imbalance => onbalans
hippopotamus => hippopotamus
rolling => rollend
article => artikel
malaysia => maleisië
mcdonald => mcdonald
option => optie; Option
christiano => christiano
advertises => adverteert
prostates => prostates
topical => topisch
recruiting => rekruteren
orentreich => orentreich
dollars => dollars
artificial => artificieel; artistiek
michael => michaël
creative => creatief; creatiev
confronted => geconfronteerd
extracts => extracten
flight => vlucht; vliegen; flight
alexander => alexander
process => proces
stumbled => struikelde
dihydrotestosterone => Dihydrotestosteron; dihydrotestosteron
ii => ii
worst => ergst
stigma => stigma
methods => methodiek
semester => semester; trimester
began => begon
angela => Angela
non => niet
far => ver
parm => parm
colors => kleuren; colors
erectile => erectiel
fully => volledig; voluit
bernstein => bernstein
petri => petri
spinal => spinaal
lab => lab; labo
theory => theorie
san => san
penis => penis
serendipity => serendipiteit
sweden => zweden
portion => portie
areata => areata
race => ras; race; racen; razen
kuntzman => kuntzman
slap => klap; slaan
protein => proteïne
dermis => Dermis; dermis
warby => warby
hands => handen; handen-
xeljanz => xeljanz
arthritis => artritis
ancient => antiek
boom => boem; bloeien; boom; kaboem
ronald => ronald
pre => pre
proselytizer => proselytizer
hail => hagel
lifelong => levenslang
experimenting => experimenteren
density => densiteit
luscious => delicieus
solution => solutio; solutie
six => six
lund => lund
hairlines => haarlijnen
following => volgend; volgeling
go => go
automatically => automatisch
identity => identiteit; identiteiten; Identiek; Identiteit
rheumatoid => reumatoïde
snug => Snug
german => Germaan
pressure => pressie
lightly => licht; lichtjes; luchtig
win => winnen
web => web; Web
signal => signaal; seinen; signaleren
mails => mailen
aesthetics => esthetica
wife => wijf
diego => diego
clients => klanten
project => project; projecteren
stylist => stilist
cap => kap
pressing => persen; dreigend
obsessives => obsessives
alopecia => alopecie; Alopecia
expression => expressie
implanted => geïmplanteerd
prepped => prepped
summer => zomer
pads => pads
conference => conferentie; congres; conference; conventie
dht => dht
garfield => garfield
rocket => raket
farrell => farrell
trillion => biljoen; triljoen
hormonal => hormonaal
optional => optioneel
osteopontin => osteopontine
overflowing => overbodig; overlopen
feet => voeten; voet
hanging => verhanging; hangend; hangende; ophanging; hangen
able => capabel
benchmarks => benchmarks
european => europese
reported => gerapporteerd
moved => geroerd
brooklyn => brooklyn
cylinders => cilinders
grail => graal
twentieth => twintigste; twinstigste
worldwide => wereldwijd; wereldwijde; wereld-; wereldlijk
money => money
partner => partner
midtown => midtown
botox => botox
tofacitinib => tofacitinib
trials => trials
houses => huizen
factors => factoren
startup => opstarten
perfectly => perfect
mechanical => mechanisch; mechanische; machinaal
robs => robs
prominently => prominent
emotional => emotioneel; emontioneel; geëmotioneerd
migrate => migreren
initiate => initiëren
arm => arm
placards => plakkaten
regular => regelmatig; regelmatige; geregeld
offering => offer; offerande; opoffering
quality => kwaliteit; kaliber
seventeen => zeventien
injected => geïnjecteerd
columbia => columbia
surprise => surprise
mid => midden; middel
splotched => splotched
warmly => warm
puberty => puberteit
costanza => costanza
donor => donor; Donateur; donateur
top => top; tol
autoimmune => auto-immuun
starts => starts
francisco => francisco
mouse => muis; muizen; muisje
molds => mallen
elisha => elisha
cynicism => cynisme
plugs => plugs
gail => gail
pill => pil
gravitational => gravitationeel
hotel => hotel
wealth => weelde
lotion => lotion; Lotion
abdomen => abdomen
held => hield; hielden
enthusiasm => enthousiasme; enthousiast
tupperware => tupperware
systems => systemen
college => college
retention => retentie
highlights => Highlights
restoration => restauratie; renovatie
color => kleur; color
gersh => gersh
lord => lord
professional => professioneel; professional
strong => straf
skeptic => scepticus; sceptisch
prophet => profeet; profete
front => front
postmenopausal => postmenopauzaal
rivertown => rivertown
fell => vellen; fjell
sun => zon; Zon
fontan => fontana