und => en; hoe zit het met; alsook
offenbar => kennelijk; blijkbaar; duidelijk; apert; evident; klaarblijkelijk; uitgesproken; ogenschijnlijk; voor de hand liggend; klaar
seiner => hem; hij; -zelfde; hij ntiek
habe => heb
gewählt => gekozen; select
außerdem => bovendien; daarenboven; verder; overigens; trouwens; daarbij; daarnaast; voorts; alsmede; daarboven
um => om; met; op; per; te; tot; rondom; aan; jegens; tegen
jähriger => jaar
den => dat
jährige => jaar
wohl => waarschijnlijk; vast; zeker; wel; allicht; bepaald; wel degelijk; immers; ongetwijfeld; toch
als => dan; toen; wanneer
aufgefordert => gevraagd
sei => was
laut => luid; luidruchtig; hard; volgens; hardop
er => hij; hem; ie; zij; het; hie; hē; 'ie; 'm; dankt
wohnung => appartement
eine => een; één; 'n; een of andere
liebeskummer => liefdesverdriet
angaben => informatie
eintrafen => aangekomen
allerdings => zeker; echter; bepaald; vast; wel degelijk; toch; wel; immers; inderdaad; ongetwijfeld
wollte => gezocht
deren => waarvan; wiens; wier; van wie; diens; wie d’r; wie z’n; dier; welks
wurde => was
seine => zijn; iemands; aan hem
stellte => gepresenteerd
frauen => vrouwen
samstag => zaterdag
süddeutschen => zuid-duitsland
mann => mannelijk
anzeige => tonen
am => de; het; aan de; aan het; naar de; naar het
betrunken => dronken; beschonken; zat; bezopen; dol; ladderzat; beneveld; blauw; straalbezopen; kachel
gegangen => weg
zu => te; naar; aan; bij; tegen; voor; tot; op; binnen; gesloten
notrufen => noodoproepen
dar => is
ihn => hem; hij; ’m; d’r; haar; het; 'ie; 'm; ’ie
meldung => bericht
telefon => telefoontoestel
gemeinsame => gezamenlijk; gezamenlijke
zum => naar
beamten => ambtenaren
gesellschaft => vennootschap
bekomme => krijgen
wollten => gezocht
dieser => deze; dit; dat
sache => ding
gehen => lopen; gaan; wandelen; van stapel lopen; verlopen; marcheren; stappen; zich begeven; rijden; varen
es => het; er; hij; dat; d’r; haar; hem; zijn; 'm; 't
zeitung => krant
polizeisprecher => politiewoordvoerder
einem => een; één
schuhwerk => schoeisel
spektakulärsten => meest spectaculaire
verstärkung => beloning
unsere => onze; ons; de onze; die van ons; het onze
erwähnt => vermeld
schutz => bescherming
beiträgt => draagt
statt => in plaats van; in plaats daarvan; in stede van
langen => genoeg zijn; voldoende zijn
wasserbau => waterbouwkunde
lärm => ruis
ursprüngliche => origineel
einspeisevergütung => terugleververgoedingen
teil => deeltje
baudirektion => construction authority
grossräumige => grootschalig
diesem => deze
tatsächlich => werkelijk; daadwerkelijk
so => zo; aldus; zodanig; dusdanig; even; op die manier; dermate; dus; dit; als
zur => naar
fische => vis
eingeleitet => geïnitieerd
drehtür => draaideur
sorgt => biedt
neue => nieuw
werde => zullen
ausführungen => versies
bevölkerung => volk
massnahmen => maatregelen
stiefel => laarzen
publikum => auditorium; audiëntie; gehoor; hoorders; toehoorders
knopfdruck => druk op de knop
knapp => schaars; beknopt; bondig; karig; schraal; schriel; kostbaar; ongemeen; ternauwernood; weinig
raum => heelal
sozusagen => als het ware; zogezegd; bij wijze van spreken; om zo te zeggen
setzt => sets
flügeln => overtreffen
umflossen => gebaad
müssen => moeten; behoren; dienen; horen; behoeven; zullen; hoeven; nodig hebben; toe zijn aan; behoefte
räumt => subsidies
steigerung => toenemen
schon => al; reeds; alvast; alreeds; bereids; nu al; wel; nual; ooit; uiteindelijk
staudamm => dam
sagt => zegt
wasserkraftwerk => waterkrachtcentrale
trifft => voldoet
bild => bord; fotografie; imago; lijst; schoolbord; tabel; tafel
fisch => vis
unteren => lager
kraftwerk => centrale
einher => vergezeld
sowie => alsmede; evenals; zodra; en; alsook
spatenstich => groundbreaking ceremony
bodenschutz => vloerbescherming
unterhalb => onder; beneden; daaronder; eronder; onderste
künftig => voortaan; aanstaand; komend; eerstvolgend; toekomstig; toekomst; aankomend; in spe; nu; toekomend
direkt => rechtstreeks
ohne => zonder; gespeend van; ontbloot van; verstoken van; zonder te; ex
umwelt => leefmilieu
vorliegende => deze
durch => door; per; via; met; op; doorheen; aan; door middel van; bij; gedurende
später => later; achteraf; volgend; daarna; dan; naderhand; nadien; vervolgens; achterste; straks
unter => onder; beneden; tussen; getuigen; in; midden; onderX; tijdens; laagste; onderste
gummistiefel => wellington
ab => vanaf; sedert; sinds; over; van; vandoor; voort; weg; heen; verwijderd
versorgte => geleverde
schweiz => zwitserland
erweitern => uitbreiden; vergroten; uitbouwen; afwikkelen; besmeren; doorsmeren; ontrollen; ontvouwen; ophouden; rekken
fünf => vijf; vijftal
dreck => vuiligheid
da => daar; omdat; aangezien; ginder; ginds; hier; want; vermits; kijk; aldaar
getöse => geraas
sanierung => vernieuwing
auenlandschaft => meadowlands
könne => kon
zurückgewiesen => veroordeeld; verworpen
akt => handeling
hochwasser => overstromen
verworfen => immoreel
kraftwerks => krachtinstallatie
archäologie => oudheidkunde
gang => cursus
zudem => verder; daarnaast; overigens; trouwens; bovendien; daarbij; bijkomend; buitendien; daarenboven; voor de rest
flusskraftwerk => river energiecentrale
zuführt => benodigdheden
pumpensumpf => pompput
geprüft => gevalideerd; gediplomeerd
hindurch => doorheen; door; door ... heen; via; erdoor
hohen => hoog
während => terwijl; gedurende; tijdens; onder; staande; in; voor; lopende; toen; bij
gegensatz => oppositie
nur => slechts; alleen; maar; enkel; pas; uitsluitend; net; gewoon; alleen maar; eerst
spundbohlen => damwanden
insel => eiland
dank => dank zij; dankzij
dauert => neemt
auslauftrompete => aflopende trompet
bau => aanbouw; aanleg
badeplätze => badplaatsen
bloss => gewoon
einen => een
kraft => door; met; per; aan; krachtens; dwingen
saniert => gerehabiliteerd
sie => zij; ze; haar; hen; hij; d’r; het; hun; u; d'r
boden => fond; voedingsbodem
einer => een of andere; enig; een of ander
körperkraft => body force
hauptkraftwerk => de belangrijkste energiecentrale van
erstaunt => verbaasd; verbijsterd; verwonderd; verrast
hauptkraftwerks => de belangrijkste energiecentrale van
aufnehmen => absorberen
mitarbeiter => werknemer
wenn => wanneer; als; indien; toen; ingeval; hetzij; of; zodra; eenmaaal; eens
etwas => iets; een beetje; wat; enigszins
knallgelben => felgele
zentralverwaltung => centrale administratie
bezeichnet => aangewezen
trägt => bears
braucht => nodig hebben
beginnt => starts
hat => heeft
fast => bijna; haast; vrijwel; bijkans; zo goed als; nagenoeg; schier; zowat; welhaast; amper
dieses => deze; dit; dat
hochwasserschutzes => bescherming tegen overstromingen
heiterkeit => opgewektheid
sondern => maar; doch; echter; hoewel; in tegendeel
ihren => hun
zusätzliche => extraatje
brauchen => behoeven; moeten; hoeven; nodig hebben
mai => mogen
oder => of; hè; dan wel; nietwaar; oftewel
gilt => van toepassing
involviert => betrokken
vibriert => trilt
anlage => investering
vom => van
auch => ook; eveneens; evenzeer; tevens; mede; zelfs; alsmede; alsook; evenals; evenzo
weiterbetrieb => voortzetting van de activiteiten
bildet => vormen
trat => toegetreden
schwarze => zwart
offensichtliches => duidelijk
wie => hoe; als; zoals; gelijk; zo; daar; lijkend op; aangezien; bij wijze van; tot
verfahren => doen; handelen; te werk gaan; ageren; bezig zijn; optreden; procedure; aanmaken; afdwalen; bedrijven
weberei => het weven
getätigt => geplaatst
wehrs => waterkering
ins => naar
rentieren => waard zijn
fertig => klaar; gereed; afgelopen; af; afgewerkt; beëindigd; bereid; gedaan; klare; voorbereid
schlüpft => slips
neuen => nieuw
aber => maar; echter; doch; niettemin; toch; behalve; hoewel; in tegendeel
alt => oud; bejaard; vergevorderd; antiek; ouderwets; aftands; aloud; bouwvallig; gammel; oudheid
baudirektor => planning director
zweck => doel
verfahrens => werkzaamheden
ohropax => oordopjes
bis => tot; totdat; binnen; voor; tegen; naar; tot en met
vorgesehen => gepland
hin => naar beneden
stellen => plaatsen; zetten
soll => zal
strommenge => huidige volume
weitere => ander; meer; verder
minuten => proces-verbaal
zweistufigen => tweestaps
für => voor
immer => altijd; steeds
bundesverfassung => federale constitutionele
urschweizerisches => authentieke zwitserse
gigawattstunden => gigawattuur
spatenstichs => groundbreaking ceremony
fernsteuerung => afstandsbediening
im => in; op; tijdens; over; voor
forst => bos
fischereiwesen => vissen wezens
betrieb => werking
erholungsräume => ontspanningsruimtes
wird => wil; zullen
zurück => terug; achteruit; achterwaarts; rugwaarts; weer; achterover; alweer; nogmaals; opnieuw; van voren af aan
einspruch => tegenwerping
entschied => beslist
weiße => wit
menschen => lieden
mitteilung => mededeling
jedoch => echter; maar; niettemin; toch; daarentegen; hoewel; dus; desalniettemin
weiter => verder; langer; verderop; meer; bovendien; daarenboven; langs; verdergaan; voort; voorts
müsse => moet
militär => krijgsmacht
bedeutendes => belangrijk
schluss => sluitend
medikamente => drug
wonach => waarna; waarop; waarachter; waarnaar
legte => zetten
ausschließt => uitsluit
heimatschutzministerin => minister van binnenlandse veiligheid
risiko => kans lopen
verlangte => eiste
ihrer => haar; ze; zij; 'r; d'r; d’r; ’r
disqualifiziert => gediskwalificeerd
verbot => ban
antrag => toepassing
vergangenen => verleden
einstweiliger => tussentijd
dürfen => mogen; kunnen; het recht hebben
hieß => was
umfassende => uitgebreid
erfolg => succes
memorandum => memo
daraufhin => vervolgens; hierop; daarna; dan; waardoor
bundesgericht => federale rechtbank
aufgrund => vanwege; omdat; als gevolg van; door; veroorzaakt door; wegens
verfügung => beschikking
solcher => zulk een; dusdanig; zo’n; zodanig; zulk; dergelijk; zo; zo een; dergelijke; dusdanige
einschließlich => inclusief; inbegrepen; incluis; met inbegrip van
präsident => praeses; preses; voorzitter
nehme => nemen
zulassung => vergunning
darstellten => vertegenwoordigd
hatte => gehad
medizinische => medisch
notiert => opgesomd
regelung => verordening
geschlecht => seks
militärischen => militair
eingriffe => interventies
neues => nieuw
regierung => overheid
entscheidung => beslistheid
trump => troef
haus => huizen
bereits => reeds; al; alreeds; alvast
benötigten => nodig
zeit => keer; maal; tijdsduur
früheres => vroeger
weitgehend => vergaand; ruim; grotendeels; meestal; overwegend
seien => zijn
rückgängig => dalend; teruggaand
anordnung => arrangement
zuständig => bevoegd; competent; deskundig; vakkundig; zaakkundig; verantwoordelijk; aansprakelijk; toerekenbaar
heftigen => hevig
verhängt => opgelegde
dürften => waarschijnlijk
diskutiert => besproken
schädigung => schade
netzsperren => netwerk lock
auf => op; aan; bij; open; in; naar; voor; te; tegen; tot
kritiker => criticus
etwa => ongeveer; circa; een stuk of; zowat; plusminus; rond; daaromheen; ergens; eromheen; in het rond
verbraucher => consument
eingriffsmittel => aangrijpmiddelen
verbrauchern => consumenten
behörden => overheid
zensur => rapportcijfer
internetsperren => internet lock
deutsche => Duits
verordnung => besluit; decreet; regeling
häufiger => vaker
schwerwiegenden => ernstig
eisenbahn => spoorweg
einführung => introductie
luftfahrt => aviatiek; vliegwezen
anfrage => onderzoek
zukünftig => toekomstig; voortaan; toekomend; in de toekomst; toekomst; in het vervolg; aanstaand; in spe; van nu af aan; vanaf nu
verhängen => bedekken; bevelen; opdringen; opleggen; vastleggen
zugangssperren => toegang blokkeren
gesetz => wet
bundesamt => federal bureau
regelwerk => regels
erheblicher => aanzienlijk
bundesanstalt => federaal instituut
abgeordneten => gedetacheerd
betont => benadrukt
geht => gaand
zuständige => competent
frühere => vroeger
umstrittenen => betwist
fachfremde => non-specialist
bislang => tot dusver; tot nu toe; tot dusverre; tot hiertoe; dusver; nog; tot dan toe; tot zover; totnogtoe; zover
behördlichen => officieel
hervor => voort; naar voren; voorover; vooruit; voorwaarts
stammt => data
entscheiden => beslissen; besluiten; uitmaken; kiezen; zich voornemen; beschikken; uitkiezen; uitlezen; uitpikken; uitzoeken
seit => sinds; sedert; vanaf; van; met ingang van; door; sindsdien; aangezien; dan; vermits
brisanz => explosieve kracht
verfasst => constitutioneel; grondwettelijk; grondwettig
geschaffen => aangemaakt
ämter => kantoren
dürfte => macht
sperren => afdammen; afsluiten; belemmeren; boycotten; dood verklaren; stuwen
warnhinweisen => kanttekening
diese => deze; dit; dat; die; det
sperrung => blokkeren
vielen => veel
besonders => vooral; in het bijzonder; inzonderheid; apart; speciaal; voornamelijk; afzonderlijk; extra; gescheiden; terzijde
woche => week
hast => hebt; hebben
erkältung => kou
also => dus; aldus; bijgevolg; daarom; derhalve; zodoende; dan; toch; zo; daarvoor
einige => enkele; sommige
freie => gratis
auszuhalten => dragen
erträglicher => dragelijk
s => enkel
weil => omdat; aangezien; daar; vermits
sind => zijn; bent; are; zijt
auslösen => activeren; teweegbrengen; veroorzaken; initiëren; ontketenen; in gang zetten; ontlokken; oproepen; opwekken; peulen
volle => vol
handelsübliche => commercieel
ressort => afdeling
hinfälligkeit => vijgenmat
hass => haten
erwischt => gevangen
viren => virus
reißt => rips
manche => sommige; enkele; een paar; enige; wat; een aantal; sommigen
beimischung => toevoegsel
jede => ieder; elk; al; alle; elke; iedere; iedereen
dasjenige => datgene
mal => eens; op een keer
dritten => derde
ewigen => eeuwig
gefühle => emoties
schlimm => slecht; beroerd; kwaad; kwalijk; verkeerd; erg; bar; ernstig; pijnlijk; rot
davon => daarvan; ervan; hiervan; weg
fiese => smerig
wenigstens => althans; tenminste
rachsüchtig => rancuneus
angreift => aanvallen
du => jij; je; gij; ge; u; U; de; gulder; Du; jou
fieber => koorts
geschichten => verhalen
sonntagszeitung => zondagskrant
darnieder => uitgestrekt
zuschlägt => strikes
einfach => eenvoudig; simpel; enkel; gemakkelijk; makkelijk; gewoon; slechts; enkelvoudig; aalwaardig; aalwarig
furchtbar => vreselijk; verschrikkelijk; schrikaanjagend; ijselijk; vervaarlijk; bar; afschuwelijk; gevaarlijk; ontzettend; hachelijk
kennt => weten
heißt => is
süße => zoetheid
muss => moet
frühjahr => voorjaar
verbracht => doorgebracht
erkältet => verkouden
bestatter => begrafenisondernemer
beerdigungen => begrafenissen
erkältungen => verkoudheid
schuld => aanrekenen; schuldgevoel
denn => omdat; aangezien; daar; want; vermits; wijl
schwieriger => moeilijk
frankfurter => worstje
selbstmitleidig => zelfmedelijdend
leid => sorry
will => zullen
krank => ziek; naar; zieke; gemeen; immoreel
bett => couchette; kooi; leger; ligplaats
mehrtägigen => enkele dagen
angucken => kijken naar
musste => had
erkältungsleid => verkoudheid spijt
kaum => nauwelijks; amper; ternauwernood; kwalijk; net; met moeite; moeilijk; juist; maar net; lastig
weltöffentlichkeit => wereldopinie
wenigsten => zo min
auftritte => verschijningen
erhaltung => behoud
new => nieuw
seite => ribbe
behauptete => claimen
times => x
dennoch => toch; niettemin; echter; desondanks; maar; desalniettemin; nochtans; ondanks dat
geheiratet => getrouwd
merkte => bekend
gesichert => goedaardig; ongevaarlijk; veilig; onschadelijk; behouden; betrouwbaar; bona fide; geborgen; gewis; safe
meisterschaften => kampioenschappen
auftritt => voordoet
beispiel => voorbeeld
erinnert => recalls
öffentlichkeit => publiek
frau => vrouwelijk
alte => oud
aufgefallen => merkte
staat => overheid
abschottenden => uitsluiting
plötzlich => plotseling; bruusk; plots; abrupt; ineens; plotselinge; opeens; kortaf; onverwachts; onvoorzien
teure => duur
sängerin => zanger
viele => veel
angeblich => vermeend; zogenaamd; naar men beweert; naar verluidt; zogezegd; blijkbaar
mitglied => lid
wichtig => belangrijk; ernstig; erg; voornaam; zwaar; aanzienlijk; zwaarwichtig; aanmerkelijk; vitaal; essentieel
aufsehenerregenden => sensationeel
ihr => jullie; haar; u; hun; zijn; gij; aan haar; d’r; je; ’r
ehefrau => vrouw
erkenntnisse => bevindingen
gerückt => verplaatst
mutter => moeder
ihre => hun; haar; aan hun
vater => vaderschap
genossin => kameraad
südkoreanischen => zuid-koreaanse
staatschef => state-kok
berichtete => gerapporteerd
nachrichtenagentur => persbureau
machthabers => heerser
selbstbewusst => zelfverzekerd
genannt => genaamd; genoemd; met name; vermeld
dabei => daarnaast; ernaast; hiernaast; in de nabijheid; daarmee; daarmede; met dat; aanwezig zijn; bezig
überlebenswichtig => vitaal
land => bondsland
sehen => zien; aanschouwen; kijken; bekijken
clan => stam
ihm => hem; aan hem; aan ’m; daar ... aan; daaraan; er ... aan; er ... heen; eraan; erheen; het
staatlichem => nationaal
asien => azië
ärztin => doctor
damals => toen; destijds; dan; toenmaals; toentertijd; indertijd; hierna; vervolgens; op dat moment
geheimdienstes => geheim
regiert => geregeerd
dessen => waarvan; wiens; wier; diens; van wie; wie d’r; wie z’n; dier; welks; die d'r
vergnügungspark => pretpark
erstmals => voor het eerst
besuch => bezoek
zeigten => toonden
tasche => zak
information => bericht; terechtwijzing; verwittiging
tauchte => verschenen
drittes => derde
stolz => trots; fier; prat; groots; hooghartig
bleibt => stoffelijk overschot
woman => vrouw
sehr => heel; erg
blickfeld => gezichtsveld
aufmerksam => aandachtig; attent; oplettend; aardig; alert; leuk; lief; mooi; prettig
erfunden => fictief; liegen; verzinnen; verzonnen
abwendung => afkeer
gemeinschaftsstandards => communautaire normen
würde => zou; zouden
staatsanwalt => aanklager
drohenden => bedreiging
aushalten => verdragen; ondergaan; dragen; lijden; doorstaan; uithouden; uitstaan; dulden; harden; velen
vermische => gemengd
tun => doen; maken; aanmaken; bedrijven; uitrichten; uitvoeren; uitbrengen; aanleggen; bouwen; construeren
unnachahmlich => onnavolgbaar
entweder => of; hetzij; ofwel; beide
argument => betoog
grund => reden
angedroht => bedreigd
glaube => denken
vorzeigeunternehmen => vorzeige bedrijf
anruf => telefoontje
unterhaltung => aardigheid; lol; pret; pretje
sonst => anders; ander; in het andere geval; zoniet; anderszins; op een andere manier; zo niet
jeweiligen => elk
derzeit => nu; tegenwoordig; op het ogenblik; huidig; hierna; momenteel; thans; toen; toenmaals; toentertijd
durchaus => beslist; absoluut; bepaald; per se; strikt; volstrekt; zeker; vooral; best; degelijk
juristische => wettelijk
protokoll => verslag
dies => deze
nutzer => gebruiker
fähigkeit => vermogen
unzulässig => afgekeurd; ongeoorloofd
verstoße => tegendeel
nebenbranchen => naast industrieën
art => wijs
überzeugendes => dwingende
bitte => alstublieft; alsjeblieft; graag gedaan; gelieve; wees zo goed; geen dank; a.u.b.; asjeblief; asjeblieft; geen probleem
operiert => chirurgie
kettensäge => kettingzaag
umsehen => omkijken; rondkijken; rondzien
reicht => genoeg
dort => daar; ginds; ginder; aldaar; daarginds; er
müssten => zou
datenschutz => privacy
gedöns => onsamenhangend
mühe => inspanning
beim => tijdens
transparenz => doorzichtigheid
einmal => eens
geschäftspraxis => zakelijke praktijk
hält => houdt
vornehmen => verrichten; bewerkstelligen; doorvoeren; realiseren; uitvoeren; nakomen; naleven; tot stand brengen; vervullen; verwerkelijken
weiterhin => bovendien; daarenboven; verder; voorts; continueren; doorgaan; verdergaan; voortzetten; behalve
aufsagen => opzeggen; reciteren; voordragen
erklärte => uitgelegd
konzerns => groep
kunden => klant
vorzunehmen => maken
überlegt => doordacht; weloverwogen; doordachte
gesetze => wetten
blatt => lemmer
mittel => medium; middelbaar; middelste; midden-
brotaufstrich => verspreiding
zahlt => pays
zerkleinern => fijnstampen; stampen; verscheuren; versnipperen
solche => zulk een; zo’n; dergelijk; dusdanig; zo; zo een; zodanig; zulk; dergelijke; dusdanige
veröffentlicht => gepubliceerd
kollegen => collega's
kümmern => zorgen; behartigen; verzorgen; schelen; bezorgd zijn; zich bekommeren; bezorgd maken; naar omkijken; zorg
einfachen => makkelijk
strafzölle => strafheffingen
ansprechpartner => contactpersoon
empfindlich => gevoelig; teergevoelig; zwak; delicaat; teer; netelig; vatbaar; breekbaar; broos; fragiel
gebe => geven
zölle => plichten
lauer => wachten
sekunde => tweede
miteinander => samen; bij elkaar; bijeen; gezamelijk; tezamen; ineen; met elkaar
angeheuert => gehuurd
manchmal => soms; somtijds; weleens; bijwijlen; somwijlen; wel eens; af en toe; bij wijlen; nu en dan
saatgut => zaden
corporate => zakelijke
geschwindigkeit => snelheid
irgendwelche => enkele; een of andere; elk; enkelen
geltende => toepasselijk
satz => soorten zinnen; zetten
pressesprecherin => perswoordvoerder
schützen => beschermen; behoeden; beveiligen; bewaken; bewaren
umgang => behandeling
gerade => recht; net; even; rechtop; zojuist; direct; pas; juist; overeind; paar
unserer => de onze; die van ons; het onze
anfang => begin
ersetzen => vervangen; vergoeden; compenseren; aflossen; de plaats innemen van; goedmaken; inspringen; substitueren; in de plaats stellen van; corrigeren
keine => niemand; geen; geen enkel; geen enkele; nee
obwohl => hoewel; alhoewel; ondanks; ofschoon; al; dat; desondanks; maar; ook al; wel
ansehen => bekijken; kijken; blikken; toekijken; kijken naar; toezien; aangaan; beschouwen; betreffen; gelden
erinnerte => teruggeroepen
zielen => mikken; richten; bedoelen; beogen; mikken op; rooien; ten doel hebben; streven
verwies => puntig
anzufangen => om te beginnen
mindestanforderungen => minimumeisen
trotz => ondanks; niettegenstaande; in weerwil van
führungsetagen => executive verdiepingen
erwogen => bedachtzaam; doordacht; weldoordacht
entfernte => afgelegen
vorladen => dagvaarden; toewijzen; voor het gerecht dagen; citeren; noemen; ontbieden; toedichten; toekennen; toeschrijven
team => elftal; equipe
müsste => moeten; zou moeten
ölkonzern => olie groep
betroffenheit => consternatie
sondersteuern => speciale controle
angeht => zoals voor
vielversprechend => gunstig; veelbelovend; hoopgevend; hoopvol
damit => daarbij; opdat; daarmee; ermee; dat; om; zodat; zodoende; aldus; ten einde
monaten => maanden
wo => waar; waarvan; waarvandaan; waarheen; WAAR; waarnaartoe
beruhigen => kalmeren; geruststellen; bedaren; sussen; gerust stellen; gunstig stellen; lenigen; pacificeren; verzachten; vrede brengen
gehabt => had
halte => denken
beschimpft => beledigend
drohung => bedreiging
öffentlichen => publiek
seinen => zijn
pkw => auto
dagegen => daarentegen; integendeel; maar; ertegenover; echter; tegenaan
hochrespektable => zeer respectabel
anzieht => trekt
erdnussbutter => pindakaas
ohnehin => hoe dan ook; sowieso; desondanks; in ieder geval; toch
finanzbehörden => fiscus
treffen => raken; ontmoeten
könnte => zou kunnen
nutzern => -gebruikers
ignoriert => genegeerd
jedem => elk
gibt => zijn
fand => vond; vonden
scheint => lijkt
ehemalige => voormalig
wenden => draaien
steuerregeln => fiscale regels
orangensaft => jus
gerecht => rechtvaardig; billijk; fair; goed; juist; eerlijk
pro => per; in; te; binnen; aan; elk; ieder; om; tegen; voor
einzige => alleen; enkel
selbst => zelf
sagen => zeggen; opgeven; vertellen; spreken; praten; uitbrengen; instrueren; gezegde; luiden; opzeggen
eben => vlak
wusste => kende; kenden
ernst => serieus
bauern => boerenstand
solle => moeten
lahmen => hinken; mank lopen
worden => zijn
schauspielerin => actrice
mag => zoals
wenige => enkel
mitzuschneiden => vangst omhoog
beschäftigungen => bezigheden
nützliche => bruikbaar
mehreren => meer
klar => duidelijk; helder
deine => je; jouw; uw
anzeigentext => weergavetekst
achtung => attentie
hätte => zou
privatleute => particulieren
wähler => kiezer
verteuern => duurder maken
einfuhrmenge => invoervolume
voraussetzung => eis
gesicht => onder ogen zien
hauptsitz => hoofdkwartier
frage => vraag
drecksunternehmen => dreck bedrijf
sollte => moeten; zou moeten
wehtut => doet pijn
verdient => loffelijk
gewaltphantasie => gewelddadige fantasie
warnschuss => waarschuwingsschot
kein => geen; nee; geen enkel; neen; generlei; geen enkele; niemand; niet; nee, niet; niet een
wirtschaft => economie
halten => houden; vasthouden; stoppen; bijhouden; afslaan; blijven staan; halthouden; stilstaan; beschouwen; gadeslaan
kenne => weten
obskuren => obscuur
lautete => was
verstehen => begrijpen
wiedergeben => reproduceren; teruggeven
tageszeitungen => dagbladen
gegner => tegenstander
zieht => trekt
dargelegt => uiteengezet
aufregung => opwinding
fall => val
überprüfen => controleren; checken
übersetzung => vertaling
deutschen => Duits; Duitse
herabsetzt => vermindert
leugnete => ontkend
hinzuweisen => te wijzen
folterten => gemarteld
wahlkämpfen => verkiezing strijd
hilfe => help
erschreckt => bang
wirksame => effectief
hilfen => aids
umgegangen => behandeld
schleppten => gesleept
verhafteten => gearresteerd
auszusetzen => blootstellen
streitschrift => argumentatieve schrijven
seinem => zijn
weltteilen => hele wereld delen
sieg => overwinning
umreißen => vernielen; vernietigen; verwoesten; afbreken; neerhalen
steht => stands
eheschließung => bruiloft
bestandsaufnahme => inventaris
möglichkeit => kans
schwulen => homoseksueel
eingesetzt => gebruikt
merken => onthouden
erfolgreichen => geslaagd
rechten => procederen
entnommene => teruggetrokken
vorfälle => incidenten
abkürzung => snelkoppeling
nachtrag => supplement
aufbrachte => bijeengeraapt
präsidentschaftswahl => presidentsverkiezingen
ehe => voor; alvorens; aleer; alvorens te
lage => plaats
prägt => bedrukt
teilte => verdeeld
gebessert => gereformeerd
orientierungen => oriëntaties
bündig => beknopt
englischen => engels
heute => vandaag; heden; hedendaags; ZDF heute; vandaag de dag; tegenwoordig
diskriminierungen => discriminatie
bedeutung => betekenis
aufgeregte => opgewonden
zukunft => aankomend; toekomend; toekomstig
durchgesetzt => afgedwongen
gestellt => naast elkaar
machte => gemaakt
einzelfall => individuele gevallen
zwiespalt => conflict
gleichgeschlechtliche => hetzelfde geslacht
keiner => niemand; geen; geen enkel; geen enkele
wünschte => wensen
obzwar => hoewel; alhoewel; ofschoon
errungen => won
trauriger => verdrietig
erfolge => successen
blick => uitzicht
orientierung => oriëntatie
anklagend => beschuldigend
gesellschaften => bedrijven
premierminister => premier
dafür => daarvoor; ervoor; daartoe; daardoor; daarom; vandaar; zodoende; hiervoor; in plaats van
jahrhundert => eeuw
neben => naast; nabij; aan; bij; dichtbij; op; behalve; te; bezijden; binnen
gar => geheel; heel; helemaal; totaal; volkomen; volledig; finaal; zelfs; gereed; klaar
liegt => is
queere => zonderling
bändigen => temmen; africhten; dresseren; beteugelen; intomen; afremmen
stellungnahmen => adviezen
berichtet => gerapporteerd
angriff => aanval
umgebracht => gedood
tausende => duizenden
sogar => zelfs; eens; niet eens; nog niet; quitte; zowaar
ressentiments => wrok
jüngsten => recent
wahlkampagne => verkiezingscampagne
recht => juist
auftreten => ontstaan
religiosität => godsdienstigheid
unterschiedlich => verschillend; divers; anders; ongelijk; uiteenlopend
unmittelbar => direct; rechtstreeks; live; recht; dadelijk; meteen; onmiddellijk; frank; onbeschroomd; oprecht
form => vormen
gesucht => zoek
buch => boeken
stärke => etmeel
weder => X Y; noch
ihnen => hun; ze; aan hun; aan ze; hen; naar hun; zij
mittlerweile => inmiddels; ondertussen
schwule => homoseksueel
sicherheitskräfte => veiligheidstroepen
wussten => kende; kenden; wist
jahrhunderts => eeuw
ungewöhnlich => abnormaal; ongewoon; ongebruikelijk; vreemd; buitengewoon; afwijkend; aberrant; afdwalend; dol; dolzinnig
spielerisches => speels
szene => scène
nachdem => nadat; na; over; omdat; achter; dan; vervolgens
witzig => geestig; gevat; ad rem; snedig; grappig; amusant; geinig; humoristisch; kluchtig; koddig
herangegangen => benaderde
kleine => small
nie => nooit; nimmer
ganz => heel; geheel; compleet
traurigsten => droevigste
möglichkeiten => strekking
einschränkung => beperking
anrührend => aandoenlijk
essenden => het eten
jungfräulichkeit => maagdelijkheid
gut => goed; okee; fraai; goede; knap; mooi; net; ruim; schoon; dik
heimischen => binnenlands
tat => deed
mühseligen => zwoegend
produktion => fabricage; fabricatie
mitunter => soms; bijwijlen; af en toe; nu en dan; somtijds; somwijlen; weleens
herum => omheen; rondom; rond; circa; een stuk of; eromheen; ongeveer; plusminus; zowat
kämpfe => gevecht
sitzenden => gezeten
winzigen => klein
nächte => overnachtingen
führen => leiden; besturen
abzusichern => beveiligen
entbehrungsreiche => ontbering
schließlich => uiteindelijk; eindelijk; tenslotte; immers; ten slotte; eventueel; per saldo; per slot van rekening
spießig => kneuterig; burgerlijk
drehbuch => scenario
lebenslange => levensduur
büchern => books
vielleicht => misschien; mogelijk
paare => paren
beobachtet => opgemerkt
regie => richting
filmporträts => movie portretten
nah => nabij; dichtbij; bij; dierbaar; naverwant; nabije; dicht bij; kortbij; om de hoek; op een boogscheut
ihrem => hun
gmbh => ltd.
beziehung => verhouding
auswahl => selectie
glück => fortuinlijkheid
kleinen => small
nebeneinander => zij aan zij; Naast elkaar
ihres => haar
paares => echtpaar
trotzdem => desondanks; niettemin; toch; echter; hoewel; maar; desalniettemin; ondanks dat; in ieder geval; nochtans
hochzeitsfeier => bruiloft
heiraten => trouwen; huwen; in de echt verbinden; uithuwelijken; in het huwelijk treden; zich in de echt verbinden; met; tot man nemen; tot vrouw nemen; de man worden van
verheiratet => getrouwd; gehuwd
klischees => clichés
genau => precies; nauwkeurig; exact; accuraat; juist; nauwgezet; stipt; zorgvuldig; prompt; punctueel
wohnzimmertisch => salontafel
verliebtsein => verliefd
regalen => schappen
mädchenhaft => meisjesachtig; mesjesachtig
schönen => manipuleren; Skåne
begleitet => vergezeld
schmächtige => zwak
frühsport => s morgens te oefenen
liebe => beminnen; dierbaar; dierbare; houden van
partnersuche => dating service
alter => leeftijd
vermittler => bemiddelaar
hügeligen => heuvelachtig
dazwischen => daartussen; ertussen
stets => altijd
zweisamkeit => saamhorigheid
je => ooit; eenmaal; eens; per; aan; wel eens; elk; ieder; bij; hoe
eingefädelt => draad-
wohlhabenden => rijk
hinreißend => adorably
usa => vs
sieht => looks
japanerin => japans
frühstückstisch => ontbijttafel
hinweg => heen; over; verwijderd; vandoor; voort; weg; overheen
norman => normandisch
bewahrte => gered
angst => angstgevoel; anxietas; bang; bang zijn
details => gegevens
kuriosum => vreemde ding
früher => vroeger; eerder; daarvoor; indertijd; vooraan; weleer; voorheen; eens; ooit; voormalig
rat => raad
zuneigung => genegenheid
erkämpfe => vecht voor
wunderbar => wonderlijk
rechtlich => juridisch
ehebett => echtelijk bed
abhebt => liften
weniger => minder; min; minder dan; minus
verleih => huren
schimpft => scheldt
kastengrenzen => doos grenzen
scham => beschaamdheid
unzeitgemäß => verouderd
akzeptiert => aanvaard
genauen => exact
oberlehrerhaften => schoolmasterish
sätze => prijzen
einfamilienhäuschen => eengezinswoning
näher => dichterbij
unordentlich => slordig; chaotisch; morsig; rommelig
hantiert => afgehandeld
tagsüber => overdag; voor donker; voordat het donker wordt; daags
kultivierten => bewerkt
schwestern => zusters
nett => aardig; lief; vriendelijk; aangenaam; leuk; schattig; prettig; mooi; charmant; heerlijk
beobachten => observeren; waarnemen; gadeslaan; toekijken; toezien; bekijken; opmerken; waken; horloge; in acht nemen
zanken => twisten; kibbelen; krakelen; schimpen; vechten; kibelen; rusiemaken; harrewarren; kiften; kijven
hoffnungsvoll => hoopvol; hoopgevend; vol verwachting
faszination => betovering
sinne => verstand
indischen => indiaas
ergänzen => aanvullen; toevoegen; bijdoen; bijmengen; bijvoegen; toegeven; vervolledigen; aanbouwen; aaneenschakelen; aaneenvoegen
gehende => wandelen
stumme => dempen
kürbisse => pompoenen
hochzeit => bruiloft
wohltuend => aangenaam; aardig; bekoorlijk; charmant; innemend; lief; liefelijk; schattig; snoeperig; snoezig
knetfiguren => klei cijfers
pragmatismus => zakelijkheid
garten => tuin
zerreißt => tranen
bisschen => baard; enkele
getroffen => hit
bill => rekening
alltag => het leven van alledag
schmerzt => doet pijn
liebesbeziehung => buitenechtelijke relatie
verbundenheit => solidariteit
spielt => toneelstukken
schwierigkeiten => moeite
findet => vondsten
hochzeitnacht => bruiloft acht
zuschauerin => publiek lid
niemals => nooit; nimmer
ursprungs => oorsprong
verfügbar => beschikbaar; verkrijgbaar; in voorraad; op stock; vooradig; voorhanden; voorradige; vrij; beschikbare status; disponibel
mitglieder => leden
kontrollen => controls
englisch => Engels
eingabe => invoer
interessen => belangen
ausmaß => omvang
zugänglichen => toegankelijk
alten => oud
voneinander => van elkaar
mittwoch => woensdag
gab => was
riesiger => reus
einstellung => houding; stand
gründer => oprichter
datenschutzregeln => regels inzake gegevensbescherming
dazu => daartoe; daarvoor; ervoor; daarbij; erbij; ten; ter; daaraan; daarenboven; daarheen
unzulässige => niet aanvaardbaar
nahezu => bijna; haast; bijkans; schier; nagenoeg; vrijwel; zowat; welhaast; zo goed als; amper
hinzu => bovendien
vorstandschef => board chef
unglücklich => onfortuinlijk; arm; beklagenswaardig; erbarmelijk; ongelukkig; ongelukkigerwijs; schamel; zielig; bedroefd; bedrukt
geriet => kwam
wahlkampf => verkiezingswerk
fehlern => fouten
öffentlich => publiek; openbaar
dargestellt => getoond
auswirkungen => effecten
fügte => toegevoegd
bitten => vragen; verzoeken; aanvragen; inroepen
nannte => genoemd
gremiums => paneel
mitgründers => medeoprichter
gegenwärtigen => stroom
lieferte => voorzien
aktiviert => geactiveerd
vernünftig => verstandig; vroed; wijs; redelijk; verantwoordelijk; rationeel; redelijkerwijs; zinnig; billijk; betamelijk
kassiert => geïnd
voraussetzungen => vereisten
mittelsmann => tussenpersoon
größten => de grootste
frühzeitig => vroeg; vroegtijdig
wiederum => opnieuw
welt => wereld
gelte => van toepassing
fehler => fout
beschafft => aangeschaft
schritten => stappen
deinen => uw
verwaltungsrat => raad van bestuur
schlagwort => leuze
erst => pas; maar; alleen; enkel; slechts; uitsluitend
bedeutsame => significant
it => zij
mitgliedern => leden
nutzerzahlen => user-pay
leute => mensen
gespürt => vilt
gedacht => bedoeld
anwendung => gebruikmaking
suchfeld => zoekveld
zuversichtlich => zeker; gewis; stellig; vast; vaststaand; verzekerd; wis; ontwijfelbaar; optimistisch; waaraan niet te twijfelen valt
genannte => riep
bestimmten => zeker
vergangenheit => geschiedenis
herankommen => naderen
löschen => blussen; wissen; uitdoven; verwijderen; doven; uitblussen; uitdoen; afbetalen; aflossen; afschrijven
verschafft => biedt
entscheidende => beslissend
verwaltungsratschef => raad van chef-kok
sagte => vertelde; vertelden; verteld
einschätzung => aanslag
instrumentalisieren => exploiteren
umfang => cirkelomtrek
suche => zoeken
kündigte => aangekondigd
heraus => over; heen; vandoor; verwijderd; weg; buiten
tretende => voorbijgaand
betroffenen => aangedaan
werbeboykotte => reclame boycots
medienberichten => berichten in de media
irgendwann => ooit; eens; eenmaal; wel eens; soms; weleens
drittparteien => derden
netzwerk => net
erlauben => toestaan; toelaten; veroorloven; gedogen; vergunnen; permitteren; autoriseren; dulden; goedkeuren; goedvinden
weitergegeben => doorgegeven
gemacht => gedaan
konterte => tegengegaan
demnach => bijgevolg; daarom; dus; aldus; derhalve; daarvoor; vandaar
rede => spraak
aufrufe => bezoeken
regulierungen => regeldruk
falls => als; indien; wanneer; in het geval dat; ingeval; as; voor het geval dat
genutzt => gebruikt
haltungen => houdingen
hoffe => hopen
ausgehen => uitgaan; uitkomen; uitlopen; uitstappen; uitstijgen; uittreden; daten; geven; uitdoven; aanbotsen
bekanntwurde => werd bekend
ganzen => alle
geschäft => bedrijf
gewaltigem => enorm
unternehmens => vennootschap
vereinzelte => geïsoleerd
telefonkonferenz => conference call
nutzerdaten => gebruikersgegevens
könnten => mogen; zou kunnen
beziehungsstatus => relatie status
irgendjemand => iemand
ganze => hele
zusammenhang => aansluiting
druck => afdruk
manipulationsversuche => sabotage try
vorstand => raad van bestuur
zahl => nummer
spuren => spoor
reihe => rij
zuvor => eerder; vroeger; daarvoor; voorheen; indertijd; vooraan; vooraf; voordien; weleer; tevoren
griff => behandelen; hanteren; omgaan; omgaan met
bekommen => krijgen; ontvangen; verkrijgen; behalen; genieten; toucheren; verwerven; halen
rücktritt => terugtreding
fortschritte => vooruitgang
fertiggestellt => afgewerkt; klaar; gedaan
gebuchten => geboekt
beispielsweise => bijvoorbeeld; onder andere; zo; zoals; bij voorbeeld
weiteres => ander
verständnis => begrip
drittanwendungen => derde toepassingen
gefordert => bindend; dwingend; gedwongen; nodig; verbindend; verplicht; verplichtend
anzeigen => adverteren; aankondigen; aandienen; aangeven; klikken; verklikken; aanduiden
gefunden => terecht
fehlende => vermist
außer => behalve
immerhin => zeker
hubschrauber => helikopter
jahrzehnten => decennia
bayerische => bavarian
lehrer => leraren
sendung => tonen
aufklären => inlichten; verduidelijken
wichtigste => eerste; primaire; belangrijkste; voornaamste
umzugehen => transactie
panzer => vechtwagen
sicherlich => zeker; vast; wel degelijk; bepaald; beslist; ongetwijfeld; voorzeker; waarlijk; natuurlijk; tuurlijk
gegenwärtige => stroom
beschäftigte => werknemer
betrauen => belasten met; opdragen; opdracht geven; toevertrouwen; laden
rolle => figuur; speler
schilderte => geportretteerd
fettleibigkeit => zwaarlijvigheid
manchen => sommige
bewältigen => overtreffen; overwinnen; te boven gaan; bevangen; uitblinken; uitmunten; verslaan; voorbijstreven; zegevieren; aankunnen
darf => moet
jeden => elk
interessent => belanghebbende
erziehung => onderwijs
grundprinzipien => basisprincipes
wofür => waarvoor; waartoe; waarom
herzustellen => maken
einser => -expanding
adressat => geadresseerde
abend => avond
gewalt => agressie
grundwiderspruch => fundamenteel tegenstrijdige
innenminister => minister van binnenlandse zaken
jener => die; dat; gindse; deze; dit; dat ... daar; datgene; degene; det; die ... daar
präferenzen => voorkeuren
armut => armoede
eigentliche => echt
aufklärung => onderwijs
elternhäusern => ouderhuizen
armee => leger
unterzubringen => accommoderen
lesern => readers
einfluss => invloed
überblick => overzicht
herausforderungen => uitdagingen
zeitalter => leeftijd
versucht => beproefd
fehlen => schelen; ontbreken; afwezig zijn; missen; absent zijn; mankeren; ontberen; schorten; mangelen; derven
friedenserziehung => vredeseducatie
grassierenden => ongebreidelde
bildungsdebatte => onderwijsdebat
aufgaben => taken
schulischen => school
wieder => opnieuw
herausforderung => uitdaging
kleiner => minder
abiturienten => middelbare school senioren
angesichts => gezien
vorbild => model
desolaten => woest
muslimischen => moslim
psychologe => zielkundige
franziska => franciscaanse
insofern => als; indien; ingeval; wanneer; zo; evenveel; mits; zoveel; zozeer
mediennutzung => mediagebruik
verfassung => grondwet
geprägt => gemarkeerd
allgemeinbildenden => algemeen
bekämpfen => bevechten; bestrijden
aufsehen => hoogachten; opkijken
armeeradiosender => leger radiostation
erziehungsminister => minister van onderwijs
twitter => tjilpen
schicken => zenden; sturen; verzenden; opsturen; betamen; behoren; doen toekomen; horen; opzenden; passen
arbeitet => werkend
fällt => falls
niemanden => iedereen
freudenrufe => call vreugde
verletzte => gewond
angehen => aangaan; betreffen; gelden; raken; aanpakken; bekijken; blikken; kijken; kijken naar; schouwen
kritik => aanmerking; beoordeling; recensie
gefährden => bedreigen; in gevaar brengen
ruft => het roepen
grenzzaun => kruis hek
geschah => gebeurd
zutiefst => diep
freudenschreien => schreeuw vreugde
zielt => doelstellingen
or => of
verurteilte => overtuigd
zehntausende => duizenden
zeigen => tonen; aanwijzen
hebräisch => Hebreeuws; joods; hebreeuws
mensch => man; manspersoon; vent
vorfall => incident
ereignet => plaatsgevonden
montag => maandag
sender => omroep
unklar => onduidelijk; ambigu; vaag; duister; ontastbaar; ontastbare; bewolkt; nevelig; onzeker
schuss => shot
darstellte => vertegenwoordigd
hinrichtung => executie
untersuchen => onderzoeken; uitzoeken; nagaan; exploreren; uitvissen; vorsen; examineren; nakijken; zoeken; een enquête houden
zeige => tonen
abgeordnete => plaatsvervanger
kurzen => kort
äußerungen => uitspraken
gewaltsamen => hevig
gefahr => gevaarlijkheid; hachelijkheid
unterstütze => ondersteuning
südlichen => zuidelijk
motiv => aanleiding
aussieht => looks
tötete => gedood
passieren => gebeuren; aan de hand zijn; voorkomen; voorvallen; geschieden
befehle => commando's
hurensohn => klootzak
innere => binnenste
erschütternd => tragisch; verschrikkelijk
einwohner => bevolking
sicherheit => waarborg; beveiliging en bewaking
illegalen => onwettig
solches => zulk een; zo’n; dusdanig; dergelijk; zo; zo een; zodanig; zulk; dergelijke; dusdanige
wachsen => groeien
kurs => baan
stehen => staan; rechtstaan; gaan staan; zijn
verstoßes => inbreuk
meinungs => , advies
mehrheit => gros; meerderjarigheid
verweist => points
widerstand => elektrische weerstand
maßregelung => berisping
zunächst => vooral; eerst; in het bijzonder; inzonderheid; allereerst; aanvankelijk; in de eerste plaats; vooreerst; bovenal; eerste
gestartet => begonnen
eingriffen => tussenbeide
billigen => goedkeuren
grundwerten => basiswaarden
korruption => bederf
sanktionsverfahrens => sanctie procedure
auszuhebeln => omvallen
vorgehen => ageren; doen; handelen; bezig zijn; optreden; te werk gaan
ministerpräsidenten => premier
grundsätze => beginsel
weiteren => meer
läuft => runs
hinaus => buiten; eruit; daarbuiten; uit; buitenwaarts; naar buiten; uiterlijk; uitwaarts; weg
interessenkonflikte => belangenconflicten
läge => zou
regierungschef => hoofd van de regering
versammlungsfreiheit => vrijheid van vereniging
maßnahmen => maatregelen
justizsystems => rechtssysteem
presse => drukken
meinungsfreiheit => vrijheid van meningsuiting
verstöße => schendingen
gefährdung => risico
nennt => telefoontje
ungarische => hongaars
folge => rij; serie
deshalb => daarom; daardoor; dus; vandaar
verträge => contracten
empfiehlt => beveelt
wiedergewählten => herkozen
berichterstatterin => -rapporteur
triumphiert => triomfen
drittel => derde
einschränkungen => beperkingen
schwächung => verzwakking
bericht => artikel; rapporteren
justizsystem => rechtssysteem
zusammengenommen => samen
innenausschuss => intern comité
parlamentswahl => algemene verkiezingen
verfassungs => make-up
fährt => drives
schleuserei => smokkelen
sieben => zeven; ziften; zift
verdachts => achterdocht
wann => wanneer; als; toen
erneut => opnieuw; nogmaals; wederom; weer; alweer; alweder; terug; weder; weerom
württemberg => kruiderij
abarbeiten => afwerken; doodwerken; uitvoeren
bundesländern => deelstaten
beschuldigte => beklaagde
kriminalität => misdaad
mussten => had
festgenommenen => gearresteerd
pressesprecher => persvoorlichter
überwiegend => vooral; veelal
haftbefehle => arrestatiebevelen
häufig => dikwijls; vaak; veelvuldig; frequent; veel; veelal; gedurig; veeltijds; menigmaal; gewoon
fluchthilfe => uitlijnhulp
verdacht => achterdocht
vorwürfe => beschuldigingen
ermittelt => vastbesloten
lebensgefährte => significante andere
nutzten => nam
rotationsprinzip => roulatiebeginsel
staatsanwaltschaft => aanklager
skrupellosen => meedogenloos
gemeinsam => gezamenlijk; gemeenschappelijk; samen; algemeen; collectief; gedeeld
erzielen => behalen; bereiken; inhalen; reiken tot; treffen; scoren
arbeiten => werken
gelungen => geslaagd
thailändische => thai
siegen => overwinnen; winnen; verslaan; zegevieren; bevangen; afbreken; afhakken; afhouwen; afkappen; afleggen
fanden => gevonden
verbrechen => criminaliteit; vergrijp
komplizen => medeplichtigheid
schleusung => schutgeld
chancen => prospects
profitgier => profit hebzucht
ermittler => onderzoeker
behördenangaben => autoriteiten toelichtingen
bundesweites => landelijk
bundesgebiet => federale reserve
spur => afdruk; voetspoor
eingreifreserve => operationele reserve
chef => eindbaas
vorenthaltens => beroving
vollstreckt => afgedwongen
gezielt => gericht
beispielloser => zonder precedent
vorgegangen => overgegaan
schlag => schok
durchsuchte => overvallen
durchsuchungen => onderzoekingen
verpflegung => catering; proviandering; ravitaillering; voedselvoorziening
monatelange => maanden
gehe => gaan
verhaftet => opgesloten
verzweigtes => vertakte
bundesinnenminister => federaal minister van binnenlandse zaken
erkenntnissen => bevindingen
mutmaßliche => verdacht
trafen => ontmoette
ermittlern => onderzoekers
angetroffen => gevonden
einnahmen => inkomsten
aufenthaltes => blijven
angemeldet => onthouden
aufgebaut => gebouwd
nahmen => nam
zeigt => shows
hauptverdächtigen => verdachte
mittätern => medeplichtigen
vermeintliche => vermeend
durchsuchten => doorzocht
oberstaatsanwalt => upper aanklager
bundesweit => landelijk
wohnungen => huisvesting
einsatz => gebruik
besteht => is
gewissen => sommige
keinen => geen
miete => huur
menschenverachtenden => onmenselijk
unterstützt => ondersteund; ondersteund door
schleusern => smugglers
steuerhinterziehung => belastingontduiking
ausmaßes => omvang
zuhälternetzwerk => pimp netwerk
schleusungskriminalität => immigratie
razzia => politie-inval
bande => kliek
festgenommen => gearresteerd
ermittlungen => onderzoeken
insgesamt => samen; tezamen; bijeen; ineen; globaal; aaneen; in totaal; welgeteld; al met al; algeheel
schwerpunkt => zwaartepunt
ausgeliefert => afgeleverd
etlichen => verscheidene
zuhälterei => aanschaffing
abreise => vertrek
deutsch => Duits; Duitse
schleuser => smokkelen
arbeitsentgelt => werken voor geldelijke
übernommen => aanvaard
büros => kantoren
betrieben => bediend
ausbeutung => exploitatie
deutscher => Duits; Duitse
ermittlungsstand => bepaling was
staatsanwaltschaften => openbare aanklagers
thailändischer => thai
betroffene => aangedaan
harter => taai
sozialversicherung => sociale zekerheid
dadurch => daarmee; daarmede; daarbij; daardoor; hierdoor; erdoor
würden => gelieve; zou; zouden
siegener => buiten siegen
danach => vervolgens; dan; achteraf; toen; daarna; nadien; daarop; erna; na; naderhand
aktiv => actief; bedrijvend; werkzaam; bedrijvig; bedrijving; werkdadig; werkend; levendig; beweging; dynamiek
genauso => even; evengoed; trouwens
würdet => zou
viertel => kwart
einzigen => single
hölle => hel
lauter => de loutere waarheit
schön => mooi; fraai
glückwunsch => felicitatie
gepinkelt => geplast
schlaf => slaapstand; slapen
aufkommen => ontstaan; verschijnen; oprijzen
buchholz => beukenhout
geflohen => gevlucht
vatertagsgelage => vaders dag spree
dichtschwallen => strak surge
benehmen => zich gedragen; gedragen; optreden; Gedragswijze; ontnemen
erbrochenem => braakte
lässt => bladeren
seid => zijn
leitkultur => dominante cultuur
wohnhäusern => flatgebouwen
begeisterung => enthousiasme
mischt => gemengd
gerne => graag
schnapsleichen => brandy balans
fan => ventilator; waaien; waaier
kneipen => pubs
großstadt => stad
fahren => rijden; gaan
großflächig => een groot gebied
nervt => zuigt
übrigens => trouwens
freude => vreugd
wohltat => goede daad
schöne => mooi
kieze => buurten
stadtteil => district
bäume => bomen
bekommt => krijgt
hell => licht; helder; klaar
verwandelt => getransformeerd
pinkeln => pissen; plassen; urineren
halt => genoeg; stop
frust => frustratie
geklingelt => rang
glasscherben => gebroken glas
euch => jullie; u; je; aan je; aan u; elkaar; jou; aan jou; aan jullie; naar je
altersheimen => oude heimen
bestimmt => zeker; vast; stellig; bepaald; gewis; duidelijk; ongetwijfeld; precies; vaststaand; helder
sämtliche => al; alle; allemaal; allen; alles
überdurchschnittlich => bovengemiddeld; buitengewoon; erg; heel
riesengroße => reusachtig
freiluftparty => outdoor party
erinnerung => gedenkteken; herdenking
wohne => leven
hälfte => half
nerven => aanstoot geven
wochenende => weekend
area => gebied
riesengroßes => groot
aufgelöst => verstoord
leider => helaas; jammer; jammer genoeg; tot mijn spijt; ongelukkigerwijs; tot onze spijt; o wee; ongelukkig; spijtig genoeg
bahn => trein
gefreut => tevreden
hafengeburtstag => haven verjaardag
beweinend => tranen
betrunkenen => dronken
gefühlten => waargenomen
schweinchenkostüm => varken kostuum
auswärtigen => buitenlands
dummerweise => domweg
spaß => plezier
diesen => deze
nachbarn => neighbours
stunden => aanhouden; uitstellen; verdagen; verschuiven; werken; achteruitgaan; achteruitlopen; afstaan; afwisselen; schelen
to => naar
fahre => rit
tauben => doof
böse => kwaad
vorbeilaufende => running verleden
seitdem => sinds; sindsdien; sedert; vanaf; dan; met ingang van; sinds dan; waarna
schauen => kijken; bekijken; zien; aanschouwen; blikken; toekijken; aangaan; betreffen; bezien; gelden
wochenenden => weekends
trinkgeld => tip
umgangsformen => etiquette
sitznachbarn => sedentaire buren
frohes => gelukkig
bricht => breaks
nutznießer => begunstigde
anwohner => omwonenden
zugänglich => toegankelijk; genaakbaar; bereikbaar
gegensteuer => tegen de fiscale
beraten => adviseren; aanraden; raden; beraadslagen; advies geven; overleggen; doordenken; overwegen; vergaderen; aanbevelen
eidgenössische => federaal
konzipiert => ontworpen
ohrenschmerzen => oorpijn
unterliegen => de nederlaag lijden
ausschliesslich => uitsluitend
bonifizierung => kilometerstand award
gesundheitskosten => kosten voor gezondheidszorg
leiter => hoofd
unklare => onzeker
handelt => deze
erfüllt => ontmoette
heini => houwen
zuverlässig => betrouwbaar; vertrouwd; degelijk; zeker; behouden; bona fide; geborgen; gewis; goedaardig; ongevaarlijk
nachweisen => aantonen; tonen
verschlüsselt => gecodeerde
aufzusuchen => bezoek
eigenverantwortung => persoonlijke verantwoordelijkheid
versprochenen => beloofde
feststellen => constateren
eingesehen => bekeken
vordringlich => urgent; spoedeisend
vorschnell => voorbarig; onbezonnen
empfehlung => aanbeveling
aufs => op
vitaldaten => vitale gegevens
abgegeben => ingediend
gesundheitswesen => gezondheidszorg
schweizerische => zwitsers
schweizer => zwitser
krankenversicherung => ziektekostenverzekering
check => controleren
getrieben => aangedreven
arztbesuche => artsenbezoek
erbringt => biedt
vorerst => vooralsnog; voorlopig
benötigen => nodig hebben; behoeven; vereisen; hoeven; moeten; vergen
aufnimmt => pikt
einzudämmen => beteugelen
heilmittelinstitut => remedie instituut
konsultieren => raadplegen
verunsicherten => onzeker
abzuwarten => te zien
eingegrenzt => beperkt
gesundheitsberatung => gezondheidsadvies
nötigen => dwingen; noodzaken; verplichten
leistungserbringer => zorgverlener
ärztlichen => medisch
anreize => prikkels
erklärt => gedeclareerd
verknüpfung => koppelen
gesunden => herstellen; genezen; helen; revalideren
veranlassen => doen; maken; laten; laten doen; aanrichten; teweegbrengen; veroorzaken; aandoen; stichten; aansporen
recherchen => onderzoek
erhalten => ontvangen; bewaren; krijgen; behouden; bergen; onderhouden; genieten; conserveren; overhouden; toucheren
unnötige => onnodig
einfacher => gemakkelijker
angegebenen => gespecificeerd
bereich => sektie
suchen => zoeken; opzoeken; uitkijken
hierzulande => dit land
ausserdem => ook
sportliche => sport-
meldepflicht => verplichte registratie
patientinnen => patiënt-
verschiedentlich => bij verschillende gelegenheden
geäussert => uitgedrukt
mithelfen => assisteren; baten; bijstaan
gemäss => volgens
fahrt => rit
notfallstation => spoedeisende hulp afdeling
existieren => bestaan
fühlen => voelen; aanvoelen; gevoelen; gewaarworden; tasten; betasten; bevoelen; geuren; rieken; ruiken
anforderungen => vereisten
vorgaben => zogenaamd
auskunft => informatie
lanciert => gelanceerd
sprecherin => woordvoerster
umständen => situatie
erhobenen => verzamelde
speichert => winkel
entsprechenden => overeenkomstig
bearbeitet => fijn
unaufhaltsam => onweerstaanbaar; onverbiddelijk
medizinischen => medisch
jetzt => nu; nou; thans; tegenwoordig; momenteel; heden; komaan
verunsichern => onzeker maken
gesetzlichen => wettelijk voorgeschreven
zunahme => toeneming
schritte => stappen
schweigepflicht => geheimhouding
gefahren => naar beneden
spital => ziekenhuis
arzt => doctor
aussage => verklaring
erhalte => krijgen
anhand => aan de hand van; aan hand van; n.a.v.; na aanleiding van
bestimmen => bepalen
indem => door; doordat; op; per
leistungsmerkmale => prestatiekenmerken
untersteht => rapporteert aan
einzig => alleen
systemgastronomie => gastronomie systeem
geschlechtes => voorgeslacht
filialen => takken
niederlassungen => takken
rechnet => verwacht
tritt => voordoet
vertritt => vertegenwoordigt
hauptversammlung => jaarlijkse algemene vergadering
geschäftsreise => zakenreis
aktien => aandelen
steuersenkungen => belastingverlagingen
börsengang => ipo
handel => handel drijven
gestiegen => toegenomen
befürwortung => voorspraak
pflegt => zorgen
herausgegeben => bewerkt
öffentliches => publiek
ermutigung => aanmoediging
gewandt => bedreven; rap; handig; lenig; vaardig; behendig; bekwaam; druk; kras; kwiek
wien => wenen
geschäfte => shops
heimat => thuis
kaufte => kocht
menge => lot
kundgebung => verzameling
mitgeteilt => gecommuniceerd
hochschulgebühren => collegegeld
weist => heeft
beabsichtige => van plan zijn
abgelehnt => verworpen; afgekeurd; gewraakt; veroordeeld
kursiert => lange jacht
herzen => in de armen drukken; in de armen nemen; knuffelen; omarmen
italienischen => italiaans
exchange => uitwisseling
diversität => verscheidenheid
ebenfalls => ook; eveneens; evenzeer; mede; tevens; evenzo; evenzoo; insgelijks; op gelijkaardige wijze; dezelfde
beaufsichtigt => overziet
verbundenen => verwant
bewerbung => toepassing
renditen => opbrengst
ansichten => bekeken
fett => vet; dik; corpulent; gezet; vettig; vetgedrukt; vetrijk; dikke; gezette; lijvig
beschäftige => transactie
weihnachten => kerstmis
genuss => behagen; pret; vermaak; welbehagen
aktualisiert => bijgewerkt
vergnügungsparks => pretparken
röstereien => branders
iger => sterkte
vollen => vol
räumte => toegekend
clinch => vastklinken
einzelaktionär => enkele aandeelhouder
sonderrolle => bijzondere rol
wörtlich => letterlijk
nimmt => neemt
eintritt => binnenkomst
verbindet => combines
firma => bedrijf
vollzieht => neemt
freies => gratis
aktie => aandeel
verbreitete => verspreiding
lasten => wegen
koste => elke prijs
trumps => troeven
inszeniert => geënsceneerd
executive => uitvoerend
zeitungsbeitrag => krant bijdrage
gesonnen => bedoeld; moedwillig; opzettelijk
gelingen => slagen; lukken; bloeien; floreren
becher => kop
rückzug => retraite
vergangenes => laatste
wahl => verkiezing
prominente => beroemdheid
eingeschworene => beëdigd
beruf => carrière
fairen => eerlijk
letzten => laatste
mitte => centrum
amt => kantoor
detailansicht => toon details
liebäugelt => speelde
wirbt => adverteert
defizite => tekorten
city => the city
aktionär => aandeelhouder
bezugsquellen => waar te kopen
sauer => zuur; kwaad; boos; wrang; scherp; nijdig; gebelgd; gram; lelijk; met opgestoken zeilen
chairman => voorzitter
jungen => jong
mögliche => potentieel
wachsende => groeiend
posten => bericht; boeken; plaatsen (een bericht)
sonderprojekt => speciaal project
gewarnt => gewaarschuwd
mied => vermeden
anhängern => sleutelhangers
aufnahme => opvang
entfernt => verwijderd; ver; weg; afgelegen; veraf; ververwijderd; heen; over; vandoor; verafgelegen
gedanken => geest
hochschuldabschluss => hoge schuldenlast statements
kette => schakelketting
diesmal => deze keer; ditmaal
dekaden => decennia
firmieren => onder de firmanaam; werken
einzustellen => aanpassen
kritisiert => gewraakt
voriges => voorgaand
hauskette => winkelketen
mangelhafte => ontoereikend
hauptinsel => huis eiland
urlaub => vakantie
häufen => stapelen; opeenhopen; ophopen; opstapelen; opeenstapelen; tassen; accumuleren; collecteren; innen; inzamelen
ausgebaut => uitgebreid
zwangsläufigen => onvermijdelijk
vorjahreszeitraum => periode vorig jaar
flugpläne => vliegplannen
stöhnt => gekreun
himmel => hemelgewelf
heftige => hevig
sommerflugplans => onze zomerdienstregeling
einheitliches => uniform
umbau => conversie
schätzt => ramingen
flüge => vluchten
zwar => wel; zeker; weliswaar; bepaald; immers; toch; vast; namelijk; wel degelijk; al
spät => laat; late; vergevorderd; te laat; achter zijn; achterlopen; over tijd zijn; te laat zijn
nachlass => vermogen
umlackiert => herschilderd
schickten => verzonden
oft => dikwijls; vaak; veelal; gedurig; veel; menigmaal; veeltijds; veelvuldig; frequent; dikwerf
front => voorzijde
gestrichen => geannuleerd
reisesommer => zomer reizen
zusätzlichen => extra
akten => bestanden
gute => goed
einheitliche => uniform
einiges => een of ander; een of andere; enigerlei
dauer => tijd
mieten => huren; aannemen; aanwerven; afhuren; charteren; in dienst nemen; tewerkstellen; huur; inhuren; rent
märz => maart
gleichfalls => eveneens; insgelijks; evenzeer; ook; mede; van hetzelfde; idem; even; evenzo; op gelijkaardige wijze
mieses => beroerd
vorgehalten => gehandhaafd
analyse => ontbinding
warnte => gewaarschuwd
ausständen => werkonderbrekingen
nachricht => mare; nieuwigheid; nieuwtje
fluglotsen => luchtverkeersleiders
flugreisende => vlucht reizen
touristikerin => toerisme expert
flugausfälle => mislukkingen vlucht
aussichten => vooruitzicht
privatunterkünften => privé accommodatie
vermietung => huur
flugbetriebs => vliegoperaties
privatunterkünfte => homestay
gewechselt => veranderd
befürchten => duchten; bang zijn voor; schromen; vrezen; terugschrikken voor; bang maken; beangstigen; verschrikken; vrees aanjagen; verwachten
voraussichtlich => waarschijnlijk; vermoedelijk
einheimische => lokaal
preisverfalls => ineenstorting van de prijzen
hemmnissen => barrières
beteiligung => deelname
hauptstadt => hoofdletter; kapitaal
dach => dakconstructie
unwettern => stortbuien
crews => bemanningen
schwere => ernstig
luft => antenne
gestiegenen => toegenomen
air => lucht
billigflieger => low cost
fliegt => vliegen
teilzuhaben => deelnemen
überfordern => overbelasten
genäht => ingenaaid
umgemeldet => opnieuw geregistreerd
riegel => bout
beschäftigten => werknemers
sitze => zetels
arbeitnehmer => werknemer
pleite => blut; failliet; platzak
ausfälle => verliezen
airlines => luchtvaartmaatschappijen
holprigen => hobbelig
überangebot => overschot
flugverspätungen => vertragingen van vluchten
geschäftsführer => directeur
fordert => driften
französischen => frans
angebote => specials
stehenden => staand
arbeitsniederlegungen => werkonderbrekingen
rheinischen => rijn
tochtergesellschaft => dochtermaatschappij
flugzeuge => vliegtuig
ziel => doelpunt
zugeschnittenen => toegesneden
nachfrage => vraag
weitergeht => blijft
schiebt => shoves
kommenden => komst
wachstumsprobleme => groeiproblemen
unterschiedliche => verschillend
gleichberechtigung => gelijkheid
zelebrieren => vieren
geldausgeben => zakgeld
vollständige => vol
verwirklichte => besefte
verletzt => geblesseerd; gekwetst; gewond; pijn doen; zeer doen
führungskräfte => managers
beklagt => klaagt
bereichen => gebieden
verbreitet => algemeen; gewoon; normaal; gezamenlijk; heersend
morgige => morgen
derselben => hetzelfde
voranbringen => bevorderen
geschickt => bedreven; handig; bekwaam; behendig; vaardig; geschoold; slim; capabel; competent; deskundig
müttern => moeders
schwebte => dreef
heldentaten => feats
bundesjustizminister => federaal minister van justitie
raumfahrtbehörde => ruimtevaart autoriteit
epochaler => tijdperk-
pflicht => verplichting
kampf => vechten
presseagentur => persbureau
anschliessend => vervolgens
geschäftsführende => beheren
gutscheine => coupons
gegründet => gesticht
ausnahme => uitzondering
verärgert => boos; kwaad; geërgerd; geërgerde; verbolgen; gebelgd; gram; lelijk; met opgestoken zeilen; op hoge poten
gefühlt => vilt
winkte => gegolfd
frauenland => vrouw land
benachteiligt => misdeeld; benadeeld; kansarm
anregung => stimulatie
berufsleben => professionele leven
häusliche => thuis
früheren => vroeger
vereinnahmt => erkend
verwirklicht => besefte
mehrheitlich => meerderheid
umbenannt => hernoemd
weibliche => vrouw
rabatte => kortingen
schwerelosigkeit => gewichtloosheid
mission => christelijke zending
gestaltet => ontworpen
veranstalten => aanrichten; arrangeren; ordenen; ondernemen; organiseren; regelen; terechtbrengen; aanpassen; accommoderen
schritt => stap
agentur => agentschap
veranstaltungen => events
demonstrieren => aantonen; bewijzen; betogen
frauenrechte => de rechten van vrouwen
begangen => toegewijd
wichtigkeit => belang
zeichen => karakter
weltall => heelal
justizminister => minister van justitie
passend => geschikt
benannt => genoemd
uhr => horloge
zwangsheirat => gedwongen huwelijk
weltraums => de kosmische ruimte
feiertag => feest- en gedenkdagen
erde => aarde
beliebter => populair
türkei => kalkoen
charme => betoveren
händler => handelaar
ausgabe => editie
pries => geprezen
etappensieg => stadia zegevierende
rechtliches => wet
bereit => klaar; gereed; af; afgelopen
heisst => middelen
kosmetik => schoonheidsmiddelen
darauf => dan; daarna; achteraf; naderhand; vervolgens; derhalve; dus; bijgevolg
los => nu; kom; kom op; vooruit; zonder; kom aan; start!; vlug een beetje; vooruit!
grüsse => groeten
fahnen => vlaggen
frauenwahlrechts => vrouwenkiesrecht
lohnunterschiede => loonverschillen
sozialdemokratin => socialistisch
türken => waggelen
arbeitswelt => werkende wereld
unseren => onze
liess => links
traum => dromen
testeten => getest
entdeckung => detectie
geschluckt => slikte
reiner => zuiver
her => hierheen; geleden
medikament => drug
erfolgsgeschichte => succesverhaal
bluthochdruck => hoge bloeddruk
ließ => was
ausblieb => nagelaten
eins => een; één
berichteten => gerapporteerd
pharmaunternehmen => farmaceutische bedrijven
wirkstoff => werkzame stof
gewinne => overwinning
bedeutete => betekende
patent => kloek; scherpzinnig; slim
probanden => proefpersoon
häufigeren => vaker
milliardenhöhe => de miljarden
nebeneffekt => bijwerking
pille => pil
wirkstoffes => agent
meldete => gerapporteerd
zufall => geval; kans
botschaft => nieuwigheid; nieuws; nieuwtje
massenausweisung => massale verdrijving
bald => spoedig; binnenkort; weldra; gauw; dra; straks; alras; haast; welhaast; dadelijk
ausweisung => verdrijving
giftanschlag => vergif stop
jeweiliges => respectief
ausweisen => verjagen; uitdrijven; verdrijven; wegdrijven; wegjagen; uitzetten
giftangriff => gif aanval
wichtigen => belangrijk
wirtschaftsfaktor => economische factor
feierfreudige => viering vreugdevolle
springbreak => voorjaarsvakantie
alkoholkonsum => drinken leeftijd
yucatánhalbinsel => yucatan peninsula
mindestalter => minimumleeftijd
hause => thuis
richtig => juist; correct; goed; rechtvaardig
pilgerten => bedevaart
liebsten => favoriet
bisher => tot nu toe; tot dusver; nog; nog steeds; tot dusverre; tot hiertoe; dusver; tot dan toe; tot zover; totnogtoe
regime => bewind
wirtschaftliche => economisch
balanceakt => evenwichtsoefening
unabdingbar => noodzakelijk; onvermijdelijk; beslist noodzakelijk; essentieel; onmisbaar; onontbeerlijk; onvervreemdbaar; volstrekt
gebildet => geleerd; ontwikkeld; knap; geletterd; belezen; erudiet; samengesteld; wijs; academisch; akademisch
ausgeübt => uitgeoefend
zusammenarbeit => samenwerking
löse => solvent
amtiert => official
gehüllt => verpakt
starkgemacht => gesterkt
heikler => delicaat
allianz => bondgenootschap
stärker => meer
meinung => advies
partner => associé; deelgenoot; lid
kooperation => samenwerking
ernstfall => ernstig geval
deklaration => verklaring
wichtige => belangrijk
versprochen => beloofd; toegezegd
stelle => plaats
zuzugehen => uitstrekken
grossen => groot
ungelegen => niet van pas komend
wende => beurt
widerwillig => met tegenzin; onwillig; schoorvoetend; aarzelend; grommend; weerbarstig
höchst => bijzonder; danig; duchtig; geducht
heftig => fel; scherp
eng => nauw
hinter => achter; na; aan; over; na verloop van; achterste; achteraan; vanachter; waarachter; achterna
jüngst => recent; onlangs; voor; kortgeleden; kortelings; laatst; recentelijk; jongstleden
enge => dicht
ausgesprochen => eminent; voortreffelijk
wahlen => verkiezingen
krisenherde => crisis hotspots
fühlt => voelt
entschärfung => onschadelijk maken
umso => des te
auffällig => opvallend; treffend; opzichtig; sprekend; afzichtelijk; voyant; markant; prominent; opmerkelijk; opmerkenswaardig
siegreichen => zegevierend
verflechtung => verweving
bekämpfung => vechten
bündnispartner => alliantiepartner
kulissen => achtergronden
einzusetzen => te gebruiken
versuchte => beproefd
tendenzen => trends
lösung => solutio
gemeinsamen => gemeenschappelijk
zugesetzt => toegevoegd
wichtiger => belangrijk
verbündeten => bondgenoot
beziehungen => relaties
engen => smal
einknicken => gesp
beschlossen => afgesproken
setzte => zat
einmischt => bemoeizucht
gewährt => toegekend
verhängten => opgelegde
womöglich => wellicht; misschien; mogelijk; allicht; vast; waarschijnlijk; wel; zeker
angelegenheiten => zaken
droht => bedreigt
haftbefehl => bevelschrift
kurzbotschaftendienst => short ambassade dienst
veröffentlichung => vrijlating
botschaftsexil => ambassade ballingschap
enthüllungsplattform => openbaring platform
vertretung => vertegenwoordiging
gekappt => afgetopte
dokumente => papieren
verstossen => beledigen
sperrte => opgesloten
prozess => geding; gerechtszaak
massnahme => meten
schuldzuweisungen => schuld opdrachten
entgehen => vermijden
infrage => ondervraagd
befürchtet => vreesde
mitgegründete => mede-oprichter
asyl => toevlucht
giftanschlags => gif aanval
bewährungsauflagen => parole pads
begründung => terrein
inneren => binnenste
kappt => bezuinigingen
aussenwelt => buitenwereld
überstellt => overgebracht
hiess => heette
kurzzeitig => kort; kortdurend; kortlopend
gedrängt => beknopt; bondig; dicht; dik; gebonden; kernachtig; kort; summier; zakelijk
before => voor
our => onze
hätten => had
äußerte => uitgedrukt
inhaber => exploitant
gesenkten => verlaagde
botenjungen => aangeboden jonge
boy => jongen
are => zijn
profitiert => voordelen
stützte => bijgestaan
benutzen => gebruiken; aanwenden
hinsichtlich => aangaande; qua; inzake; over; t.o.v.; ten opzichte van; betreffende; wat betreft
aktienkurs => koers van het aandeel
with => met
geäußert => uitgedrukt
pay => betalen
weißen => bleken; wit maken
unlike => anders
delivery => levering
führe => leiden
erwäge => aangezien
zahlen => betalen; dokken; storten; uitbetalen; uitkeren; voldoen; afrekenen; lonen
kurswechsel => koerswijziging
steuerliche => belasting
börse => aandelenmarkt
election => verkiezing
my => mijn
gesagt => verteld
others => anderen
have => hebben
quellen => vloeien
einzelhändler => kleinhandelaar
staatsoberhaupt => staatshoofd
wiederholt => herhaaldelijk; nogmaals; meermaals; telkens; weder; van voren af aan; weer; alweer; wederom; alweder
taxes => belastingen
of => van
tremendous => enorme
zeitweise => fluctuerend; intermitterend; met; periodiek; tussenpoos; wederkerend
wirft => raises
verfeindet => vijanden
eingebrochen => kelderde
causing => het veroorzaken
putting => zetten
pranger => schandpaal
use => gebruik
vortag => de dag voor
little => weinig
geklagt => klaagden
concerns => zorgen
niedergang => nadagen
wirtschaftlichen => economisch
kursierten => gecirculeerd
loss => verlies
zuletzt => ten laatste; tenslotte; ten slotte; eindelijk; uiteindelijk; laatste
the => de
drehte => gedraaid
they => zij
their => hun
einzelhändlern => individuele dealers
stated => bepaald
many => veel
zog => drew
thousands => duizenden
berichte => rapporten
bundesebene => federaal niveau
bestehende => bestaand
uneingeschränkten => onbeperkt
umwandeln => veranderen; omzetten; vermaken; wisselen; assimileren; in zich opnemen; kenteren; transformeren; verkeren; converteren
umgewandelt => geconverteerde
eheschließungen => voor sluitingen
eingetreten => plaatsgevonden
waage => weegschaal
umfrage => overzicht
sprecher => omroeper
gaben => gaf
völlige => compleet
geschlossen => dicht
jeweils => telkens; elk; elke
letzte => achterste; jongstgeleden; laatst; laatste; vorig; jongste; juist gebeurd; meest recente
standesamtsleiterin => standesamt hoofd
schwulenverbands => gay union
standesämter => civiele kantoren
umwandlungen => conversies
umwandlung => conversie
eingetragenen => geregistreerd
hervorgeht => evident
taten => deden
märzwoche => mars voor weken
hochzeitspartys => bruiloften
heterosexuelle => hetero
ehen => transactie
begrüßt => verwelkomt
gerechnet => verwacht
neu => nieuw; recent; vers; fris; luchtig; onbedorven; opkomend; actueel; opnieuw; weer
standes => artikel
ansturm => woeste aanval
gleichstellung => gelijkheid
fürs => voor
standesamt => burgerlijke stand
feierten => beroemd
bund => federatie
ließen => kon
bezirksämtern => districtskantoren
eingetragene => geregistreerd
warteten => wachtte
amtsleiterin => hoofd van het kantoor
jahrestag => verjaardag
glaubt => gelooft
leidenschaft => passie
nähe => buurt
tode => dood
kämpfer => vechter
aufschauen => opkijken
freue => kijk
versteht => begrijpelijk
gemeinsamkeiten => gelijkenissen
bestohlen => beroofd
angerufen => riep
weitergeben => doorgeven; communiceren; delen; mededelen; verdelen; doorvertellen
sicher => zeker; veilig; stellig; vast; gewis; ongevaarlijk; wis; vaststaand; verzekerd; ongetwijfeld
brauche => nodig hebben
halle => foyer
weltfrieden => universele vrede
ausnahmetalent => uitzonderlijk talent
passiert => gebeurd
angesehen => prestigieus; aanzienlijk
gebeten => gevraagd
gewachsen => gegroeid
transparenter => doorzichtig
angefangen => begonnen
kerngeschäft => kerntaak
anfängen => begin
schweife => afdwalen
tiefen => diep
außergewöhnlicher => uitzonderlijk
vertrag => aanbesteding; samentrekken
on => op
geholt => bracht
exil => ballingschap
worum => over wat
jahrzehnte => decennia
aufbauen => bouwen; construeren; aanleggen; aanmaken; maken; bedrijven; doen; fitten; installeren; uitbrengen
guter => goed
unbedingt => per se; absoluut; beslist; onvoorwaardelijk; bepaald; onmisbaar; onvermengd; strikt; volstrekt; vooral
bruch => breken; wrongel
möchte => zou willen
aussahen => keek
jungle => oerwoud
überlegenheit => superioriteit
existiert => er
verändert => afwijkend; afwisselend; anders; variërend; verschillend; wisselend
teppich => tapijt
erreicht => voldaan; voldane; voltrokken
regelte => gereguleerd
kamen => kwam
fernsehen => teevee; televisie kijken; televisiekijken; tv; tv-kijken; tv kijken
vermarktet => markten
ahnen => vermoeden; doorzien; gissen; raden; verdenken; voorzien
abgemacht => verrekend
seinetwegen => door hem
hilfreich => behulpzaam; hulpvaardig; hulp-
täufer => doper
schuhe => schoenen
promoten => bevorderen
weitergebe => doorgeven
vermögen => kunnen; mogen
wesen => zijnde
frieden => vrede
gesammelt => verzamelde
guten => goed
friedensbotschafter => vrede ambassadeur
gott => god
genauer => precies
zueinander => elkaar
gesteckt => aangesloten
diener => bediende; knecht; hulpje
seltensten => zeldzaamste
verstanden => begrepen; ontvangen
glauben => geloven; menen; denken; houden voor; vermoeden; aannemen; agnosceren; erkennen; geloven in; honoreren
gestürzt => omvergeworpen
aufgewachsen => opgegroeid
unvorhersehbar => onvoorspelbaar
sofort => meteen; dadelijk; aanstonds; onmiddellijk; zo; subiet; direct; op staande voet; schielijk; ogenblikkelijk
jahrhundertlang => eeuwenlang
woran => waardoor
promotet => bevorderd
hattet => je had
erfahrung => ondervinden
straßen => wegen
wieviel => hoeveel; hoezeer; inzoverre; voorzover; hoeveelste
herausschreien => shout out
prophezeiung => voorzegging
leichter => gemakkelijker
stimmt => klopt
meister => kampioen
dunkelhäutige => donker
zusammengeschlossen => samen
begriff => term
scheitern => falen; mislukken; stranden; feilen; onderuitgaan; aborteren; een miskraam krijgen; floppen; in het water vallen; ontijdig bevallen
gelitten => leed
bigotterie => kwezelarij
runter => beneden; afwaarts; benedenwaarts; naar beneden; neerwaarts; omlaag; terneer; neer
geleistet => gedaan
gesamtpaket => compleet pakket
dich => jou; je; jij; u; aan je; aan jou; jijzelf; jullie; uzelf
oh => o
wert => waardig; waar; duur; eerzaam; prijzig; waard; dierbaar; kostbaar; waardevol; geacht
stürzen => omverwerpen; mieteren
ständig => permanent; voortdurend; continu; onophoudelijk; eeuwig; constant
wortes => , woord
irgendjemandem => iedereen
boxsport => boksen
sachen => dingen
reden => spreken; praten; converseren; overleggen
bemerkenswerte => opmerkelijk
unkontrollierbar => ongecontroleerd
geblieben => bleef
einzustehen => opstaan
schaue => kijk
froh => blij; verheugd; vrolijk; verblijd; gelukkig; tevreden; blijd; vergenoegd; voldaan; bevreugd
getrampelt => vertrapt
geführt => uit
komme => krijgen
kämpfen => strijden; vechten
kämpft => gevecht
ruhe => vrede
heimatstadt => hometown
solange => terwijl
leuten => mensen
stehe => ben
anstrengend => inspannend; zwaar; uitputtend; vermoeiend; moeizaam; afmattend; gespannen; hard; ingespannen; pakkend
unsinn => onzin
vorgesetzt => honk
gezwungen => artificieel; gekunsteld; gemaakt
tiefgründige => diepgaand
daraus => hieruit
spaltung => splijting
geboxt => boxed
tut => doet
aufzugeben => laten
gekehrt => gedraaid
lautet => leest
brauchte => nodig
job => plaats; werkkring
rumble => gerommel
treten => schoppen; trappen; lopen; stampen; gaan
massen => omvang
aufschlussreiche => inzichtelijke
rückschläge => tegenslagen
unabhängig => onafhankelijk; vrij; absoluut; autonoom; onvermengd; onvoorwaardelijk; puur; volstrekt; zelfstandig; zuiver
knast => slammer
lieben => houden van
chance => gebeurtenis; geval
vorher => vroeger
antrieb => aandrijving
fuhr => dreef
ereignete => plaatsgevonden
unfälle => ongevallen
gesorgt => voorzien
fahrer => bestuurder
model => mal; maquette; patroon; toonbeeld; voorbeeld
fussgängerin => voetganger
autopiloten => automatische piloot
ums => gedood
unfalls => ongeval
schlagzeilen => headlines
assistenzsystem => hulpsysteem
fahrbahnbegrenzung => rijbaan limiet
gelenkten => geleide
rücken => duwen; stoten; douwen; dringen; aandrijven; aanduwen; drijven; opjagen; schuiven; voortdrijven
warnung => waarschuwing
bundesweiten => landelijk
polizeiangaben => politie toelichtingen
fahrzeugs => voertuig
entscheidend => beslissend; cruciaal; afdoend; doorslaggevend; stringent; definitief; essentieel; onherroepelijk; van overwegend belang; vast
stiess => toegetreden
überfahren => overrijden
unfall => toevalligheid
erfasst => gedetecteerd
tödlichen => dodelijk
sicht => kijk; droombeeld; visioen
fehlfunktionen => storingen
untersucht => onderzocht
stand => loods
mitteln => voorleggen
uber => over
ähnliche => soortgelijk
zufolge => volgens; ingevolge; ten gevolge van
polizeichef => sheriff
nordnigerianischen => het noorden van nigeria
nahrungsmittelhilfe => voedselhulp
teenageralter => tieners
uno => één
mädchen => meisje
angriffen => aangevallen
etliche => enkele; een paar; enige; sommige; wat; verscheidene; verschillende
anschläge => beroertes
nahe => dichtbij; nabij; aanstaand; eerstvolgend; komend; naderbij; daarnaast
verübt => gepleegd
gesprengt => opgepakt
ortschaft => dorp
verschleppt => gedeporteerd
zumeist => meestal; hoogstens; maximaal; ten hoogste
anschlägen => aanvallen
schülerinnen => leerlingen
angewiesen => vertrouwend
bundesstaat => federale staat
gerissen => listig; listige; uitgekookt; doortrapt; geslepen; glad; leep; list en bedrog; pienter; scherpzinnig
verschleppte => gedeporteerd
mitgerissen => meegevoerd
getötet => gedood
örtlichkeit => plaats
verschüttet => morsen
strassen => wegen
stürzten => overhaast
dutzend => dozijn
suchten => gezocht
felsbrocken => kei
vorbeifuhr => reed door
bahnlinie => lijn
herausfinden => uitvinden; uitzoeken; te weten komen; uitvissen; doorhebben; er achter komen; onderzoeken; ontcijferen; ontdekken; uitvogelen
norditalienischen => noord-italië
unbestimmte => onbepaald
meis => masters
absturzgebiet => crash gebied
fahrzeuge => rollend materiaal
gemeinde => gemeenschap
bergsturz => mountain val
unterbrochen => kapot
ausreichend => voldoende; genoeg
vergrößerung => hoekvergroting
größere => meer
verdaulichkeit => verteerbaarheid
geringeren => lager
frühen => vroeg
zweifelsohne => ongetwijfeld; zeker; bepaald; ontwijfelbaar; onverdacht; zonder twijfel
beliebtheit => populariteit
rohkostszene => raw food scene
energiemangel => energie tekort
hingabe => toewijding
recherchierten => onderzocht
luftanteil => lucht aandeel
verwerten => benutten; gebruiken; aanwenden; toepassen; aanbrengen; aandoen; aantrekken; aanzetten; doen; doorvoeren
gift => vergif
gelatinierung => verstijfseling
völkern => overpopulate
pflanzenkost => installatie kostbaar
pflege => zorg
wertvolles => waardevol
völlig => compleet; totaal; volkomen
verdaulicher => verteerbaar
abgesehen => uit elkaar
entschieden => beslissend; cruciaal; finaal; overtuigend; uitgemaakt; beslist; vastberaden; voldongen; onherroepelijk; onverbiddelijk
kursieren => circuleren; in omloop zijn; omgaan; rondgaan; rouleren
erfordern => vereisen; eisen; vergen; opeisen; rekenen; voorschrijven
proteinen => eiwitten
untersuchten => onderzocht
gleicher => dito; identiek; -zelfde; gelijkmatig; identiek gelijk; ‐zelfde
verdauliches => verteerbaar
größe => afmeting
begrenzte => beperkt
brustkorbs => borstkas
deutet => aangegeven
rohköstler => raw food
sozialleben => het sociale leven
werkzeug => gereedschap
bilden => kweken; opvoeden; vormen; grootbrengen; opleiden; dresseren; beschaven; civiliseren; bouwen; formeren
ermöglicht => toestaat
hinterkopf => achterhoofd
gebisspflege => kunstgebit zorg
streifzug => zwerftocht
litten => leed
verkleinerung => reductie
hochkalorische => calorierijke
verarbeitung => processing
ernährung => voedingsleer
weiches => zacht
erklärungen => declaraties
metabolischen => stofwisselings-
gänzlich => geheel; heel; helemaal; totaal; finaal; volkomen; volledig; compleet; ten volle; totaliter
frühe => vroeg
entspricht => correspondeert met
geschieht => gebeurt
wissen => weten; kennen; kennis; kunnen
heutigen => vandaag
daher => vandaar; daarom; daar ... vandaan; daarvan
verfügbare => beschikbaar
roh => rauw; grof; onbewerkt; onbehouwen; ruw; bot; cru; ruig; snauwerig; rauwe
geräte => apparaten
verknüpft => samenhangend
mixern => blenders
gesamtbild => totaalbeeld
naheliegt => ligt in de buurt
verfügen => decreteren; verordenen; beschikken over; disponeren; voorschrijven
verzehren => consumeren; slopen; verbruiken
verarbeitete => verwerkte
verdauung => digestie
energiequelle => energiebron
mühlen => molens
erheblich => belangrijk; aanzienlijk; erg; ernstig; voornaam; aanmerkelijk; zwaar; geruim; zwaarwichtig; beduidend
gleiche => dito; identiek; -zelfde; gelijkmatig; identiek gelijk; ‐zelfde
täglichen => dagelijks
deswegen => daarom; dus; bijgevolg; daardoor; derhalve
untersuchungen => onderzoeken
veganen => veganistisch
häufiges => veelvuldig
erfolgreichste => geslaagd
sowohl => zowel; zoowel
verstopfung => constipatie
unverarbeitet => onverwerkte
fesselnder => engrossing
nährstoffmängel => tekorten aan voedingsstoffen
grundsätzlich => in principe; principieel; in beginsel; fundamenteel; essentieel; grond-; hoofd; hoofd-; hoofdzakelijk; onmisbaar
erhöhung => toenemen
abstruse => diepzinnig
nährstoffreich => voedzaam
gemüse => groenten; plantaardig
hilft => helpen
verarbeiten => verwerken; assimileren; in zich opnemen; gebruiken; poortnummer; proces
zeitpunkt => tijd
kranialkapazität => schedelcapaciteit
physikalische => fysiek
evolution => ontwikkeling
proteinvergiftung => eiwit vergiftiging
somit => bijgevolg; zodoende; dus; mitsdien; daarom; daarvoor; ergo; ook weer
rohform => ruw
ernähren => voeden; onderhouden; eten geven; voederen; voedsel geven; voeren
hochwertigen => hoge kwaliteit
artgerecht => humaan
energiereichen => energie
ließe => kon
lebensmittel => etenswaar
durchbruch => doorbraak
kalorienzufuhr => calorie supply
todbringendes => dodelijk
buchtipp => boek tip
zähne => gebit
datenlage => gegevensbeheer
gehirn => hersenen
verarbeiteter => verwerkte
stärkehaltiges => zetmeelrijke
höchstens => evenmin als
ganzjährig => eeuwig
entscheidender => kritisch
obst => fruit
prinzip => beginsel
fleisch => vlees
feuer => vuren; vuurzee
rohen => rauw
unserem => onze
einnahme => het nemen
energiegewinn => energieproduct
teuren => duur
weizen => tarwe
liefert => biedt
unverarbeiteter => onverwerkte
unnatürlich => artificieel; kunstmatig; gekunsteld; gemaakt; gewrongen; nagemaakt
nahrungsmittel => eten
diversen => verscheidene
erklärung => uiteenzetting
weicher => zacht
unkenntlichkeit => onherkenbaar
bekämen => zou krijgen
erhält => ontvangt
verwendung => gebruik
beeinträchtigen => schaden; benadelen; deren; beschadigen; belemmeren; havenen; schenden; bederven; beïnvloeden; compromitteren
effizienten => doeltreffend
derweil => ondertussen; intussen
durchschnittlich => gemiddelde; gemiddeld; middelmatig; modaal
willenskraft => wilskracht
nahrungseinnahme => voedselopname
versorgung => levering
rohköstlern => raw-foodists
argumentiert => debatteert
täglich => dagelijks; alledaags; daags; alledaagse; banaal; dagelijkse; gewoon
verdauungssystem => spijsverteringsorganen
entsprechende => geschikt
begleitete => vergezeld
nahrung => eten
gemäß => volgens; blijkens; ingevolge; naar; langs; overeenkomstig; naargelang; op; passend; uit hoofde van
chemische => droog
verbraucht => uitgeput; afgedragen
lebenden => leven
rohe => rauw
kochbananen => bakbanaan
zwecks => ten behoeve van
ausgezeichnet => excellent; uitmuntend; uitstekend; voortreffelijk; kostelijk; tiptop; tof; schitterend; gelauwerd; geweldig
gründen => stichten; oprichten; vestigen
einfachere => eenvoudigere
bevorzugen => prefereren; verkiezen; de voorkeur geven aan; voortrekken
reine => zuiver
leicht => gemakkelijk
anhänger => aanhangwagen
erleichtern => vergemakkelijken
beliebtere => meer populair
dahinter => daarachter; kont; na; over; terug; zitvlak
ansatz => embouchure
verdrängt => onderdrukt
einsetzt => toepassingen
konzerne => bedrijven
nachbarschaft => buurt
netz => netwerk
rückkehr => terugkeer
gebaut => gebouwd
geschäftsmodelle => business modellen
zuzulassen => vergunning
geworben => geadverteerd
star => filmster
einzelnen => elk
wählt => selecteert
wertvollsten => meest waardevolle
betrachtet => beschouwd
selbstverständnis => zelfbeeld
beschleunigungsspur => invoegstrook
ziele => doelen
vorherrschaft => suprematie
einzuhalten => voldoen
datenautobahn => datasnelweg
zusatzprogramme => extra programma's
add => toevoegen
galt => was
grundlegender => basis-
nuller => noughties
explorer => ontdekkingsreiziger
internetkonzern => internet group
offenes => beperkt
abgelaufen => vervallen
kopf => bovenkant
geschüttelt => geschud
haag => den haag
verzahnung => tandwieloverbrenging
solchen => zo'n
zuge => toegevoegd
standort => vestigingsplaats
rüstungsprojekten => bewapening projecten
luftwaffe => luchtmacht
umziehen => verhuizen; omkleden; bewegen; uitwijken; zich omkleden
absprachen => geheime verstandhouding
fortan => in het vervolg; van nu af aan
einsatzbereitschaft => bereidheid
dauerhaft => duurzaam; blijvend; permanent; bestendig; constant; solide; stabiel; voorgoed; voortdurend; aanhoudend
militärkooperation => militaire samenwerking
durchhaltefähigkeit => door te oordelen vermogen
ort => plaats
beteiligten => betrokken
gepard => cheetah
flugabwehrpanzer => luchtafweer armor
niedrig => laag; lage
angehenden => ontluikende
abbrecherquote => uitvallers rate
elke => anjer
höher => superieur; opperste; prevalent; bovenste
kargen => kaal
durchzusetzen => afdwingen
abbrecher => verlaters
ausbildung => opvoeding; vorming
schmeißt => gooi
berufsausbildung => beroepsopleiding
berufsbildungsbericht => vet-rapport
vizechefin => vice-baas
vorgelegt => ingediend
berufung => appelleren
abbrecherquoten => uitval
fachangestellte => professionele medewerkers
üblichen => gebruikelijk
sicherheits => veiligheid
friseure => kappers
liege => ligstoel
mindestvergütung => minimumloon
verwaltung => beheer
gewerkschaftsbundes => 'federation
ausbildungen => opleidingen
zügig => snel; vlot; gierzwaluw
prüfung => tentamen
fachkräften => professionele krachten
niedrigsten => laagste
mordprozess => moorddadige proces
seltsam => vreemd; raar; eigenaardig; merkwaardig; bizar; curieus; gek; rare; typisch; vreemde
engere => dichterbij
mitfühle => sympathiseren
solcherlei => dit soort
schriftliche => geschreven
funde => ontdekkingen
angeklagten => beschuldigde
düstere => somber
seele => ziel
gestanden => geweest
eingeladen => uitgenodigd
zufälligerweise => toevallig
bord => inschepen; schildzoom
vorgeworfen => beschuldigde
gegoogelt => googled
fachleute => professionals
dritte => derde; derde partij
schwedische => zweeds
themen => topics
boots => laarzen
tüftler => knutselaar
dunkle => donker
kennengelernt => ontmoette
reichten => varieerden
abgibt => releases
mittelpunkt => centrum
tour => rondreis
ausgesagt => getuigde
damalige => dan
ausschnitte => uitsnijdingen
vorgestellt => denkbeeldig
zeugin => getuige
dokumentation => documentatiesysteem
listete => opgesomd
gutachten => verslag
walls => wanden
letztlich => ten slotte; tenslotte
vorgeführt => gedemonstreerd
fehlt => vermist
schwachen => zwak
zerstückelt => uiteengereten
urteil => veroordeling; zin
inhalt => inhoud
prozesstag => de proef
einladen => uitnodigen; inviteren; vragen; noden
fortgesetzt => permanent; voortdurend; aldoor; alsmaar; onafgebroken; altijddurend; blijvend; doorlopend; eeuwig; gedurig
urwaldmotivs => jungle motief
stream => beek
bewohner => ingezetene
wohnt => levens
postschalter => postkantoor teller
dorfläden => dorpswinkels
anklang => goedkeuring
wohnüberbauungen => woonwijken
kirche => kerk
vereine => verenigingen
löst => triggers
ziehen => trekken; kweken; slepen; dresseren; grootbrengen; opleiden; opvoeden
holztisch => houten tafel
möglichst => zo ... mogelijk; indien mogelijk; mogelijk
hängt => hangt af
wodurch => waardoor; waarmee; waarbij
doppelt => dubbel; tweeledig; tweevoudig; duplex; tweemaal
challenge => uitdaging
neubauten => nieuwe gebouwen
kirchgemeinde => kirch community
errichtet => opgetrokken
schweift => sweeps
jahrtausendwende => draai van het millennium
austausch => uitwisseling
unterschriften => ondertekenen
bilder => foto's
älterer => ouderen
saal => hal
riesenpuzzle => gigantische puzzel
herauszufinden => uit
fünfundachtzig => vijfentachtig
verein => club
schweren => ernstig
zweitgrösste => op een na grootste
schild => wegwijzer
draussen => buiten
farben => kleuren
möchten => mogen; willen; zouden graag willen
passendes => geschikt
verteilte => gedistribueerde
zeugnis => getuige
eingeschult => school ging
jugendarbeit => jeugdwerk
hängte => zweven; hangen
älteste => oudst
schwarzen => zwart
zusammenzusetzen => weer in elkaar
kleben => lijmen; plakken
durfte => kon
gelegen => gemakkelijk; geschikt; doelmatig; gepast; passend
gymnasiast => schooler
hergestellt => gemaakt
konzentriert => aandachtig
halbstundentakt => half-uursegmenten
eingepasst => gemonteerd
live => rechtstreeks
schwinden => tanen; verdwijnen; krimpen; smelten
interaktion => wisselwerking
beschränkt => afgestompt; begrensd; beperkt; stom; dom; eindig; leeghoofdig; onnozel; simpel
gewachsenen => grown
angebot => bieden
antwortet => reageert
gegenmittel => tegengif
erprobt => bewezen
restlichen => overblijvende
lücken => hiaten
jan => januari
mitgenommen => nam
rand => grens
begegnungsorte => ontmoeting locaties
riesige => reusachtig
dorfgespräch => dorp talk
ausstellen => etaleren; tentoonstellen; blootstellen; uitbrengen
engagieren => boeken
türe => deur
plakat => poster
teile => onderdelen
geliefert => afgeleverd
ergeben => aanhankelijk; gehecht; toegenegen; opofferingsgezind; aangeven; leveren; aanbrengen; afleveren; bestellen; in de steek laten
lebt => levens
vermehrt => toegenomen
streifen => beroeren; zwerven; aanroeren; aanzitten; dolen; dwalen; ronddolen; ronddwalen; strijken langs; waren
eindrücke => impressies
knüpfte => gebonden
eltern => bovenliggend
herr => dhr.
bauernhäusern => boerderijen
autobahnanschluss => autosnelweg
bernische => berner
ostermontag => paasmaandag
buchstaben => brieven
neuzuzüger => nieuwkomers
handelsbilanz => betalingsbalans
neuesten => laatst
verstößen => schendingen
volkswirtschaften => economieën
vorjahresmonat => vorig jaar maand
zoll => inch; plicht
entbrannt => ontstoken
ausgeglichener => evenwichtige
fielen => viel
monat => maand
gesamtexporten => totale uitvoer
verbuchen => post
ausgelöst => getriggerd
gesunken => gedaald
ausgewachsenen => volwassen
urheberrechte => auteursrechten
streit => geschil
umsetzung => uitvoering
belief => bedroegen
stiegen => toegenomen
weltwirtschaft => wereldeconomie
zollverwaltung => douane
ungleichgewichts => onbalans
ausfällt => mislukt
gesamte => alle
legten => ingediend
begründet => gegrond
saisonale => seizoensgebonden
zurückgeführt => gerecycled
ausfuhren => export
anstieg => toenemen
gründe => redenen
gemeldet => gerapporteerd
drohungen => bedreigingen
einfuhren => invoer
mitteilte => vertelde
vergeltungszöllen => vergelding plichten
stadtteilen => city ​​aandeel
ehesten => waarschijnlijk
mietpreise => prijzen
angestiegen => toegenomen
zahlungskräftigen => rijk
vermieten => verhuren; te huur; verhuur
zumal => in het bijzonder; inzonderheid; voornamelijk; hoofdzakelijk; speciaal; temeer; bovenal; maar liefst; vooral
fordern => eisen; opeisen; vergen; vereisen
fördern => bespoedigen; accelereren; verhaasten
überdruck => opdruk
bedeutet => middelen
geweckt => spitsgeruit; met spitsruiten
outsidern => buitenstaanders
schichten => opstapelen
verfügbaren => beschikbaar
gegenstand => subject
urbanen => stedelijk
entkommen => ontsnappen
brettspiels => raad, spel
mietzinses => de huurprijs
ungenügend => ontoereikend; onvoldoende
begehrteste => most wanted
steinmetz => steenhouwer
längst => allang; lang geleden; al geruime tijd; lang
altstadt => oude binnenstad
bitterbösen => woedend
regulierung => verordening
erleichtert => opgelucht
paradoxerweise => paradoxaal
mustergültig => voorbeeldig
sprunghaft => bescheiden; discreet; onopvallend; vluchtig
geschützter => beschermde
köpfe => hoofden
strecke => route
mietvertrag => huren
dreht => roteert
doppelte => duplicaat
grösseres => vergroten
niedrigere => lager
mangel => manco
studierende => student
einkommens => conventie
erstaunlich => verbazingwekkend; verrassend; verbazend; verwonderlijk; prachtig; verbluffend; wonderbaarlijk; fabelachtig; geweldig; opvallend
gewisse => sommige
allzu => ook; overdreven; te
befragt => ondervraagd
geprägten => bedrukt
oecd => oeso
wirtschaften => huishouden; beheren; besturen
goldküste => gold coast
normen => normaliseren
altersspezifisches => leeftijdsspecifieke
nationen => volken
verhalten => gedragen; bijhouden; houden; ingetogen; terughoudend; vasthouden; zich gedragen
forscher => onderzoeker
generell => algemeen; doorgaans; in het algemeen; überhaupt; over het algemeen
geduldige => patiënt
abschliessend => definitief; onherroepelijk; vast
kriegerischen => militair
wirkt => acts
mittleren => midden
führt => leads
abstand => distantie; interlinie
ausgeprägt => geprononceerd
wohlhabend => welgesteld; bemiddeld; gegoed; gezeten; welvarend; gemakkelijk; moeiteloos; vlot; abondant; overvloedig
starten => beginnen
englischsprachigen => engels
gesellschaftliche => sociaal
schüler => student
forschergruppe => onderzoeker groep
seeufer => lakeside
risikoscheuer => risicomijdende
durchschnitt => gemiddelde
auszuwirken => invloed
reichsten => meest
neigung => inclinatie
lehrenden => onderwijs
hingegen => daarentegen; integendeel; echter; ertegenover; anderzijds
bereitschaft => paraatheid
dran => aan; aan de beurt
unternehmerischer => ondernemend
sechsmal => zes keer
erweisen => getuigen; blijken; certificeren; betonen; aantonen; adstrueren
vorstellung => verbeeldingskracht
hohe => hoog
erstens => ten eerste; allereerst
wille => zullen
thesen => scripties
alters => leeftijd
bildung => ontwikkeling; onderrichting; vorming
aufwenden => besteden; uitgeven
ausgewirkt => aangedaan
auswertung => evaluatie
geduldiger => patiënt
wobei => waarbij; terwijl
unternehmertum => ondernemerschap
schliesslich => eindelijk
zusammengetragen => gecompileerd
verteilung => spreiding; uitreiking
verbreiteter => wijd verspreid
aufschlüsse => ontsluitingen
verhaltensökonomen => gedrags-economen
bedeutendste => belangrijk
auswirkt => effect
innerhalb => binnen; daarbinnen; binnenin; intern; binnen-; binnenwerk; intrinsiek; wezenlijk
kalt => koud; kil; koel; fris; koude; koele; frisse; kou; onvoorbereid
wohlstand => voorspoed; bloei; geluk; welvarendheid
taucht => duiken
geografie => aardrijkskunde
vermehrten => toegenomen
forschungsarbeit => onderzoekswerk
kälteren => kouder
unterschiede => verschillen
gezeigt => getoond
handelte => onderhandeld
erschossen => shot
entwinden => ontrukken
haaren => ruien
drang => aansporen
vorort => voorstad
eröffnet => geopend
schütze => sagittarius; werpspoel
schiesserei => het schieten
ortszeit => lokale tijd
stadtrand => buitenwijken
fuss => voet
weissen => wit
angreifer => aanvaller
kölnern => cologners
schlussmann => circuit man
gelbe => geel
aufgetaucht => verschenen
rückstand => residu
trainiert => getraind
torhüters => doelverdediger
torhüter => doelverdediger
zuschauer => kijkers
bundesliga => nationale competitie
schlechteste => ergst
relegationsrang => degradatie ranking
freistoßtor => vrije schop
traf => hit
sechsten => zesde
torverhältnis => doelsaldo
schnellen => snel
innenpfosten => binnenkant paal
handwerker => ambachtsman
gesetzt => ernstig; serieus; stemmig; vast; bona fide; degelijk; deugdelijk; flink; gedegen; hecht
kehrer => veger
scheiterte => mislukt
führungstreffer => leiderschap staking
risse => barsten
offenbarte => onthuld
verpassten => gemiste
ausgleich => compensatie
anschlusstreffer => verbinding staking
league => liga
h => b
bittencourt => neem de rechter
vereinsgeschichte => clubgeschiedenis
abstieg => afdaling
erhöhte => toegenomen
schwächen => verzwakken; ontkrachten; afzwakken; temperen; verdunnen; verzachten; afnemen; bedaren; beschadigen; luwen
wiederbeginn => restart
parkplatz => parkeren
entrissen => gewrongen
gewartet => wachtte
wrestled => worstelde
pike => snoek
ausgestiegen => stapten
sohn => zoon
gerettet => gered
mut => moed
waffen => armen
says => zegt
schaffte => beheerd
gunman => straatrover
waffenschein => wapenvergunning
waffe => wapen
burned => verbrand
pistole => geweer
white => wit
gesperrten => opgesloten
medienbericht => media verslag
schüssen => commissies
pressekonferenz => persconferentie
fled => vluchtte
lag => was
he => hallo; zeg
patron => beschermheer
gehalten => held
theke => bar
wounded => verwond
from => van
täter => overtreder
away => weg
rifle => geweer
people => mensen
abgenommen => verwijderd
this => deze
pick => plukken
schüsse => shots
up => omhoog
zurückgegeben => teruggekeerd
foot => voet
möglicherweise => misschien; mogelijk
fatally => gedoemd
save => besparen
fuß => voet
nude => naakt
teller => plaat; schotel
schusswaffen => vuurwapens
fire => brand
gun => geweer
verletzungen => schendingen
feuerpause => staakt-het vuren
used => gebruikt
händigten => handed
barrel => vat
entzogen => teruggetrokken
hero => held
erlegen => doodschieten; afmaken; afschieten; afslachten; slachten
his => zijn
four => vier
begnadigung => pardon
lebenslanger => levensduur
spitzen => aanzetten; scherpen
zeigte => toonden
verhandlung => gehoor
verteidigung => defensie
tage => dagen
meer => zee
freispruch => absolutie; effening; kwijtschelding; vereffening
tatorts => delict
zerteilt => onderdelen
bestreitet => ontkent
grausige => griezelig
festplatte => schijf
tue => do
höchststrafe => maximumstraf
anwälte => advocaten
jährigen => jaar
sah => zaag; zagen
wunden => pijnlijk
erwiesen => bewezen
zulaufenden => spits toelopend
ungewöhnlichen => ongebruikelijk
geringer => minder
gespeichert => gered
vergleichsweise => relatief
geschehen => gebeuren
schwer => zwaar; moeilijk; lastig; slim; drukkend; zware; hard; fiks; geducht; krachtig
hinrichtungen => executies
unglaubwürdig => ongeloofwaardig; fabelachtig; ongelooflijk
haft => hechtenis
sagten => zei
betonte => benadrukte
geträumt => gedroomd
beantragt => gezocht
gefesselt => gebonden
selbstgebauten => self-made
liebschaft => amour
verzweifeltes => wanhopig
kellnert => een ober
tratschenden => roddelen
lockenkopf => curlyhead
tot => dood; overleden; levenloos; gestorven; dode; afgestorven; ter ziele; doodgegaan; heengegaan; buiten gebruik
erwachsenwerden => volwassen leeftijd bereiken
keck => brutaal
dir => jou; aan je; aan jou; je; naar je; naar jou; aan jullie; aan u; jullie; naar u
pfarrerssohn => pastor zoon
schwester => zuster
kurze => kort
einst => ooit
schultern => schouder
katastrophe => calamiteit
innigen => intiem
träume => dromen
heimliche => geheim
entkommt => ontsnappingen
trauernde => rouwende
jugendliche => jeugd
transportiert => vervoerde
schlug => overtreffen
traurige => verdrietig
repressiven => onderdrukkend
nutzt => toepassingen
mütter => moeders
unerhört => ongehoord; flagrant; infaam; schaamteloos; schandalig; schandelijk; stuitend; verfoeilijk
weitergegangen => weg
ausgangspunkten => exit punten
missgeschick => ongeluk
körper => lichaam
beäugt => eyed
marinesoldat => marinier
ausgestattet => ingericht
erarbeitet => werkte
kehrt => opbrengst
trim => trimmen
mief => bedomptheid
oceanside => oceaan
kapitel => hoofdstuk
kurzem => onlangs
übersetzt => vertaald
footballspieler => voetballer
beraubt => beroofd; ontnomen
muttersein => moederschap
rebellisch => opstandig; oproerig
ehrgeiz => ambitie
trauma => verwonding
hitzige => verwarmd
sünde => zonde
gutaussehend => knap; aanlokkelijk
freundschaft => vriendendienst
hübsch => knap; mooi; aardig; leuk; bevallig; fraai; keurig; schoon; bekoorlijk; fijn
schlusspunkten => aansluitpunten
chores => klusjes
bedrückend => deprimerend
schlimmer => slechter; erger
gemeindemütter => community moeders
keuschheitsring => zuiverheid ring
vorgezogen => voorkeur
flip => tik
stellung => positie
benennt => hernoemt
umstand => omstandigheid
süd => zuidelijk
tobt => woedt
schmerzvoll => pijnlijk
kirchenmütter => kerk moeders
verwegen => doldriest; roekeloos; stoutmoedig
atmosphäre => stemming
irgendwo => ergens; hier of daar; overal; eender waar
humpelnd => mank
verletzung => letsel
freizügig => vrijgevig; genereus; goedgeefs; kwistig; rijkelijk; royaal; scheutig
abtreibung => abortus
unauslöschlich => onuitwisbaar
sucht => onderzocht
vorstellungen => representaties
brötchen => bun
kiste => krat
entgegen => tegemoet; mijden
geschmacklicher => van de smaak
rät => adviseert
brettspiel => bordspel
mittagessen => twaalfuurtje
lebensmittelabfälle => voedselverspilling
auftrag => order
proteinbällchen => eiwit soup company
stöbere => rommel
samstagabend => zaterdagavond
kauft => kocht
aufdrehe => opdagen
reiße => scheur
differenzen => verschillen
nächster => aanstaand; aankomend; komend; volgend; dichtst; naast; volgende; spoedig
herb => zuur; scherp; bijtend; doordringend; fel; guur; schel; schril; snerpend; hatelijk
karottensaft => wortelsap
nase => neus
getränke => dranken
klingelt => ringen
monate => maanden
haltbar => stevig; ferm; fors; hecht; potig; robuust; sterk; stoer; struis; duurzaam
too => ook
etikett => label
süßlich => stroperig; zeemzout
wandert => emigreerde
zutaten => ingrediënten
hund => reu
bote => boodschapper
brei => beslag
schnappt => snaps
suppe => soep
mülleimers => prullenbak
weiterverkaufen => doorverkopen
wegzuschmeißen => weggooien
bist => bent; zijt
beugt => bochten
landwirtschaft => landbouw
wittert => verdachten
rauch => rook
fährte => spoor
eile => haasten
lieblingsgetränk => favoriete drankje
nudeln => noedels; pasta; noedel
alltagstauglich => dagelijks gebruik
geschmack => smaak; esthetische smaak; proeven
entsorgen => verwijderen
enthalten => bevatten; inhouden; behelzen; houden
gerettetes => gered
entsorgt => afgestane
esse => eten
retterboxen => redder dozen
himbeeren => frambozen
unsicher => onveilig; onzeker; precair; bedenkelijk; onbepaald; ongewis; twijfelachtig
lese => oogst
versuch => proberen; trachten
löffel => emmer
günstiger => beter
letzter => laatst; achterste; jongstgeleden; afgelopen; dichtsbijzijnde; jongstleden; vorig; definitief
schnitt => doorsnede; snoeien
paket => verpakking
biete => aanbod
ziemlich => nogal
wären => ware; was; zou zijn
anbau => bebouwing; bewerking
schnüffelt => snuift
riecht => geuren
müll => afval
pappe => karton
bundesbürger => , duitsers
baby => schatje
fault => fout
matschig => beurs
trocken => droog; dor; droge; droogweg; sec; drogen; watervrij
okay => oké; OK; okee
wait => wachten
gespür => flair
alphamännchen => alpha male
niemandem => iedereen
festgestellt => gevonden
mitgebracht => bracht
redakteurin => editor in
müde => moe; vermoeid; mat; slaperig; uitputting; vermoeidheid; lusteloos
schwierig => moeilijk; zwaar; lastig; netelig; netelige; gecompliceerd; ingewikkeld; moeilijke; slim; zware
anführer => leider
gerücht => praatje
tennismatch => tenniswedstrijd
mithalten => bijbenen
aufzunehmen => nemen
redet => gesprekken
großartigkeit => grootsheid
geburtstag => verjaardagsfeest
versuchen => proberen; uitproberen; beproeven; aanpassen; passen; pogen; toetsen
gewisses => sommige
umlauf => circulatie; omloop; roulatie
entschuldige => sorry
gutem => goed
wettkampf => competitie; concours; concurrentie; match; wedloop
renommierte => vermaard
dürrholz => verdord hout
versehen => voorzien van; bevoorraden; provianderen; spekken; stijven; abundant; breed; breedvoerig; garneren; groot
ganzes => geheel
ermutigen => aanmoedigen; bemoedigen; aanwakkeren; opwinden; prikkelen; stijven; verhitten; werken op; aansporen; aanzetten
shaggy => ruig
queen => koningin
schmutzig => vuil; smerig; vies; oneerlijk
haschisch => hasj
net => netto
erfolgreich => succesvol; geslaagd; gelukt; voorspoedig; met goed gevolg; met succes
einander => elkaar
performen => uitvoeren
geschenk => gift
mühelos => gemakkelijk; moeiteloos; makkelijk; licht; vlot; soepel; vanzelf
merkten => bekend
hit => klappen; raken
übernimmt => accepteert
kino => bioscoop
körperliche => fysiek
termine => data
rest => nachtrust
aufschieben => uitstellen; verdagen
jetzigen => aanwezig
haushalt => huishouden
studiert => geleerd
schulabschluss => schoolgraduatie
gewollt => gezocht
gern => graag; gaarne; met genoegen; met; plezier; welwillend; bereidwillig; bij voorkeur
zurückbekomme => terug te krijgen
angestellte => werknemer
gelohnt => waard
rennt => runs
tschüss => dag; tot ziens; doei; adieu; vaarwel; tot kijk; doeg; hoi; houdoe; later
cousins => neven
auseinander => uiteen; uit elkaar
selbstsicherheit => zelfbewustzijn
sehe => zien
hinfällt => gerucht
patentbüro => octrooibureau
abends => 's avonds; s'avonds; avond; vannacht; ’s avonds
einteilen => verdelen; delen; opsplitsen; splitsen; afbreken; debiteren
durchzuziehen => volgen via
ungern => met tegenzin; schoorvoetend
aufgehört => gestopt
abhole => halen
oberflächlich => oppervlakkig; ondiep; vluchtig; licht
kumpels => jongens
umgezogen => verplaatst
früh => vroeg; pril; tijdig; vroegtijdig; weldra
ungewollt => onopzettelijk
raus => ga weg; hoepel op; rot op; sodemieter op; uit
zusätzlich => aanvullend; additioneel; bijkomend; bijkomstig; extra; toegevoegd; accessoir; accessorisch; bijbehorend; meegeleverd
weint => huilt
gestritten => vochten
gefragt => zoek
klamotten => lompen
geschwänzt => spijbelaar
teilt => aandelen
öfter => vaker; meermaals
absprechen => overeenkomen
probe => monster
verantwortlich => aansprakelijk
dritt => derde
vorgegeben => reeks
toll => gek; dol; dolzinnig; krankzinnig; waanzinnig; stapel; uitzinnig; doldriftig; fijn; verwoed
kümmerte => zorgden
krass => uitermate; extreem; grof; insensibel; ongevoelig; ruw
übernehmen => erven
cousinen => neven
stubenhockerin => huismus
kindergarten => kleuterschool
malte => geschilderd
fremdes => buitenlands
zurückgezogen => teruggetrokken
kümmert => zorgen
damaligen => dan
diejenige => degene
freuen => jubelen; blij zijn; ernaar uitkijken om; uitkijken; uitkijken naar; verheugen; verheugen zich op; vrolijk zijn; zich verheugen
offenbart => onthuld
schmuckkiste => sieraden krat
rückweg => terugweg
häuser => huizen
wohin => waarheen; waar; waartoe; waarvan; waarvandaan; waarnaartoe; waar ... heen; warheen; waar ... naar toe; werwaarts
lebe => leven
hinfahren => gaan
montagvormittag => maandagochtend
unterdessen => inmiddels; intussen; daarentegen
anrief => belde
highway => openbare weg
bezirk => district
ausbruchs => het uitbreken
schossen => shot
stunde => uur
anrufe => telefoontje
gerochen => rook
irreales => onwerkelijk
donnerstagnachmittag => donderdagmiddag
hauptstraße => hoofdweg
wichtigsten => hoofd-
nächsten => naast
estates => landgoederen
hunde => hoektand
zerstört => gebroken; gekraakt
taub => doof; dove; bewusteloos; verdoofd; verkleumd; verstijfd; bot; stomp; doofheid; gehoorgestoord
bekamen => gekregen
ladegeräte => opladers
blieben => bleef
siedlung => nederzetting
computer => personal computer
dauernd => permanent; voortdurend; blijvend; onophoudelijk; almaar; alsmaar; constant; continu; aldoor; bestendig
gepackt => compact
neuer => nieuw
sprudelte => flapte
herauskommt => komt uit
handy => mobiel
zurückgehen => achteruitgaan; teruggaan; afnemen; dalen; afzwakken; minder worden; neerslaan; slinken; vernederen; verzwakken
mitzunehmen => nemen
ausgeräumt => ontruimd
gestopft => gevuld
aufgetan => geopend
erlebt => ervaren
gespräch => interview
weile => terwijl
gefühl => gevoel
nachrichten => nieuwigheid; nieuwtje
nötigste => meest noodzakelijke
entwarnung => all-clear
fuhren => leiden
losgefahren => vertrekken
anzuschauen => om naar te kijken
liste => keuzelijst
riss => barst
spielzeuge => speelgoed
ordnung => orde
gearbeitet => werkte
schmuck => juwelen
rettungskräfte => reddingswerkers
erschütterte => schudde
bekam => gekregen
mittag => lunch
reingelassen => binnenlaten
absteigender => aflopend
evakuiert => geëvacueerd
rissen => scheurde
rein => schoon
erdbeben => aardbeving
durften => mochten
unterlagen => documenten
fortgeführt => vervolgd
umsatz => omzet
steuer => heffing
enttäuscht => teleurgesteld; bedrogen; gedupeerd; ontgoocheld; gedesillusioneerd
steuerpläne => fiscale plannen
arbeitgeber => werkgever
protest => tegenwerping
hinterfrage => ondervragen
obdachlosigkeit => dakloze
umstrittene => controversieel
stadtrats => city ​​council
ursprünglich => origineel
schätzungen => ramingen
ausbau => uitbreiding
angepeilten => doelgerichte
angesetzt => erkend
bürgermeisterin => burgemeestersvrouw
stadtrat => gemeenteraad
mitarbeitern => werknemers
stetig => continu; voortdurend; gestaag; ononderbroken; constant; aanhoudend
jährlichen => jaar-
getreten => ingevoerd
siebten => zevende
partie => spel
ohrfeige => draai om de oren
flachen => flat
karte => kaart
profi => professioneel
rückwärtslaufen => achteruit lopen
flog => vlogen
gewann => won
unterzahl => onder nummer
anschließend => achtereenvolgend; vervolgens
galaxy => melkweg
theatralisch => schouwburg-
übernahm => nam
zeitungsbericht => krantenbericht
händlerin => handelaar
voran => voorwaarts
handelsplatzes => marktplaats
spitze => hoogste
zukäufe => overnames
stock => etage; verdieping
chefin => baas
börsen => uitwisselingen
wechselt => verandering
ernannte => benoemd
verlässt => bladeren
börsengeschichte => publiekelijk geschiedenis
berührung => contact
technologiebörse => technologie-uitwisseling
akquisitionen => overnames
speziellen => speciaal
vorstellunge => representatie