holen => halen
freundin => vriendin
an => aan
in => in
seiner => zijn
bleiben => blijven
aufbrechen => breken
nach => na
dachte => gedachte
polizei => politie
den => de
dillingen => dillingen
wegen => wegens
geschichte => geschiedenis
als => als
ex => ex
polizisten => politie
laut => luide
von => van
schief => schuin
ging => ging
eine => ene
freund => vriend
erzählte => vertelde
der => de
deren => der
aus => uit
sich => zich
seine => de zijne
plan => flat
geschlagen => geslagen
verlassen => verlaten
überreden => overtuigen
nicht => niet
die => de
des => de
wolle => wollen
dass => dat
beiden => beide
am => am
dem => de
bestätigte => bevestigd
polizeiinspektion => politie inspectie
junge => jongen
nacht => nacht
anders => anders
dieser => die
schwäbischen => zwabische
ein => een
missbrauchs => misbruik
gewesen => geweest
elegant => elegant
sein => zijn
historischen => historisch
wasser => water
erfüllen => vervullen
zwei => twee
entstehen => ontstaan
waren => ware
park => park
fischfreundlichen => visvriendelijke
rengel => rengel
drei => drie
ökologischen => ecologisch
schönheit => schoonheid
projekt => project
gehört => gehoord
denen => die
tatsächlich => feitelijk
limmattal => limmattal
grösste => grootst
verzasca => verzasca
das => dat
zürich => zürich
wasserdichtes => waterdicht
meter => meter
ebenso => evenzo
orange => oranje
auftakt => upbeat
insiderbegriffen => insider begrepen
prozent => procent
zugleich => tegelijk
moment => moment
renaturierung => renaturatie
westlichen => westelijk
grossem => groot
kantons => kantons
kanal => kanaal
glanzenberg => glinsterende berg
grosse => groot
doch => toch
mehr => meer
flair => flair
produzierbare => produceerbaar
komplexität => complexiteit
rund => rond
limmatabschnitt => limmat sectie
pneukran => pneukran
zürcher => zürcher
zahlreiche => talrijk
direkt => direct
elektrizitätswerke => elektriciteitscentrales
erneuern => vernieuwen
ceo => ceo
grundwasser => grondwater
millionen => miljoenen
feiern => vieren
posieren => poseren
jahre => jaar
natürlich => natuurlijk
verworfen => verlaten
limmat => limmat
urs => urs
gekommenen => komen in
wenigen => weinig
mitten => midden
entwicklungshotspot => ontwikkeling hotspot
jährlich => jaarlijks
mit => met
geschwemmsel => geschwemmsel
spaten => spade
vögeli => voegeli
kommt => komst
einen => verenigen
noch => nog
ekz => ekz
versorgen => verzorgen
vierpersonenhaushalte => vierpersoons huishoudens
einer => een
namens => namens
wurden => waren
planungsphase => planningsfase
freitagmorgen => vrijdagmorgen
offiziellen => officieel
aufnehmen => opnemen
abgeschlossen => gesloten
konzession => concessie
pd => pd
etwas => ietwat
motorisierte => gemotoriseerde
vier => vier
spricht => spreekt
grosses => groot
varianten => varianten
dieses => die
jahr => jaar
horizontalrechen => horizontale rake
energieformen => energievormen
dietiker => dietiker
brauchen => gebruiken
turbinen => turbines
oder => oder
über => over
werden => worden
toblerone => toblerone
strom => stroom
bieten => bieden
investieren => investeren
sollen => moeten
markus => markus
erneuerung => vernieuwing
karriere => carrière
kägi => kaegi
helme => helmen
bauen => bouwen
ist => is
wasserkraft => waterkracht
franken => franken
vollständig => volledig
dietikon => dietikon
nun => nu
dorothee => dorothee
verschiedene => verscheidene
stellen => stellen
westen => westen
oktober => oktober
für => per
immer => immer
allmend => allmend
erneuerten => vernieuwd
dann => dan
gegen => tegen
obama => obama
james => james
barack => barack
jedoch => edoch
transgender => transgender
identifizieren => identificeren
januar => januari
nielsen => nielsen
amerikanischen => amerikaans
risiko => risk
gekommen => komen
august => augustus
militärdienst => militaire dienst
washington => washington
lehnte => leunde
geburt => geboorte
per => per
freitag => vrijdag
true => true
stoppte => gestopt
vorgängers => voorganger
unterzeichnet => ondertekend
seines => zijn
donald => donald
operative => operationele
machen => maken
kirstjen => kirstjen
dezember => december
rekruten => rekruten
kammer => kamer
bei => bij
offen => open
angekündigt => aangekondigd
virginia => virginia
richmond => richmond
dienen => dienen
bereits => bereids
behandlung => behandeling
mattis => mattis
konkret => concreet
sogenannte => zogenaamd
spiegel => weerspiegelen
cdu => cdu
wir => wij
staatlicher => staat
protesten => protesten
bewegen => bewegen
finden => vinden
antwort => antwoord
höferlin => höferlin
deutschland => duitsland
variante => variant
mildere => milder
aufgehoben => opgeheven
verhindern => verhinderen
deutsche => Duitse
hier => hier
kontrovers => controversieel
absurd => absurd
internetseiten => internetseiten
zugang => toegang
thema => thema
verhängen => verhullen
websites => websites
fdp => fdp
ursula => ursula
kommen => komen
langem => lang
schärfste => scherpste
manuel => manuel
sanktion => sanctie
worüber => waarover
eu => eu
politiker => politicus
bundesregierung => bondsregering
möglich => mogelijk
leyen => leyen
lehnen => leunen
können => kunnen
richtung => richting
cpc => cpc
ministerien => ministeries
streiten => strijden
sperren => versperren
inhalte => inhoud
ermächtigt => gemachtigd
uns => ons
momente => momenten
tanja => tanja
winter => winter
aggressiv => agressief
warum => waarom
einige => enige
influenza => influenza
allein => alleen
weil => wijl
hart => hard
tagen => dagen
jeder => ieder
false => false
weiß => wit
cocktail => cocktail
was => wat
man => men
artikel => artikel
nämlich => namelijk
schlechter => slechter
autorin => auteur
zunehmend => toenemend
lesen => lezen
welches => welk
denise => denise
wenigstens => minstens
rachsüchtig => wraakzuchtig
organisieren => organiseren
faz => faz
wäre => ware
z => z
a => a
leben => leven
vorbei => voorbij
daran => daaraan
schnupfen => snuiven
münchen => münchen
allgemeinen => algemeen
jedes => ieders
husten => hoesten
peikert => peikert
f => f
harald => harald
alle => alle
denn => dan
haben => hebben
erklärbar => verklaarbaar
krank => krank
wer => wie
kann => kan
plus => plus
wissenschaft => wetenschap
delirium => delirium
südkoreanische => zuid-koreaanse
peking => beijing
medien => media
fiel => viel
us => us
hungert => hongerig
fotos => foto's
dennoch => edoch
stammhalter => stammhalter
stammen => afstammen
xi => xi
suk => suk
mystery => mysterie
unhasu => unhasu
un => un
viele => vele
cheerleaderin => cheerleader
angeblich => kennelijk
geheimnis => geheim
basketballstar => basketbalster
jong => jong
meisten => meeste
jinping => jinping
ob => of
kleidung => kleding
leichtathleten => atletiek atleten
kind => kind
elegante => elegant
ri => ri
größte => grootst
ae => ae
sol => sol
orchester => orkest
sindkim => sindkim
optisch => optisch
nordkoreanischen => noord-koreaanse
incheon => incheon
diktators => dictator
kims => kim
kinder => kinderen
kommunistischen => communist
dabei => daarbij
sehen => bezien
nahm => nam
pjöngjang => pyongyang
modische => modieus
war => was
dior => dior
nordkoreas => noord-korea
dynastie => dynastie
getragen => gedragen
zusammen => samen
yonhap => yonhap
kaderfamilie => kader familie
york => york
professor => professor
geboren => geboren
liyuan => liyuan
besuchte => bezocht
il => il
rodman => rodman
tochter => dochter
stolz => stout
peng => peng
jahren => jaar
volksrepublik => volksrepubliek
sehr => zeer
besitzen => bezitten
bekannt => bekend
aufmerksam => opmerkzaam
kim => kim
dennis => dennis
ju => ju
statements => statements
exxonmobil => exxonmobil
erzählen => vertellen
kollege => collega
europäische => europese
zusammenbringe => samenbrengen
kandidaten => kandidaten
verbringen => doorbrengen
macht => maakt
bourbon => bourbon
weg => weg
scheinbar => schijnbaar
europa => europa
neulich => recentelijk
amerika => amerika
mein => mijn
datenskandal => data schandaal
sanktionen => sancties
datenpakete => datapakketten
unternehmungen => unternehmungen
probleme => problemen
idioten => idioot
person => persoon
dies => dit
idee => idee
aufgekratzten => gekrast
christopher => christopher
politik => politiek
dort => d’r
verkauft => verkocht
amerikanische => amerikaans
einmal => eenmaal
stahlindustrie => staalindustrie
erkennbar => herkenbaar
bin => ben
richtige => rechts
reiermann => ree man
nichts => niets
mich => mij
anfragen => vragen
internet => internet
vor => voor
handelskriegs => handelsoorlog
irland => ierland
lebens => leven
verfolgt => vervolgd
leser => lezer
erinnern => herinneren
tennessee => tennessee
verboten => verboden
länder => land
ich => ik
informationen => informatie
subvention => subsidie
responsibilty => responsibilty
unterwegs => onderweg
abzuweichen => afwijken
schützen => beschutten
gebeutelten => gebeutelten
wen => wie
piratenpolitiker => piraat politici
dublin => dublin
wahrheit => waarheid
produktionsstätten => productielocaties
abteilung => afdeling
schaden => schaden
milliarden => miljarden
scheinen => schijnen
kulow => kulov
trotz => trots
download => downloaden
antwortete => antwoordde
erwogen => weloverwogen
destillerien => distilleerderijen
gesetzen => wetten
monsanto => monsanto
gespräche => gesprekken
steuern => besturen
tina => tina
all => al
brüssel => brussel
änderung => verandering
menlo => menlo
daumenschrauben => duimschroeven
dahin => daarheen
alternativen => alternatief
unternehmen => ondernemen
dagegen => daartegen
handelskrieg => handelsoorlog
facebook => facebook
dinge => dingen
genommen => genomen
wüst => woest
treffen => treffen
verdienen => verdienen
gezahlt => betaald
reagiert => reageert
wenden => wenden
kalifornien => californië
gerecht => recht
selbst => zelfs
pr => pr
eben => effen
christian => christelijk
einwenden => tegenwerpen
wusste => wist
ernst => ernstig
technisch => technisch
zuschlüsseln => zuschlüsseln
insiderreport => insider rapport
erste => eerste
fröhlich => vrolijk
alles => alles
wenige => weinig
erheben => verheffen
kilobit => kilobit
amerikanischer => amerikaans
überzeugend => overtuigend
klar => klaar
seiten => zijden
whiskey => whisky
jennifer => jennifer
absender => verzender
daimler => daimler
verantwortung => verantwoording
mir => mij
personen => mensen
krise => crisis
sinnvoll => zinvol
ulrich => ulrich
verdient => verdienstelijk
abhalten => afhouden
viel => veel
verstehen => verstaan
eines => een
wiedergeben => weergeven
überlegen => overleggen
versetzen => verzetten
grammatische => grammaticaal
effektives => effectief
gebracht => bracht
überprüfen => overhoren
produzent => producent
meinen => menen
afrikanischen => afrikaanse
politischem => politiek
altman => altman
westlicher => westelijk
wladimir => vladimir
bisexuelle => biseksueel
kadyrow => kadyrov
sexuellen => seksueel
bewegung => beweging
staaten => staten
bandes => band
identifizierten => geïdentificeerd
aktion => actie
diejenigen => diegenen
schuldigen => schuldig
lassen => laten
chronologie => chronologie
lager => lager
clintons => clinton
lgbt => lgbt
umreißen => omlijnen
merken => merken
nationalsozialismus => nationalsozialismus
männer => mensen
george => george
schärft => scherpt
instrument => instrument
bewegungen => bewegingen
autoren => auteurs
cameron => cameron
hillary => hillary
achtundsiebzig => achtenzeventig
ehe => eer
einerseits => enerzijds
lesben => lesbisch
fundamentalistische => fundamentalistische
eliten => eliten
app => app
bündig => bondig
frustriert => gefrustreerd
weltweite => wereldwijd
acht => acht
widerstände => weerstanden
symons => symons
todesstrafe => doodstraf
element => element
rechte => rechten
putin => putin
homosexuellen => homoseksueel
w => w
gruppierungen => groeperingen
formieren => formulier
bush => bush
leiten => leiden
ramsan => ramzan
religiösen => religieus
tschetschenische => tsjetsjeense
bilaterale => bilaterale
andererseits => anderzijds
politischen => politiek
politisches => politiek
bändigen => bedwingen
ländern => landen
jonathan => jonatan
zentralen => centraal
david => david
dating => dating
hundert => honderd
sprünge => sprongen
darin => daarin
homosexuelle => homoseksueel
tschetschenien => tsjetsjeense
bedrohungen => bedreigingen
recht => recht
auftreten => optreden
bilanz => balans
aktivismus => activisme
gesucht => gezocht
erwartet => verwacht
vereinigten => verenigd
strafe => straf
homosexualität => homoseksualiteit
geschrieben => geschreven
wussten => wisten
schrecklich => verschrikkelijk
schaffen => scheppen
position => positie
widerständen => weerstanden
tiefe => diepte
ritualen => rituelen
porträtieren => portretteren
persönlichen => persoonlijk
desto => des te
tabus => taboes
mannes => man
animierten => geanimeerde
ganz => gans
besser => beter
co => co
hingekriegt => hingekriegt
japanische => japans
langsam => langzaam
protagonisten => protagonisten
japan => japan
komplizierten => gecompliceerd
tod => dood
optimierter => geoptimaliseerde
freundinnen => vriendinnen
maximaler => maximum
unten => beneden
führen => voeren
gedeckte => bedekt
gekachelte => betegeld
entstanden => ontstonden
arne => arne
hauses => huis
alltagskomik => alledaagse komik
dokumentarfilm => documentaire
positiven => positief
doku => doku
realitäten => realiteiten
beschreibung => beschrijving
trailer => filmtrailer
aller => elk
vielleicht => wellicht
aufgegeben => opgegeven
hildegard => hildegard
herz => hart
fsk => fsk
intellektuellen => intellectueel
ja => ja
absurden => absurd
stumm => stom
setzen => zetten
schlafen => slapen
beweisen => bewijzen
zweifeln => twijfelen
filmverleih => filmverleih
untenrum => untenrum
gestapelten => gestapeld
kamala => kamala
start => starten
video => video
film => film
zweit => tweede
küche => keuken
komischen => komisch
weh => wee
gestalt => gestalt
länge => lengte
kg => kg
liebe => lieve
vorbereiten => voorbereiden
samdereli => samdereli
zwischen => tussen
coast => kust
stets => steeds
filmemacherinnen => filmmaker binnen
herbstlichen => herfstachtig
langersehnte => langverwachte
pack => pak
media => media
isaos => isao
charmanten => charmant
kamera => camera
heinz => heinz
großen => groot
arts => arts
paar => paar
feldern => velden
homosexuelles => homoseksueel
pennsylvania => pennsylvania
sugihara => sugihara
öffnen => openen
essen => eten
plädoyer => pleidooi
gebückt => bukte
rummikub => rummikub
romantik => romance
balance => balans
wunderbar => wonderbaarlijk
isao => isao
rechtlich => recht
adoption => adoptie
yasemin => yasemin
zeiten => tijden
geben => geven
familie => familie
kulturen => culturen
nesrin => nesrin
herumwerkelt => herumwerkelt
sex => seks
moral => moreel
april => april
drife => drife
hampana => hampana
kichert => giechelt
arbeit => arbeid
hochzeitsnacht => huwelijksnacht
willkommen => welkom
sequenzen => sequenties
bauernsohn => bauer zoon
liegen => liggen
titel => titel
individuums => individu
east => oosten
konsequent => consequent
sitzen => zitten
nachts => 's nachts
wenig => weinig
keller => kelder
allem => alle
almanya => almanya
filmproduktion => filmproduktion
geworden => worden
harte => hard
piccolo => piccolo
indien => india
bonsai => bonsai
lebenslangen => levenslang
genre => genre
tränen => tranen
concorde => concorde
zuerst => eerst
shigeko => shigeko
problemen => problemen
nackt => naakt
juristisch => juridisch
fruitmarket => fruitmarkt
birkenstock => birkenstock
komödie => komedie
lernen => leren
englisch => engels
professionalität => professionalisme
e => e
mehrere => meerdere
missbrauch => misbruik
briten => brits
datenlecks => datalekken
gleichen => lijken
einstellung => aanstelling
darum => daarom
initiativen => initiatieven
schreibt => schrijft
gegeben => gegeven
informieren => informeren
cambridge => cambridge
größer => groter
größeren => grotere
telefonnummern => telefoonnummers
weise => wijs
daten => daten
britischen => brits
öffentlich => openlijk
bitten => bidden
investor => investeerder
formate => formats
zuckerbergs => suiker bergs
jahres => jaar
netzwerks => netwerk
wiederum => wederom
konnte => kon
schroepfer => schroepfer
indessen => ondertussen
abweichen => afwijken
deletefacebook => deletefacebook
union => union
technik => techniek
religiöse => religieus
privatsphäre => privésfeer
einstellungen => instellingen
ende => einde
persönlicher => persoonlijk
erst => eerst
bekanntgeworden => bekend worden
dsgvo => dsgvo
anderen => anders
positiv => positief
profile => profiel
idealistisches => idealistisch
gedacht => gedachte
analytica => analytica
adresse => adres
vorsitzenden => voorzitter
erklärungsnot => erklärungsnot
getan => gedaan
plattform => platform
heraus => eruit
andere => ander
affäre => affaire
rechtlicher => wettelijk
bekanntwerden => bekend worden
gesehen => gezien
europäischen => europese
suchfunktion => zoekfunctie
denke => denken
mail => mail
annehmen => aannemen
vereinfachen => vereenvoudigen
sozialen => sociaal
fitnessaktivitäten => fitness-activiteiten
konnten => kon
russischen => russisch
maximum => maximum
telefonat => telefoontje
diskussionen => discussies
erwarten => verwachten
optimistisches => optimistisch
verschiedener => verschillend
europas => europa
akteure => acteurs
datenaffäre => data-affaire
soziale => sociaal
hinterlassen => achterlaten
zuckerberg => zuckerberg
telefonnummer => telefoonnummer
wochen => weken
genug => genoeg
region => regio
sollten => moeten
entwickler => ontwikkelaar
journalisten => journalisten
apps => apps
adressen => adressen
zumindest => tenminste
helfen => helpen
eingeben => ingeven
mark => merg
politische => politiek
mike => mike
bekommen => aankomen
erkannt => erkend
situation => situatie
bewusst => bewust
anzeigen => aanwijzen
gefunden => gevonden
spd => spd
außer => buiten
immerhin => immers
schule => school
handeln => handelen
ahmad => ahmad
freistaat => freistaat
tradition => traditie
aufklären => verklaren
ausgrenzung => uitsluiting
digitalisierung => digitalisering
gestern => gisteren
historische => historisch
schulen => scholen
ingrid => ingrid
zentrale => centraal
mansour => mansour
gelten => gelden
csu => csu
sexualpädagogik => seksuele pedagogie
gleichzeitig => gelijktijdig
sogenannten => zogenaamd
deutschlands => duitsland
joachim => joachim
militarismus => militarisme
moderne => modern
kompensieren => compenseren
lehrplan => leerplan
schülern => scholieren
schulklassen => schoolklassen
machtlosigkeit => machteloosheid
wieder => weer
überhaupt => überhaupt
freimuth => freimuth
einfallen => binnenvallen
bundeswehr => bundeswehr
tag => dag
pädagogin => pedagoog
preußischen => pruisisch
illner => illner
giffey => giffey
nation => natie
sorgen => zorgen
deutlich => duidelijk
kompetent => competent
herrmann => herrmann
nehmen => nemen
bekämpfen => bekampen
antisemitismus => semitisme
journalist => journalist
hamas => hamas
niemand => niemand
rennen => rennen
grenze => grens
netanyahu => netanyahu
tel => tel
verdienst => verdienste
scharfschützen => scherpschutters
aviv => aviv
anderem => anderen
gründlich => grondig
betselem => b'tselem
darüber => daarover
auda => auda
kabinett => kabinet
gekannt => bekend
gaza => gaza
gazastreifen => gazastrook
ofir => ofir
israelischen => israëlisch
palästinenser => palestijn
schrieb => schreef
wissenschafts => wetenschap
arabische => arabisch
premier => premier
naftali => naftali
zeigen => wijzen
kameraden => kameraden
aiman => aiman
aufgenommen => opgenomen
technologieressort => technologie departementale
feld => veld
anweisen => aanwijzen
tränengas => traangas
twitteraccount => twitter-account
akunis => akunis
schießen => schieten
dorthin => daarheen
bennett => bennett
unbewaffneten => ongewapend
schießt => scheuten
terroristen => terroristen
heller => heller
menschenrechtsorganisation => mensenrechtenorganisatie
genähert => benaderde
hunderte => honderden
jemandem => iemand
erdan => erdan
sderot => sderot
benjamin => benjamin
minister => minister
verurteilen => veroordelen
demonstrationen => demonstraties
aufnahmen => opnames
gilad => gilad
dienstag => dinsdag
soldat => soldaat
darunter => daaronder
eindringen => binnendringen
massenproteste => massaprotesten
passieren => passeren
reagieren => reageren
aschkelon => ashkelon
einigen => verenigen
soldaten => soldaten
erschütternd => verstorend
tv => tv
israelische => israëlisch
wachsen => wassen
demokratie => democratie
dpa => dpa
grünen => groenen
gehören => behoren
souveränität => soevereiniteit
evp => evp
vorschlag => voorstel
ernster => ernstig
starken => sterk
september => september
forschungs => forschungs
grundrechten => grondrecht
rechtsstaatliche => rechtsstaat
billigen => billijken
trends => trends
vorgehen => voorgaan
präsentierte => gepresenteerd
partei => partij
bedrohung => bedreiging
flüchtlingen => vluchtelingen
volkspartei => volkspartij
orban => orban
sargentini => sargentini
fakten => feiten
plenum => plenum
ministerrat => ministerraad
sonntag => zondag
beschneidung => besnijdenis
überraschend => verrassend
regierungspartei => regeringspartij
ungarns => hongarije
verteidiger => verdediger
parlaments => parlement
resolutionsentwurf => resolutieontwerp
konfrontation => confrontatie
systemische => systemische
judith => judith
christlichen => christelijk
rechtsstaats => rechtsstaat
orbàn => orban
deshalb => derhalve
minderheiten => minderheden
kommission => commissie
ungarn => hongarije
nationalistischen => nationalist
sargentinis => sargentinis
beginnende => beginnende
viktor => viktor
polen => polen
fidesz => fidesz
rechtsstaatsverfahren => rechtsstaat proces
systematische => systematisch
grundwerte => grundwerte
östlichen => oostelijk
vorgeschlagen => voorgestelde
nationalen => nationaal
europaparlament => europees parlement
werfen => werpen
rechtsstaat => rechtsstaat
einleitung => inleiding
prostituierten => prostituees
prostituierte => prostituée
organisierte => georganiseerd
fällen => vellen
überwiegend => overwegend
euro => euro
kam => kwam
reise => reizen
bordelle => bordelle
beamte => beambte
veruntreuung => verduistering
welche => welk
neun => negen
rastatt => rastatt
richten => richten
gemeinsam => gemeen
gsg => gsg
nationalität => nationaliteit
gingen => ging
erzielen => verdienen
arbeiten => arbeiden
hatten => had
gießen => gieten
zwölf => twaalf
horst => horst
thailand => thailand
stadt => stad
organisierten => georganiseerd
hessen => hessen
bereicherung => verrijking
längere => langer
baden => baden
transsexuelle => transseksueel
saarbrücken => saarbrucken
dieter => dieter
sprach => spaak
befreien => bevrijden
maintal => maintal
kern => celkern
speyer => speyer
opfer => offer
gruppierung => groepering
zwangsprostitution => gedwongen prostitutie
kosten => kosten
touristenvisa => toeristenvisum
angeworben => aangeworven
frankfurt => frankfurt
nordrhein => north rhine
humanitäre => humanitaire
bordellen => bordelen
voraus => vooruit
transsexueller => transseksueel
nahmen => namen
prostituieren => prostitueren
unbekannten => onbekend
hanau => hanau
landesgrenzen => landsgrenzen
alexander => alexander
vorläufig => voorlopig
prostitution => prostitutie
niedersachsen => nedersaksen
rodgau => rodgau
spezialeinheit => speciale eenheden
reaktionen => reacties
schulden => schuldig zijn
ausgangspunkt => uitgangspunt
objekte => objecten
kriminellen => crimineel
verdächtigen => verdenken
kommuniziert => communiceert
hauptbeschuldigte => alle beschuldigden
massagesalons => massagesalons
seehofer => seehofer
zehn => tien
romann => romann
deutsch => duits
beschuldigten => beschuldigde
main => main
badle => badle
bundespolizei => bundespolizei
morgen => morgen
grenzenlosen => grenzeloos
persönliche => persoonlijk
rotlicht => rood licht
eschborn => eschborn
westfalen => westfalen
sprechen => spreken
höhe => hoogte
identität => identiteit
abscheulichen => afschuwelijk
schleusen => sluizen
sommer => zomer
hotel => hotel
assoziieren => associëren
republik => republiek
essensresten => etensresten
viertel => vierendeel
restaurants => restaurants
pauli => paul
reeperbahn => reeperbahn
ertränken => verdrinken
lauter => louter
schön => schoon
vergessen => vergeten
taxi => taxi
spielbudenplatz => spielbudenplatz
platz => plaats
vorgarten => voortuin
bestellen => bestellen
kiez => kiez
grüßen => groeten
welcome => welkom
missverständnisse => misverstanden
hsv => hsv
meiner => mijn
karneval => carnaval
normalen => normaal
lieber => liever
normaler => normaal
zone => zone
ganderkesee => ganderkesee
no => no
beatles => beatles
vollsuff => vollsuff
gerne => gaarne
mindestens => minstens
feiernd => vieren
meinem => mijn
fetten => invetten
fahren => varen
go => go
bier => bier
übrigens => overigens
slalom => slalom
straße => straat
zuhause => thuis
penisse => penissen
vorgärten => voortuinen
hamburger => hamburger
stinkt => stinkt
bars => bars
intensiven => intensief
touristen => toeristen
wollen => willen
hell => hel
grundschulen => basisscholen
wahrscheinlich => waarschijnlijk
pinkeln => piesen
gesprochen => gesproken
kreuzberg => kreuzberg
danken => bedanken
verteilen => verdelen
verbarrikadiert => gebarricadeerd
kennen => kennen
wahre => waar
halbausgepackte => half-uitgepakte
esc => esc
toiletten => toiletten
trendgetränk => trend drank
nerven => ergeren
bevor => voor
elmshorn => elmshorn
st => st
büchen => büchen
wohnzimmer => woonkamer
zahlreichen => talrijk
überall => overal
wochendtreiben => wochendtreiben
sonnigen => zonnig
himmelfahrt => hemelvaart
bepöbeln => bepöbeln
hauseingang => hauseingang
böse => boos
dönerreste => doner reste
wohnen => wonen
kurz => kort
b => b
stinken => stinken
eher => eerder
mexikaner => mexicaan
junggesellenabschied => junggesellenabschied
sauftouristen => sauftouristen
jemand => iemand
zugänglich => toegangelijk
unlängst => onlangs
selber => zelf
helsana => helsana
consumer => consument
leidet => lijdt
aktivitäten => activiteiten
patienten => patiënt
police => politiek
bedenken => bedenken
bringt => brengt
benecura => benecura
via => via
eigentlich => eigenlijk
problem => probleem
google => google
namen => namen
kalorien => calorie
feststellen => vaststellen
puls => pols
bestehen => bestaan
inzwischen => intussen
höhere => hoger
vorerst => vooreerst
benötigen => benodigen
steinmann => steinmann
symptom => symptoom
versicherungseigenen => verzekering eigen
angesprochen => aangesproken
konsultieren => consulteren
daniel => daniel
dossier => dossier
dominic => dominic
bonuszahlungen => bonusbetalingen
fragen => vragen
erich => erich
schnidrig => schnidrig
lebensstil => levensstijl
gerny => gerny
motivieren => motiveren
versicherung => verzekering
eigener => eigen
nutzen => benutten
silvia => silvia
swissmedic => swissmedic
sprechers => spreker
lancierung => lancering
suchen => uitzien
smartphone => smartphone
symptome => symptomen
vermeiden => vermijden
unterstützen => ondersteunen
sport => sport-
schnell => snel
mithelfen => helpen
versicherungsnehmers => verzekeringnemer
aschwanden => aschwanden
krankenkasse => ziekenkas
medizinalprodukt => medische product
medizinisch => medisch
existieren => existeren
swica => swica
versicherten => verzekerd
gesundheits => gezondheid
sammeln => verzamelen
betroffen => getroffen
erweist => bewijst
hausarzt => huisarts
reduzieren => reduceren
medienstelle => media stelle
pikant => pikant
markt => markt
stefan => stefan
hofft => hoop
bestimmen => bestemmen
versicherte => verzekerd
einzig => enig
praxis => praxis
flüchtlinge => vluchtelingen
spekulationen => speculatie
aktienoptionen => aandelenopties
amerikas => amerika
tief => diep
ökologische => ecologisch
kaffee => koffie
elf => elf
afp => afp
schwanger => zwanger
persönlichkeiten => persoonlijkheden
london => londen
medium => media
kandidatur => kandidatuur
konservative => conservatief
präsidentschafts => presidents-
ankündigung => aankondiging
anstreben => nastreven
dekrete => dekrete
symbole => symbolen
erstes => eerste
state => staat
nachzudenken => het denken
größter => de grootste
sanders => sanders
chaos => chaos
xetra => xetra
clinton => clinton
illinois => illinois
denken => denken
privater => privaat
hungerlöhne => hongerloon
herzen => omhelzen
edelmarke => edele merk
reichen => bereiken
sozialleistungen => sociale uitkeringen
brachte => bracht
verkaufen => verkopen
produzieren => produceren
milliardär => miljardair
rote => rood
schlechten => slecht
howard => howard
dollar => dollar
starbucks => starbucks
geworfen => geworpen
besorgt => bezorgd
reserve => reservaat
gegeißelt => gegeseld
otc => otc
rhetorische => retorisch
kategorisch => categorisch
tradegate => trade gate
lang => lang
vorsicht => voorzichtig
demokrat => democraat
immigration => immigratie
lokale => lokaal
sozialem => sociaal
übernahme => overname
wörtlich => woordelijk
ökonomische => economisch
feindlich => vijandelijk
schultz => schultz
weit => wijd
seattle => seattle
firma => firma
abschied => afscheid
eröffnung => opening
polarisierung => polarisatie
entwicklung => ontwikkeling
links => links
boykottieren => boycotten
kandidiert => kandidaat
italien => italië
mailand => milaan
supersonics => supersonics
kontur => contour
christliche => christelijk
disney => disney
gelingen => gedijen
linke => linker
optionen => opties
umschließen => insluiten
kaffeehaus => kaffeehaus
binnen => binnen
endlich => eindelijk
sportfans => sportfans
kritisierte => bekritiseerd
gruppen => groepen
verdiente => verdiend
imperium => imperium
bob => bob
erreichen => bereiken
unternehmer => ondernemer
rösterei => roosteren
nasdaq => nasdaq
schwarz => zwart
disneys => disney
global => globaal
finanziellen => financieel
basketballteam => basketbalteam
bernie => bernie
posten => posten
regel => regeling
arizona => arizona
university => universiteit
oklahoma => oklahoma
interviewer => interviewer
progressive => progressief
juni => juni
stuttgart => stuttgart
leer => leeg
heißen => heten
ländergrenzen => landsgrenzen
hotels => hotels
roland => roland
juli => juli
kante => rand
passagierrechtsportal => passagier recht portal
eurowings => eurowings
ans => ans
keppler => keppler
organisation => organisatie
komplexe => complex
reisenden => reizend
breiter => bredere
streiks => strikes
registrierte => geregistreerd
tuifly => tuifly
stark => sterk
einiges => enige
thomas => thomas
organisationsprobleme => organisatorische problemen
wissel => wissel
marc => marc
flugpassagiere => vliegtuigpassagiers
ungünstigem => ongunstig
experten => experts
metall => metalen
struktur => structuur
de => de
massiven => massief
britische => brits
österreicher => oostenrijks
insider => insider
mietjets => mietjets
schlechte => slecht
starke => sterk
ryanair => ryanair
griechenland => griekenland
portal => portaal
wetter => weer
datenbank => databank
janaillac => janaillac
streichen => strijken
flugreisen => flugreisen
zentrums => centrum
balearen => balearen
anbieten => aanbieden
geplant => gepland
infrastruktur => infrastructuur
konkurrent => concurrent
bürokratischen => bureaucratisch
insbesondere => in het bijzonder
beginn => begin
raumfahrt => ruimtevaart
kontrolle => controle
lufthansa => lufthansa
tragen => dragen
france => frankrijk
flugjahr => flight jaar
reservemaschinen => reserve machines
luftverkehrs => luchtverkeer
preise => prijzen
beratungsgesellschaft => beratungsgesellschaft
dlr => dlr
zwischenzeit => tussentijd
airborne => airborne
verspätungen => vertragingen
verbindungen => verbindingen
sorgten => bezorgd
pleite => pleite
überbleibsel => overblijfsel
deutliche => duidelijk
jean => jean
euclaim => euclaim
umleiten => omleiden
brachten => bracht
gerald => gerard
integrieren => integreren
berlin => berlijn
geduld => geduld
einstellen => instellen
palma => palma
mallorca => majorca
annullierungen => annuleringen
laudamotion => lauda motion
cook => kok
airbnb => airbnb
äußerst => uiterst
post => post
produkt => product
easyjet => easyjet
passagiere => passagiers
eigenen => eigen
fliegen => vliegen
maas => maas
chinesische => chinese
zelebrieren => celebreren
sportkleidung => sportkleding
ideal => ideaal
internationalen => internationaal
schkaplerow => schkaplerow
gefeiert => gevierd
diskriminierung => discriminatie
südosten => zuidoosten
kinderehen => kinderen gaan
ermordet => vermoord
nachbarländern => buurlanden
russische => russisch
männern => mensen
erzählt => verteld
safiye => safiye
kurdische => koerdisch
protestmärsche => protestmarsen
baloise => baloise
voranbringen => vooruitbrengen
sexismus => seksisme
liechtensteiner => liechtensteiner
konservativen => conservatief
energie => energie
videoclip => videoclip
alagas => alagas
mitarbeiterin => mitarbeiterin
china => china
donnerstag => donderdag
balzers => balzers
detailhändler => retail dealer
westeuropa => west-europa
jinnews => jinnews
diskriminiert => gediscrimineerd
ansporne => ansporne
sowjetrepubliken => sovjetrepublieken
internationale => internationaal
offerieren => offreren
landes => land
organisiert => georganiseerd
schreiben => schrijven
verloren => verloren
iss => iss
manuela => manuela
liechtenstein => liechtenstein
reuters => reuters
mission => mission
ehre => eer
demonstrieren => demonstreren
gesundheitsartikel => gezondheid artikelen
interview => interview
kosmonaut => kosmonaut
dyarbakir => dyarbakir
mikrofon => microfoon
passend => passend
töchtern => dochters
kurdischen => koerdisch
heiko => heiko
rundschau => rundschau
russland => rusland
workshops => workshops
türkei => turkije
angela => Angela
globus => globe
strasse => straat
matthes => matthes
nyffenegger => nyffenegger
bereit => bereid
reiben => wrijven
vergleich => vergelijking
frauentag => frauentag
darauf => daarop
wort => woord
jin => jin
türkische => turks
vaterland => vaderland
parties => partijen
raumstation => ruimtestation
osten => oosten
patriarchat => patriarchaat
weltfrauentag => wereld frauentag
konservativ => conservatief
göttinnen => godinnen
clara => clara
wahrnimmt => waarneemt
hände => handen
anton => anton
führungsposition => leidende positie
zetkin => zetkin
familienbild => familiefoto
königinnen => koninginnen
roskosmos => roskosmos
laif => laif
gewünschte => gewenste
hoffen => hopen
sexleben => seksleven
blaue => blauw
her => hier
pharmaforscher => pharma onderzoeker
viagra => viagra
erektionen => erecties
eins => eens
zugelassen => toegelaten
sildenafil => sildenafil
erfüllten => vervuld
pfizer => pfizer
pillen => pillen
längeren => langer
interessanten => interessant
halbes => half
wunder => wonder
rautenförmige => ruitvormig
grigory => grigory
gleich => gelijk
koffer => reiskoffer
grossbritannien => groot-brittannië
salisbury => salisbury
moskau => moskou
symmetrischen => symmetrisch
non => non
persona => persona
packen => pakken
ausweisungen => uitzettingen
grata => grata
matviyenko => matviyenko
diplomaten => diplomaten
westliche => westelijk
kia => kia
oberhauses => hogerhuis
kündigt => kondigt
dukor => dukor
gastland => gastvrij land
reaktion => reactionair
walentina => walvissen tina
ausweisen => uitwijzen
vorsitzende => voorzitter
strand => strand
eldorado => eldorado
julien => julien
floridas => florida
mexiko => mexico
prüde => preuts
richtig => recht
strände => stranden
mexikanische => mexicaans
sonne => zonnen
norden => noorden
cancun => cancun
abzufeiern => abzufeiern
alkohol => alcohol
retortenstadt => retort stad
fossati => fossati
partys => partys
studenten => studenten
martin => martin
sauf => sauf
krachen => kraken
ferrat => ferrat
matteo => matteo
berlusconi => berlusconi
parteien => partijen
bringen => brengen
partito => partito
keystone => keystone
anatoly => anatoly
luigi => luigi
partner => partner
populistischen => populistische
traditionell => traditioneel
lega => lega
freundschaftsvertrag => vriendschapsverdrag
herzlich => hartelijk
salvini => salvini
terrorismus => terrorisme
verbesserung => verbetering
populisten => populisten
argumentieren => argumenteren
ungelegen => ongelegen
vollzogen => voltooid
migrationsproblems => migratieproblemen
transatlantischen => transatlantisch
spalinger => spalinger
nahen => naderen
rechtspopulist => rechts populistische
protestpartei => protestpartij
höchst => hoogst
forza => forza
schweigen => zwijgen
heftig => heftig
democratico => democratico
eng => eng
skripal => skripal
isoliere => isolerend
gentiloni => gentiloni
maio => maio
zweier => twee
russischer => russisch
rom => rome
andrea => andrea
busenfreund => boezemvriend
politisch => politiek
verbunden => verbonden
weitverbreitete => wijd verspreid
russlandfreundlichen => russia-friendly
nato => navo
linken => links
italia => italia
nordafrika => noord-afrika
paolo => paolo
di => di
maltsev => maltsev
putins => putin
italiens => italië
russophil => russofiele
silvio => silvio
normalisierung => normalisatie
absprung => springen
gentilonis => gentilonis
kulturell => cultureel
cinque => cinque
beschlossen => besloten
russlands => rusland
gehackter => gehakt
schweden => zweden
britischer => brits
ecuadors => ecuador
verhindert => verhinderd
geheime => geheim
ecuador => ecuador
kommunikationsmittel => kommunikationsmittel
quito => quito
anderer => ander
ecudor => ecudor
geheimnisverrats => geheime verraad
wikileaks => wikileaks
spion => spion
londoner => londen
entgehen => ontgaan
kommunizieren => communiceren
assange => assange
gegenüber => tegenover
sda => sda
peter => peter
nicholls => nicholls
australier => australiërs
ecuadorianische => ecuadoriaans
stockholmer => stockholm
diplomatischen => diplomatisch
internetzugang => internettoegang
julian => julian
militärs => militair
auslieferung => aflevering
assanges => assange
minus => min
j => j
enormen => enorm
konzern => concern
bundesstaaten => deelstaten
jeff => jeff
freunde => vrienden
kommunen => kommunen
tweets => tweets
postsystem => postsysteem
hasst => haat
verbreiten => verspreiden
kritisch => kritiek
benutzen => benutten
governments => overheden
retailers => retailers
u => u
weißen => witten
onlineportal => online portal
getitelt => getiteld
reiche => rijk
zahlen => tellen
and => en
long => long
präsidenten => president
ändern => veranderen
system => systeem
quellen => kwellen
bezos => bezos
out => uit
axios => axios
realdonaldtrump => echte donald trump
schäden => schade
tausend => duizend
local => lokaal
lange => lang
unser => ons
postal => post-
enorm => enorm
sarah => sara
website => webstek
i => i
amazon => amazon
as => als
kritischen => kritisch
business => business
heterosexuellen => heterosexual
pflichten => verplichtingen
adoptionsrechts => adoptie recht
partnerschaft => partnerverband
reinhard => reinhard
göttler => göttler
allen => alle
lebten => leefden
sprecher => speaker
schlossen => gesloten
hannover => hannover
geschlossen => gesloten
partnerschaften => partnerships
friedrich => friedrich
hielten => held
paaren => paren
bundestag => bundestag
lebenspartnerschaft => levenspartnerschap
sommerpause => sommerpause
rechtliche => wettelijk
köln => keulen
dorle => dorle
alleine => alleen
quartal => kwartaal
großstädten => grote steden
lebenspartnerschaften => levenspartnerschappen
claudia => claudia
harre => harre
hamburg => hamburg
bundesrat => bundesrat
lesbischen => lesbisch
homosexueller => homoseksueel
lüschow => lüschow
gefängnis => gevangenis
typen => types
wünschen => wensen
wirklich => werkelijk
johannes => john
nein => nee
online => online
cleveland => cleveland
kaufen => kopen
großer => groot
traumatisiert => getraumatiseerd
blitzableiter => bliksemafleider
puncher => ponser
genießen => genieten
embryo => embryo
präsentiert => presenteert
frazier => frazier
halle => halle
beschreiben => beschrijven
sünden => zonden
verwirrt => verward
binden => binden
aufgebrochen => gebroken
stimmte => gestemd
rassist => racist
sichtbar => zichtbaar
besonderes => bijzonder
muhammad => mohammed
geld => geld
ernstgenommen => serieus genomen
ersten => eerste
realist => realist
images => images
kontakt => contact
carter => carter
promoter => promotor
planet => planeet
lösungen => oplossingen
bekannter => bekend
härtere => hardere
joe => joe
ohio => ohio
ali => ali
rassismus => racisme
joshua => joshua
höhen => hoogten
tyson => tyson
eindeutig => eenduidig
lösen => oplossen
joseph => jozef
verändert => veranderd
propaganda => propaganda
aufspielen => spelen
nelson => nelson
verändern => veranderen
anthony => anthony
opfern => offeren
dankbar => dankbaar
mache => maken
titelvereinigung => titel eenwording
tageslicht => daglicht
king => koning
verstanden => verstaan
entmenschlicht => ontmenselijkt
jimmy => jimmy
pin => pin
goebbels => goebbels
foreman => voorman
getty => getty
meine => mijn
politischer => politiek
davor => daarvoor
besseren => beter
baddest => baddest
vergleichen => vergelijken
wortschatz => woordenschat
geliebt => geliefd
don => don
oh => och
krankenhaus => ziekenhuis
stürzen => storten
ständig => bestendig
schwergewicht => zwaargewicht
unparteiisch => onpartijdig
schuldete => verschuldigd
box => doos
passten => passen
komponenten => componenten
gebüßt => geboet
bessere => beter
erfinden => uitvinden
boxer => bokser
kämpfen => kampen
heiliger => heilig
vieler => veel
punkt => punt
solange => zolang
gezwungen => gewrongen
daraus => daaruit
ehren => eren
passt => passen
vorstellen => voorstellen
treten => betreden
erklären => verklaren
mandela => mandela
ap => ap
unterdrückt => onderdrukt
ursprung => oorsprong
fronten => fronten
fanatismus => fanatisme
boxen => boksen
lügen => liegen
lieben => liefhebben
überzeugen => overtuigen
parker => parker
ideale => ideaal
vorher => vooraf
menschliche => menselijk
reagierte => reageerden
mazda => mazda
fahrzeug => voertuig
autopilot => autopilot
autonom => autonoom
fahrassistenzsysteme => driver assistance systems,
unmöglich => onmogelijk
gehandelt => verhandeld
konzentrieren => concentreren
systems => systeem
negativ => negatief
technischen => technisch
ruf => ruf
freitagabend => vrijdagavond
tesla => tesla
verunglücktes => verunglücktes
fokus => focus
überfahren => overvaren
auto => auto
audi => audi
x => x
stand => staan
sekunden => seconden
dapchi => dapchi
borno => borno
islamistischen => islamistische
maiduguri => maiduguri
etliche => ettelijke
nahe => ernaast
edet => edet
okon => okon
haram => haram
nigeria => nigeria
freigelassen => vrijgegeven
nigerias => nigeria
terrormiliz => terreur militie
nordosten => noordoosten
boko => boko
februar => februari
toten => dood
begruben => begraven
camedo => camedo
locarno => locarno
tote => dood
begräbt => begraaft
domodossola => domodossola
ansa => ansa
just => juist
tessiner => ticino
hunden => honden
val => val
vigezzo => vigezzo
re => re
donnerten => donderde
kilometer => kilometer
rettungsteams => reddingsteams
ausreichend => toereikend
rohkostanteil => rohkost aandeel
korrekte => correct
wilde => wild
verdauen => verteren
ileostomiepatienten => ileostomie patiënten
schliefen => sliep
absolut => absoluut
kauen => kauwen
biologische => biologisch
evolutionstheorie => evolutietheorie
gift => gif
polaren => polair
völlig => volledig
dokumentierten => gedocumenteerd
gewicht => gewicht
geschriebenen => geschreven
fans => fans
sparen => sparen
ausgangsgewicht => uitgang gewicht
erfordern => vorderen
dickdarm => dikke darm
effizienter => efficiëntere
kleineren => kleinere
gemein => gemeen
primatologie => primatology
ökonomischen => economisch
beide => beide
kombiniert => gecombineerde
lippen => lippen
bietet => biedt
rechtfertigen => rechtvaardigen
ca => ca
praktisch => praktisch
these => thesis
untergewichtig => ondergewicht
frei => vrij
verdeutlichte => verduidelijkt
relativ => relatief
kochen => koken
lebensmitteln => levensmiddelen
biologie => biologie
passen => passen
daher => dus
homo => homo
pseudowissenschaftliche => pseudowetenschappelijke
kaloriengehalt => caloriegehalte
erectus => erectus
pürierstäben => pürierstäben
paleo => paleo
klettern => klimmen
methoden => methoden
qualität => kwaliteit
mahlen => malen
erhöhen => verhogen
signifikant => significant
wildnis => wildernis
große => grote
unrealistisch => onrealistisch
verzehren => verorberen
kartoffeln => aardappelen
unfruchtbar => onvruchtbaar
modernen => modern
schnellere => sneller
gekochter => gekookt
c => c
keime => kiemen
urinieren => urineren
hunger => honger
dünndarm => dunne darm
vitamine => vitaminen
realität => realiteit
deswegen => deswege
gebieten => bevelen
ideologische => ideologisch
veränderungen => veranderingen
groß => groot
vergiftungsrisiko => vergiftiging risico
überleben => overleven
versuchung => verleiding
kohlenhydraten => koolhydraten
anthropologie => antropologie
bauchfett => buikvet
energieversorgung => energievoorziening
naturnah => naturnah
gekochtes => gekookt
bakterien => bacterie
notsituationen => noodsituaties
umgebung => omgeving
rettung => redding
rohkoststudie => rohkost studie
denaturierung => denaturatie
katalysator => katalysator
kritische => kritisch
richard => richard
primaten => primaat
länger => langer
darmflora => darmflora
mund => mond
somit => somiet
enzymen => enzymen
physiologie => fysiologie
schimpansen => chimpansees
gekochte => gekookt
normalfall => normale geval
harvard => harvard
smoothie => smoothie
magens => magens
evolutionäre => evolutionaire
rohkost => rohkost
affen => apen
höchstens => hoogstens
energiereiche => energie
ganzjährig => gansjarig
tiere => dieren
fälle => falls
primatologe => primatologist
energiewert => energiewaarde
begann => begonnen
veränderung => verandering
verschiedenen => verschillend
verursachen => veroorzaken
teils => deels
unnatürlich => onnatuurlijk
zentraler => centraal
toxine => toxines
habitaten => habitats,
eiferer => ijveraar
spezifischen => specifiek
derweil => terwijl
gießener => giessen
habilis => habilis
wrangham => wrangham
verbraucht => verbruikt
verbessert => verbeterd
mehrgewinn => meer winst
verwandeln => veranderen
effektiven => effectief
universität => universiteit
kumuliert => gecumuleerde
magerem => mager
prämisse => premisse
gründen => grondvesten
stämmen => stammen
massive => massief
bevorzugen => bevoorrechten
gesund => gezond
erhöht => verhoogd
leicht => licht
ratten => rattus
moderner => modern
erleichtern => verlichten
exakt => exact
vorteile => voordelen
lauten => luiden
retten => redden
kratzen => krabben
installieren => installeren
internetkonzerne => internet bedrijven
entwicklern => ontwikkelaars
stiftung => stichting
offene => geopende
star => star
manifest => manifest
optional => optioneel
internetnutzer => internet-gebruikers
rang => rang
valley => vallei
chrome => chroom
firefox => firefox
apple => appel
browser => browser
favorisierten => favoriet
eigene => eigen
dienste => diensten
mozilla => mozilla
zehnte => tiende
ons => ons
videoplattform => videoplatform
standard => standard
marktanteil => marktaandeel
abgelaufen => afgelopen
youtube => youtube
bruder => broer
silicon => silicone
bereichern => verrijken
software => software
zwingend => dwingend
führungswechsel => führungswechsel
truppen => troepen
flugabwehrsystem => luchtafweer systeem
kommando => commando
mantis => mantis
grondgebonden => grondgebonden
beider => beide
defensie => defensie
niederländischen => nederlands
niederlande => nederland
fortan => voortaan
westafrikanischen => west-afrikaanse
stationiert => gestationeerd
vredepeel => vredepeel
luchtverdedigingscommando => luchtverdedigingscommando
ausbildungsakademie => trainingsacademie
mali => mali
schießplatz => schietbaan
holsteinischen => holstein
streitkräfte => strijdkrachten
soldatinnen => soldaat binnen
luftverteidigung => luchtverdediging
schleswig => schleswig
todendorf => dood dorp
niederländisches => nederlands
stationierten => gestationeerd
hoch => hoog
zweite => tweede
vorzeitig => voortijdig
höher => hoger
vergütung => vergoeding
runden => afronden
berufsgruppen => beroepsgroepen
steigen => stijgen
höchsten => hoogst
süddeutsche => zuidduitse
azubis => azubis
forderte => spoorde
abgebrochenen => afgebroken
entwurf => ontwerp
quoten => quota
lehrlingen => leerlingen
hannack => hannack
extrem => extreem
jobs => jobs
azubi => azubi
beginnen => beginnen
anteil => aandeel
dgb => dgb
köche => koks
geplante => geplande
prozesstagen => proces-dagen
gericht => gerecht
hinrichtungsvideos => hinrichtung videos
sylvest => sylvest
psychologische => psychologisch
hinrichtungsvideo => hinrichtung video
fallen => vallen
zufälligerweise => toevalligerwijze
jepsen => jepsen
panik => paniek
zeugen => getuigen
journalistin => journalist
madsens => madsen
interessierte => geïnteresseerd
menschlichen => menselijk
madsen => madsen
jenni => jenni
bekannte => bekend
tour => tour
thier => thier
festplatten => festplatten
zugegeben => toegegeven
videos => videos
wall => wal
erscheint => verschijnen
ecken => hoeken
jakob => jakob
detailliert => gedetailleerd
neunten => negende
missbraucht => misbruikt
einladen => inladen
kopenhagener => kopenhagen
kopenhagen => kopenhagen
dänischen => deens
boot => boot
regelmässig => regelmatig
dorf => dorp
ziehen => telen
stück => stuk
quasi => quasi
industriell => industrieel
mitmachen => meemaken
freiburg => freiburg
neuenegger => nieuwe egger
platte => plaat
karin => karin
zugverbindungen => treinverbindingen
einkaufen => inkopen
puzzelt => puzzelt
nzz => nzz
dunkelgrünen => donkergroen
netzwerke => netwerken
susanne => susana
klaffen => gapen
puzzeln => puzzeln
jüngste => jongste
dorfplatz => dorfplatz
puzzlezimmer => puzzel kamer
säcken => zakken
dorfbewohnern => dorpsbewoners
plattformen => platforms
hofer => hofer
zusammengesetzt => samengesteld
verewigen => vereeuwigen
dynamik => dynamica
grossfamilie => grote familie
neugierig => nieuwsgierig
beschreibt => beschrijft
wenger => wenger
städten => steden
portmann => portmann
entwicklungen => ontwikkelingen
flyer => flyers
dorfgemeinschaft => dorpsgemeenschap
feiert => viert
dorfbewohner => dorpsbewoner
papier => papier
gezogen => getrokken
informelle => informele
gemeindehaus => bedehuis
verschwindet => verdwijnt
kleben => kleven
puzzle => puzzel
geniessen => genieten
zwanzig => twintig
teilen => delen
bern => bern
gelegen => gelegen
wand => wand
integrationsprojekt => integratieproject
dörfer => dorpen
kontakte => contacten
konzentriert => geconcentreerd
individualismus => individualisme
stecken => steken
live => live
mobiler => mobiel
puzzleteile => puzzleteile
neuenegg => neuenegg
espresso => espresso
losen => loten
anonymität => anonimiteit
ausstellen => uitstallen
bestellte => bestelde
traugott => traugott
sortierten => geassorteerd
soziologie => sociologie
bernischen => berner
vöhringer => vöhringer
neugierige => nieuwsgierig
rot => rood
kirchgemeindehaus => kirch gemeindehaus
fragt => vraagt
anonymisierung => anonimisering
puzzles => puzzels
handelsstreit => handelsgeschil
folgen => volgen
exportieren => exporteren
deutlichen => duidelijk
schwelende => smeulende
einbruch => inbraak
umsetzen => omzetten
ängste => angsten
technologie => technologie
exporte => export
diebstahl => diefstal
chinesischen => chinese
handelsdefizit => handelshiaat
chinas => china
bestätigung => bevestiging
arme => arm
evergreen => evergreen
resultat => resultaat
grotesk => grotesk
endlosschlaufe => eindloze lus
hermann => hermann
theorie => theorie
fordern => vorderen
querbeet => querbeet
sektor => sector
langer => lang
eigenheim => eigenheim
fördern => bevorderen
wohnraum => woonruimte
liberal => liberaal
regulierten => gereguleerd
konstantem => constante
quartiere => quartiere
günstigem => gunstig
primärmarkt => primaire markt
wohnungsmarkt => woningmarkt
sekundärmarkt => secundaire markt
deregulierung => deregulering
sozial => sociaal
entkommen => ontkomen
kommentar => commentaar
verkorkstem => verkorkstem
stockholm => stockholm
schwedens => zweden
debatte => debatteren
bezahlt => betaald
visum => visum
aufschlag => toeslag
ergattert => ergattert
landesweit => landelijk
individualisten => individualisten
immigranten => immigranten
rudolf => rudolf
bewohnt => bewoond
verzerrungen => vervormingen
zerbrechen => breken
verschrieben => voorgeschreven
negativen => negatief
verschärft => aangescherpt
typischen => typisch
südeuropa => zuid-europa
konfuzianisch => confucianistische
interessanter => interessant
konflikten => conflicten
reformation => reformatie
beantworten => beantwoorden
missliebiges => miss liebiges
ungeduldiger => ongeduldig
intuitiv => intuïtief
individuelle => individu
grad => graad
afrika => afrika
nigerianer => nigeriaanse
trauen => trouwen
zollikon => zollikon
klima => klimaat
fischer => visser
starker => sterk
protestanten => protestants
generell => generiek
südkorea => zuid-korea
individuellen => individu
amerikaner => american
gemessen => afgemeten
orientiert => georiënteerde
max => max
reich => rijk
entwickelten => ontwikkelde
sanktionieren => sanctioneren
starten => starten
bonn => bonn
historisch => historisch
nordeuropa => noord-europa
portugiesen => portugees
set => set
diskussionspapier => discussienota
antworten => antwoorden
kultur => cultuur
friktionen => fricties
gymi => gymi
erweisen => bewijzen
spielen => spelen
bestrafen => straffen
traditionelle => traditioneel
unterstützung => ondersteuning
blieb => bleef
erstens => eerst
einleuchtet => einleuchtet
interessante => interessant
weber => wever
produktivem => produktief
protestantisch => protestants
verteilung => verspreiding
griechen => grieken
kooperativem => coöperatieve
grösser => groter
sozialer => sociaal
religion => religie
technologischem => technologisch
anderes => ander
finnen => finnen
geduldig => geduldig
fehr => fehr
kapital => kapitaal
falk => valk
risikobereitschaft => risicobereidheid
armin => armin
länderspezifische => landspecifieke
übrig => overig
vertrauen => vertrouwen
australien => australië
interessanterweise => interessanterwijze
bewaffneter => bewapend
antioch => antiochië
flüchtigen => vluchtig
gäste => gasten
gliedstaat => lidstaat
flucht => vlucht
restaurant => restaurant
nashville => nashville
gewehr => geweer
spiel => spel
schalke => schalke
marco => marco
klub => club
hector => hector
simon => simon
breel => breel
timo => timo
ukrainer => oekraïens
koziello => koziello
punkte => points
bentaleb => bentaleb
ruthenbeck => ruth beck
pass => pas
profitierte => geprofiteerd
salih => salih
horn => horn
saison => seizoen
saisonende => saisonende
liga => liga
yevhen => yevhen
schlechteste => slechtst
stambouli => stambouli
höger => höger
theoretisch => theoretisch
marcel => marcel
ralf => ralf
schiedsrichter => scheidsrechter
champions => kampioenen
metern => meter
restprogramm => rust programma
sörensen => sorensen
mckennie => mckennie
özcan => özcan
maroh => maroh
perfekt => perfect
fährmann => fährmann
goretzka => goretzka
spieltage => speldag
qualifikation => kwalificatie
fritz => fritz
fc => fc
spielte => gespeeld
terodde => terodde
verbleibenden => overblijvende
mere => mers
bereitete => bereid
naldo => naldo
leonardo => leonardo
oczipka => oczipka
caligiuri => caligiuri
embolo => embolo
borussia => borussia
konoplyanka => konoplyanka
santo => santo
wolfsburg => wolfsburg
gefallen => behagen
kölner => kölner
jonas => jona
zweiter => tweede
minute => minuut
trainer => trainer
heintz => heintz
karten => kaarten
burgstaller => burgstaller
schlussphase => sluitfase
mönchengladbach => mönchengladbach
conte => conte
waffel => wafel
eingreifen => ingrijpen
geflüchtet => vluchtte
vergleichbares => vergelijkbaar
grabbing => grijpen
m => m
bewiesen => bewezen
superman => superman
glücklich => gelukkig
bescheiden => bescheiden
shot => shot
angekommen => aangekomen
held => held
kill => Kill
sorry => sorry
chrisconte => chris conte
aaron => aäron
verhinderte => verhinderd
t => t
hands => handen
jr => jr
shaw => shaw
gast => gast
opened => geopend
egoismus => egoïsme
he => hee
com => com
wegzunehmen => wegnemen
at => at
ehrlich => eerlijk
betreten => betreden
mnpdnashville => mnpdnashville
chris => chris
persons => personen
lokal => lokaal
pic => pic
vermisst => vermist
metro => metro
menschenleben => mensen wonen
möglicherweise => mogelijkerwijs
hair => haar
is => is
wagen => wagen
breaking => breuk
fallender => vallend
more => More
teller => teller
terminator => terminator
vierte => vierde
waffle => waffle
house => huis
couldn => couldn
murfreesboro => murfreesboro
short => short
vagina => vagina
königin => koningin
spitzen => slijpen
psychologen => psychologen
ansicht => uitzicht
spektakulär => spectaculair
bootes => bootes
bekannten => bekend
einstimmig => eenstemmig
sexuell => seksueel
rechtssystem => rechtssysteem
unwahrscheinlich => onwaarschijnlijk
bauchgefühl => bauchgefühl
spektakulären => spectaculaire
gefangene => gevangene
geschehen => geschieden
perfekten => perfect
exzentrischen => excentriek
leiche => lijk
gestört => gestoord
tragischer => tragisch
mord => moord
echter => echt
dänemark => denemarken
gittern => gittern
normalerweise => normaliter
richterin => rechter
erfinder => uitvinder
freiheitsstrafe => vrijheid straf
beweise => bewijzen
eingeschätzt => geschatte
richter => rechter
kinderkriegen => kinderen krijgen
obsessiv => obsessieve
debüt => debuut
verlassene => verlaten
komplexer => complex
nadja => nadja
begonnen => begonnen
erwachsen => volwassen
afroamerikanische => afro-amerikaanse
erfahren => ervaren
pastorensöhnen => pastor zonen
aubrey => aubrey
keck => kek
football => voetbal
tröstlich => troostend
einst => eens
junger => jong
college => college
rechtfertigung => rechtvaardiging
flops => flops
strenge => streng
mahnen => manen
vergleichender => vergelijkende
stillschweigend => stilzwijgend
luke => luik
intelligent => intelligent
wildes => wild
abzuwägen => wegen
fromme => vroom
tragische => tragisch
sportlerkarriere => sportman carrière
latenten => latent
monologe => monologen
stimmen => stemmen
augen => ogen
kaliforniens => californië
emma => emma
detje => detje
explizit => expliciet
feinem => fijn
nadjas => nadja
tragödie => tragedie
motels => motels
weiber => weiber
robin => robin
abwesenheit => afwezigheid
süden => zuiden
geschriebene => geschreven
rebellisch => rebel
lady => lady
ungleicher => ongelijk
griechischen => grieks
gemeinschaft => gemeenschap
talentierter => getalenteerd
verzeiht => vergeeft
roman => roman
städtchen => städtchen
figur => figuur
rowohlt => rowohlt
brit => brit
funktionieren => functioneren
afroamerikanerin => afro-amerikaanse
first => eerste
bennetts => bennetts
stille => stil
parks => parken
gewohnt => gewend
verwegen => vermetel
konkurrierenden => concurrerende
selbstoptimierten => zelf-geoptimaliseerde
sonnenblumen => zonnebloemen
deuten => duiden
metapher => metafoor
lachen => lachen
tee => Tee
sixtinischen => sixtijnse
entgegen => ontwijken
gehasst => gehaat
good => goed
produkten => producten
glas => glas
kapelle => kapel
startup => startup
gastronomie => gastronomie
chips => chips
popcorn => popcorn
ploppt => ploppt
apfel => appel
belegt => bezet
sirplus => sirplus
snacks => snacks
mangosaft => mangosap
etepetete => etepetete
mhd => mhd
haltbarkeitsdatum => haltbarkeitsdatum
suv => suv
november => november
erzähle => vertellen
deckel => deksel
gegenteil => tegendeel
entdecke => ontdekken
marken => merken
würgen => wurgen
genießbar => eetbaar
veggie => veggie
tür => deur
spontan => spontaan
knabbern => knabbelen
orangenen => oranje
vermeidbar => vermijdbaar
kontrolliert => gecontroleerde
geretteten => gered
aufgewärmt => opgewarmd
industrie => industrie
milch => melk
geschmack => smaken
entsorgen => ontdoen
laden => laden
enthalten => onthouden
karton => karton
meines => mijn
unüberbrückbarer => onoverbrugbare
kilogramm => kilogram
angeboten => aangeboden
tonnen => tons
freundes => vriendje
retterbox => retterbox
ziemlich => tamelijk
biosupermarkt => biosupermarkt
studie => studie
bundesministerium => bundesministerium
ökologischem => ecologisch
tu => tu
testen => testen
achte => achtste
kokosmilch => kokosmelk
zaubern => toveren
keimen => kiemen
landet => landt
bälle => ballen
unstimmigkeiten => unstimmigkeiten
talent => talent
wasn => wasn
entschuldigen => verontschuldigen
sting => sting
ausruhen => uitrusten
interviews => interviews
bestes => best
hartnäckig => hardnekkig
humor => humor
mitbringen => meebrengen
hall => hal
johanna => johanna
aufrichtig => oprecht
jemanden => iemand
versuchen => verleiden
albert => albert
album => album
lacht => lacht
musikgeschäft => muziekwinkel
liebster => liefste
vibe => vibe
lied => lied
überzeugt => overtuigd
kontext => context
beste => best
song => song
genossen => genoten
alphatiere => alpha dieren
schmutzig => schunnig
übernehme => overnemen
make => maken
royal => royal
songs => songs
me => me
einander => elkander
amüsierten => geamuseerd
künstler => kunstenaar
studio => studio
kurzer => kort
gespielt => gespeeld
sage => sage
martina => martina
gelernt => geleerd
hörte => gehoord
reingeschoben => reingeschoben
pizza => pizza
england => engeland
umarmen => omarmen
interessiere => geïnteresseerd
anhören => aanhoren
aufschieben => verschuiven
lebenswege => lebenswege
koche => kok
hellfritz => helder fritz
caro => caro
gern => eer
begrüßen => begroeten
rebelliert => rebellen
vorurteile => vorurteile
schminken => schminken
neuseeland => nieuw-zeeland
computerspiele => computerspelletjes
kinofilme => kinofilme
echt => echt
unbeschreiblich => onbeschrijfelijk
privat => privé
erwachsene => volwassen
einteilen => indelen
geburtsvorbereitungskurs => geboorte voorbereidingscursus
vorgeben => voorwenden
besten => best
finde => vinden
ärgern => ergeren
zufrieden => tevreden
erstmal => eerste
türen => deuren
rhythmus => ritme
zweifel => betwijfelen
planen => plannen
freunden => vrienden
mehrmals => meermaals
kita => kita
dachten => gedachte
hinzubekommen => hinzubekommen
gefragt => gevraagd
ding => ding
behalten => behouden
weglaufen => weglopen
kindes => kind
absprechen => afspreken
verantwortlich => verantwoordelijk
skeptisch => sceptisch
gymnastik => gymnastiek
telefoniere => telefoon
direkter => direct
freundschaften => vriendschappen
übernehmen => overnemen
eigenes => eigen
rauchen => roken
situationen => situaties
nötig => nodig
heidelberg => heidelberg
studentin => student
verdiene => verdienen
freiheit => vrijheid
diejenige => diegene
michel => michel
lieb => lief
gasmasken => gasmaskers
drin => erin
unterdessen => ondertussen
autos => auto's
vulkanausbruch => vulkanausbruch
blocks => blocks
lavafontänen => lavafonteinen
leilani => leilani
donnerstagnachmittag => donderdagnamiddag
plünderer => plunderaar
vulkans => vulkaan
mitnehmen => meenemen
hawaii => hawaï
naturspektakel => natuurspektakel
lava => lava
stenback => stenback
erscheinen => verschijnen
halbe => half
maija => maija
handvoll => handvol
kindern => kinderen
rausgefahren => rausgefahren
puna => puna
regelmäßig => regelmatig
draußen => buiten
traurig => treurig
vulkan => vulcan
artikels => artikel
verlieren => verliezen
telefonieren => telefoneren
abaya => abaya
ausbricht => uitbreekt
enorme => enorm
priorität => prioriteit
taschen => tassen
dauern => duren
checkpoint => checkpoint
viral => viraal
rauszuholen => rauszuholen
hallo => hallo
super => super
rauszubekommen => rauszubekommen
warten => wachten
babyfotos => babyfoto's
rein => rein
hoffentlich => hopelijk
brach => braak
gestoppt => gestopt
jenny => jenny
gebäudes => gebouw
obdachlosen => dakloos
beschliesst => beslist
durkan => durkan
ursprünglich => oorspronkelijk
tech => tech
zunehmen => toenemen
kompromissvorschlag => compromisvoorstel
zweites => tweede
hauptquartier => hoofdkwartier
ausgehandelten => onderhandeld
stetig => bestendig
betrag => bedrag
grössere => grotere
montreal => montréal
mls => mls
western => western
angeles => angeles
tabellenplatz => table plaats
impact => impact
petrasso => petrasso
zlatan => zlatan
michael => michaël
club => club
videobeweises => video bewijs
gegenspieler => tegen spelers
fußballstar => football-ster
hand => hands
flog => vloog
ibrahimovic => ibrahimovic
ismail => ismail
elfath => elfath
ibrahimovics => ibrahimovic
anschließend => aansluitend
conference => conferentie
la => la
theatralisch => theater-
einsammeln => inzamelen
stacey => stacey
exchance => exchance
fonds => fonds
finanzinvestor => financiële investeerder
yorker => yorker
intercontinental => intercontinental
kommentieren => commentariëren
folgt => volgt
voran => vooraan
cunningham => cunningham
farley => farley
finanztechnologie => financiële technologie
ice => ijs
verantwortete => verantwoordelijk
parkett => parket
adena => adena
nyse => nyse
finanzsektor => financiële sector
leitung => besturing
catherine => catherine
kinney => kinney
tom => tom
friedman => friedman