regionales => regional
crucial => crucial; pivotal; essential; critical; important; vital; all important; all-important; eventful; of the essence
parece => appears to be; judgement; opinion; view
estos => these; this
tenían => they had
líder => leader; head; guide; potentate; boss; chief; chieftain; director; authority; leading
acabar => finish; end; terminate; cease; complete; conclude; end up; stop; cum; close
oficiales => official
permanecerán => they will remain
provincia => province; country; area; district; land; region; state; county; city; department
dinero => money; cash; dough; currency; silver; allowance; cash in hand; change; coin; coinage
sami => Sami; Saami; Laplander; Laplanders; Lapp; Lapps; Sámi; the Sami peoples
candidatos => candidates
lugar => place; location; locus; elsewhere; venue; position; site; spot; room; village
hikma => hikma
encuentro => meeting; encounter; bout; match; rendezvous; appointment; brush; clash; confrontation; date
tropas => troops; army; military forces; state; combat troops; line troops; line units; military personnel; soldiery
millones => millions
corroe => corrode
desierta => deserted
karrada => karrada
conducen => they lead
isis => isis
mosul => mosul
irak => iraq; republic of iraq
corrupción => corruption; taint; bribery; corruptibility; corruptness; deforming; distortion; graft; rottenness; vitiation
impedir => prevent; hinder; impede; preclude; foreclose; obstruct; block; forestall; inhibit; stop
primer => primal; first; 1st; beginning; inaugural; initiatory; original; primary; prime
primeros => first
unidos => united
llevado => born
periodista => journalist; reporter; newsman; newspaperman; newsperson; correspondent; newspaperwoman; pressman; commentator; newswoman
poder => can; power; be able to; may; might; proxy; be able; authority; able; could
sufren => suffer
febrero => February; Feb; February(februaro); Horning; february
lista => list; stripe; roster; queue; strip; roll; register; checklist; clever; schedule
tres => three; third; tres; thirty; three(tri); tree; trey
bloqueaba => i blocked
confesionalismo => confessional
mejorado => improved; enhanced; better; bettering
además => besides; furthermore; moreover; additionally; also; in addition; to boot; further; other; again
fuerzas => forces
estarán => will be
por => by; for; per; through; times; with; along; around; about; after
hace => ago; work
política => politics; policy; politician; political; government; public life; pol; politic; political relation; political science
wadi => wadi
quiere => wants
ministro => minister; secretary; cabinet minister; Secretary of State; indigo bunting; Secretary; father; foreign minister; government minister; judge
incluyen => include
cambiar => change; exchange; alter; shift; vary; convert; switch; replace; transfer; break
tiene => has
barrio => neighbourhood; quarter; neighborhood; district; ward; area; borough; barrio; suburb; city district
sur => south; South; southerly; southland; southward; S; due south; south(sudo); southern
bagdad => baghdad
jóvenes => young; youth; young people; youngsters
según => according to; according; as; per; accordingly; in accordance with; after; pursuant to; under; according as
víctimas => victims
aéreo => aerial; air; airy; overhead; airborne; flying; overground; chimeric
al => to the; aluminium; aluminum; Al; a; al; atomic number 13; by; etch; with
vida => life; lifetime; living; existence; lifespan; live; livelihood; liveliness; path; spirit
yihadista => jihadist; jihadi
rehabilitar => rehabilitate; rehab; reinstate; renovate; reprieve; restore
un => one; an; a; e-mail; email; a certain; any; some; you; an(nedifinaartikolo)
chiíes => shiites
dominante => dominant; pervasive; commanding; domineering; ruling; dominating; masterful; ascendant; predominant; ascendent
islámico => Islamic; islamic; Islamitic; Moslem; Muslim; Islamite; Islamitish
obtuvo => got
alí => ali
seguridad => security; safety; safeness; assurance; certainty; confidence; surety; authority; peace; protection
estructuras => structures
mohamed => mohamed
caída => fall; drop; tumble; crash; dip; downfall; spill; collapse; falling; hang
reconstrucción => reconstruction; rebuilding; alteration; conversion; reconstitution; reconstructive memory
primera => first; former; prime; 1st; early; first class; front; low
dignatarios => dignitaries
kurdos => kurds
posición => position; stand; location; place; stance; attitude; posture; situation; status; standing
perder => lose; miss; forfeit; fail; mislay; misplace; leak; lost; drop; forego
cuatro => four; 4; foursome; fourth; cuatro; IV; Little Joe; coxless four; forty; four(kvar)
cual => which; whom; as; that; who; cual; just as; like; such as; whatsoever
controlaban => they controlled
afecta => it affects
recientemente => recently; lately; newly; of late; the other day; freshly; just; latterly; not long ago; now
han => Han; Dawson
omar => omar
gubernamentales => governmental
violencia => violence; force; assault; aggression; ferocity; fury; vehemence; bashing; constraint; fierceness
destrucción => destruction; devastation; demolition; obliteration; death; havoc; undoing; bane; blasting; depletion
datos => data; material; corpus; details; facts; gen; information; intelligence; particulars
no => no; not; nope; nay; don't; eh; no.; No; No.; negative
va => goes
durante => during; for; over; throughout; while; whilst; when; within; durante; at
precedentes => case law; judge-made law
en => in; at; on; into; upon; inside; for; by; to; an
cerrados => closed
este => this; east; this one; East; here; that; these; easterly; eastern; eastward
apertura => opening; aperture; beginning; commencement; inauguration; openness; start; gap; liberalization; perforation
electoral => electoral; election; elective; voting
hasta => until; till; even; up to; by; til; to; also; as far as; quite
claves => keys
preocupación => worry; concern; anxiety; burden; trouble; issue; care; preoccupation; trepidation; fear
equilibrio => equilibrium; balance; poise; counterbalance; equilibration; equipoise; proportion; proportionality; armstand; armstand position
tenga => behold; here are; here is; look
nuevos => new
alterar => alter; tamper; change; modify; distort; disturb; disrupt; transform; upset; vary
espera => wait; expectation; waiting; anticipation; delay; hold; standby; abeyance; latency; latency time
amiri => amiri
desde => since; from; as of; for; because; out of; desde; a long time; by; formerly
invasión => invasion; trespass; raid; encroachment; intrusion; infestation; flood; infringement; inroad; invasion of privacy
todo => all; whole; everything; entire; every; each; complete; full; total; any
organizados => organized
votar => vote; ballot; poll; vow; attune; pass; running; vote in; vote(voĉdoni)
iraquí => Iraqi; iraqi; Irakian; Iraqian; Iraqui
territorios => territories
aliados => allies
punto => point; dot; full stop; mark; period; stitch; place; spot; count; knitting
quienes => whom; who
entre => between; among; amid; amongst; amidst; betwixt; in between; into; midst; entre
también => also; too; as well; likewise; then; in addition; besides; addedly; and; moreover
fue => it was
una => one; an; a; they; fingernail; nail; toenail; another; either; o'clock
comicios => election; elections
listas => lists
populista => populist; democrat
que => that; than; what; which; as; may; who; like; so that; how
escaños => seats
policía => police; policeman; police officer; cop; constable; policewoman; bobby; constabulary; officer; copper
capital => capital; capital city; fund; principal; main; central; centre; equity; great; metropolis
fahmi => fahmi
debería => should
mismo => same; myself; oneself; ourselves; yourself; self; himself; similar; very; equal
límites => bounds; compass; confines; court markings; grasp; limit; range; reach
inédita => unpublished
estirpes => stocks
evitar => avoid; avert; evade; circumvent; shun; elude; sidestep; steer clear of; eschew; prevent
husein => husein
mayoritaria => majoritarian
influencia => influence; leverage; ascendancy; impact; sway; power; clout; hold; reach; factor
a => to; at; a; for; into; in; on; belong; in order to; by
septiembre => September; september; Sep; Sept; September(septembro)
novedad => novelty; newness; fad; new book; new publication; new release; news; release; development; freshness
último => last; ultimate; final; latter; latest; utmost; end; past; recent; after
parlamento => parliament; legislature; parley; Parliament
incidente => incident; disruption; event; incidental; affair; contretemps; happening; occurrence; scene
nunca => never; ever; not even; nevermore; not ever; no; future; at no time; by no means; in no way
presentado => presented
martes => Tuesday; marten; martens; pine marten; tue; tuesday; Tuesday(mardo); beech marten; martes; sables
activó => active
fuertes => powerful
vuelta => change; lap; spin; turn; return; tour; junket; revolution; comeback; round
vio => he saw
comunistas => communists
amenazase => threaten
político => politician; political; statesman; politico; courteous; in-law; pol; politic; political leader; politics
antigua => old; ancient; erstwhile; old-fashioned; former; venerable
tendrá => will have
hombres => men; man; manhood; menfolk
se => they; you; itself; yourself; herself; be; yourselves; himself; themselves; each other
las => the; them; her; him; it; las; bullrope; lazy deckey; lazyline; the(la)
maliki => maliki
atacar => attack; assault; assail; charge; strike; come at; commit aggression; raid; affect; aggress
atribuirán => will attribute
salvar => save; rescue; escape; redeem; salvage; deliver; clear; keep; pass; salve
elegidos => chosen
ei => ei; saturation vapour pressure in the pure phase with respect to ice
body => infant bodysuit; onesie
afirma => it states
cada => every; each; either; all; any; everybody; everyone; single; @; at
digirió => digested
común => common; ordinary; usual; mutual; normal; ubiquitous; widespread; commonplace; joint; regular
elegir => choose; elect; pick; pick out; opt; name; select; vote; take; prefer
pensado => tought
frente => forehead; front; brow; battlefront; against; face; weather front; line; fore; forefront
confesional => denominational
inglés => English; Englishman; Sassenach; english; Briton; English language; English person; English(angla); Englishlanguage(anglalingvo); Englishpeople
función => function; use; office; job; capacity; performance; position; post; duty; part
tarde => evening; late; afternoon; night; even; eve; early evening; lately; tardy; belatedly
hora => hour; time; period; appointment; hr; minute; o'clock; age; date; lunchtime
abed => abed
cerró => hill
yihadistas => jihadists
dos => two; deuce; pair; second; couple; coxless pair; straight pair; twain; twenty; two(du)
casi => almost; nearly; practically; all but; just about; more or less; near; rough; about; virtually
dólares => dollars
votos => votes
de => from; of; off; about; out of; old; dee; for; mass noun; usurious
campaña => campaign; countryside; drive; country; cause; crusade; effort; movement; run; expedition
haider => haider
amenazas => threats
nivel => level; grade; situation; standard; notch; plane; spirit level; tier; layer; storey
militar => military; soldier; serviceman; war; martial; military personnel; be; man; military man; militate
escuela => school; schoolhouse; college; institute; university; class; department; elementary school; faculty; grade school
local => local; premises; place; regional; homegrown; locally; scene; site; venue; closed place
con => with; angle; tack; to; by; in; alongside; con; along; and
siglas => initials
comunidad => community; commonwealth; society; commune; commonality; outpost; union; body; family; village
economía => economy; economics; thrift; saving; thriftiness; economic science; bankrupt economy; economic; economic system; husbandry
seguir => follow; continue; keep; pursue; keep on; keep up; ensue; come after; trail; get on with
popular => popular; sticky; folk; common; demotic; famous; folksy; homespun; beloved; colloquial
partidos => matches
sus => its; their; one's; her; his; pig; your; Sus; Sus scrofa; grunter
kurdistán => kurdistan
uno => one; you; they; a; some; F; alone; an; identical; only
proporción => proportion; ratio; rate; proportionality; balance; relation; dimension; percentage; scaling; symmetry
norte => north; North; lodestar; northland; northward; up; N; North(nordo); above; due north
gobierno => government; administration; governance; control; rule; ascendance; ascendancy; board; executive; governorship
formación => formation; training; consist; education; background; array; lineup; geological formation; constitution; establishment
ninguna => no; no one; nobody; nil; not any
del => e-mail; email; of the; del
parte => part; elsewhere; portion; side; component; party; piece; report; section; bit
país => country; land; state; nation; area; people; place; region; territory; city
devastado => desolate; devastated
fuera => outside; out; away; off; abroad; other; afar; far; forth; outside of
estados => state
llave => key; wrench; tap; valve; spanner; curly bracket; lock; spigot; brace; dongle
retomaron => they resumed
organización => organization; organisation; control; running; association; establishment; administration; arrangement; outfit; system
suní => Sunni
alianza => alliance; covenant; wedding ring; league; wedding band; union; alignment; coalition; accord; agreement
fuerte => strong; loud; fort; hard; powerful; mighty; stronghold; fortress; tough; forte
pero => but; however; while; kink; yet; whereas; Pero; pear tree; and; nevertheless
sadam => sadam
prohibida => forbidden; prohibited
espacio => space; room; clearance; blank; gap; spacing; span; outer space; period; place
lucha => fight; struggle; wrestling; battle; strife; combat; conflict; fighting; quarrel; contest
urnas => urns
dominó => dominoes; domino
así => thus; so; such; thereby; consequently; like this; then; accordingly; like that; really
grupo => group; cluster; band; bunch; circle; gang; set; team; moiety; crowd
meses => month; months
periodo => period; menstruation; term; menses; menstrual period; length; stint; epoch; era; menorrhea
principal => main; principal; leading; primary; premier; chief; prime; arch; foremost; major
papel => paper; role; part; piece of paper; rag; rôle; character; function; note; office
anterior => previous; anterior; former; prior; preceding; last; back; earlier; foregoing; past
hadi => hadi
petrolera => oil
referéndum => referendum; plebiscite; strike ballot
otra => other; encore; another; elsewhere; somewhere else
fragmentación => fragmentation; spallation; splitting; chunking; comminution; content chunking; disk fragmentation; fragmentation of landholdings; fragmentation of lands; fragmentation of memory
voté => i voted
había => there was
región => region; area; district; zone; air hole; country; ballpark; land; nation; part
presentan => present
presentaron => presented
organizado => organized; organised
año => year; yr; grade; calendar year; twelvemonth; an; solar year; vent; -year-old; YY/YY
altos => tall
independencia => independence; independency; freedom; self-sufficiency; autonomy; self-reliance; self-direction; self-support
después => after; afterwards; next; then; later; afterward; behind; thereafter; subsequently; accordingly
tenor => tenor; strain; meaning; purport; sense; wording
cerrarán => they will close
esfumándose => fading
respondan => answer
esta => this; that; here; is; these; this here; this one
deficientes => deficient
provincias => provinces
representantes => representatives
nuri => nuri
marginal => marginal; fringe; fringy; hardscrabble; narrow
iraquíes => iraqi
centro => center; centre; middle; hub; midst; core; downtown; heart; nexus; nucleus
empañada => patty
compromisos => compromises
ocupando => occupying
explica => explain
día => day; daytime; daylight; payday; workday; day sky; one day; 24-hour interval; Valentine's day; birthday
victoria => victory; triumph; win; victoria; contest; ability; palm; stage win; victory(venko)
estado => state; status; condition; country; situation; nation; polity; standing; area; estate
saliente => outgoing; salient; projection; bulge; bump; hump; ledge; overhang; going out; incumbent
count => count
decena => ten; decade; tenner; 10; X; x
ser => be; being; get; belong; creature; equal; essence; exist; sire; come
dominan => dominate
supervisar => supervise; oversee; superintend; monitor; control; invigilate; keep; manage; ride herd on; be in charge
policías => policemen
nuevo => new; fresh; novel; young; recent; incoming; newfangled; strange; unused; New
religiosos => religious
iraq => iraq
podrían => could
proclamada => proclaimed
es => is; ace; microclimate; it's; anaplasmosis; -'s; are; phenomenon; that; there is
diputados => deputies
fronteras => borders
el => the; him; he; her; it; most; she; el; but; hers
muy => very; quite; way; well; wicked; highly; mighty; much; too; sorely
movilización => mobilization; mobilisation; mob; call-up
diciembre => December; Dec; december; December(decembro)
figuran => appear
amal => Amal; branch; branch duct; branch-off; branching; junction; pinion
jaafar => jaafar
contrario => opposite; contrary; adverse; opponent; cross; reverse; adversary; counter; unfavourable; inverse
debilitados => weakened
civiles => civilians
y => and; so what; what about; both; also; atque; but; nevertheless; that; which
haber => have; be; there be; credit; be born yesterday; supposed to; exist; holding; property; belong
desempleo => unemployment; joblessness; unemployed; redundancy; structural unemployment
causa => cause; reason; case; sake; action; factor; motive; occasion; why; grounds
conozcan => know
combatientes => fighters
irán => iran
estabilicen => stabilize
familia => family; household; kin; people; clan; kindred; parentage; relative; tribe; house
minoría => minority; minority group; few; nonage
queden => remain
número => number; numeral; amount; issue; count; hash; performance; act; figure; quantity
votado => voted
predecesor => predecessor; forefather; forerunner; herald; precursor; harbinger
resultados => aftermath; findings; results; aftereffect; finding; net earnings
veteranos => veterans
enemigos => enemies
cinco => five; basketball team; fifth; fifty; five(kvin); fiver
contra => against; versus; con; with; contrary to; counter; towards; contra; disadvantage; drawback
podría => could
tensiones => tensions
desempleado => unemployed; jobless; redundant; on the dole; out of work; idle; unemployment; out-of-work; unemployed person; without employment
liza => hippodrome; stadium; affray; arena; disturbance; fray; lists; mullet; ruffle
dictadura => dictatorship; tyranny; authoritarianism; despotism; totalitarianism; autocracy; Caesarism; Stalinism; absolutism; democracy
hakim => hakim
candidato => candidate; applicant; nominee; aspirant; hopeful; prospect; applicant party; aspirer; campaigner; contestant
alto => high; tall; alto; loud; lofty; stop; height; big; halt; higher
dispositivo => device; appliance; apparatus; gadget; disposition; mechanism; dispositive; artifice; contrivance; dodge
seis => six; units; six(ses); sixth; sixty
circulación => circulation; traffic; circulation of mud; currency; cycle; flow; movement; mud circulation; tfc; trade
moqtada => moqtada
menos => minus; less; fewer; least; to; of; little; except; lesser; short
para => for; in order to; to; toward; by; as for; childish; towards; grist; in order
ya => already; now; immediately; yet; any more; anymore; all right; by now; even; just
guerra => war; warfare; battle; wartime; fight; combat; conflict; hostility; argument; bastard purpleheart
caras => faces
cerca => near; close; fence; nearby; about; fencing; nigh; handy; by; fold
años => age; -year-old; years; -s; aged; birthday; long time
diwaniyah => diwaniyah
sistema => system; scheme; method; arrangement; array; framework; order; organisation; organization; setup
derrota => defeat; loss; course; licking; rout; route; track; contest; beating; debacle
llamados => called
colegios => colleges
controlan => they control
sábado => Saturday; Sabbath; sabbath; sat; saturday; Sabbatum; Sat; sabbat
deseos => wishes
legislatura => legislature; term; legislative term; Parliament; duration of a Parliament; legislative period; life of a Parliament; life of a parliament; term of office
pasado => past; stale; last; bygone; preterite; lit; past tense; previous; earlier; former
jugó => juice
facto => facto
jubilado => retiree; retired; pensioner; annuitant; emeritus; retired person; senior citizen; old age pensioner; pensionary; recipient
kirkuk => Kirkuk
tras => after; behind; upon; past; next; on; above; backside; can; following
sadr => sadr
pese => after; although; in spite of; though; despite
ammar => ammar
están => are; they are
la => the; it; her; la; A; him; lah; most; you; but
donde => where; whereof; wherein; wherever; at someone's home; in; place; at the home of; in which; where(kie1)
votación => voting; vote; poll; ballot; polling; balloting; division
calles => streets
militares => military personnel; soldiery; troops
abadi => Abadi
padre => father; parent; Father; dad; sire; daddy; mother; priest; male parent; fatherhood
su => her; his; its; their; your; one's; theirs; His; hers; you
espero => i hope
intercomunitarias => intercommunity
autónoma => autonomous
contexto => context; out of context; backdrop; background; circumstance; environment; scenario; setting; context of use; linguistic context
lacra => scar
perpetrada => perpetrated
electorales => electoral
los => the; them; her; him; it; los; Los; on; the Netherlands; those
vez => time; occasion; once; twice; times; turn; case; instance; mark; clip
voto => vote