regionales => regional
crucial => crucial
líder => leader
oficiales => official
provincia => province
sami => Sami
candidatos => candidates
hikma => hikma
encuentro => encounter
tropas => troops
millones => millions
corroe => corrode
desierta => deserted
karrada => karrada
isis => isis
mosul => mosul
irak => iraq
corrupción => corruption
impedir => impede
primer => primal
unidos => united
poder => power
sufren => suffer
febrero => February
lista => list
tres => three
confesionalismo => confessional
fuerzas => forces
por => for
política => politics
wadi => wadi
ministro => minister
incluyen => include
barrio => barrio
bagdad => baghdad
víctimas => victims
al => al
yihadista => jihadist
rehabilitar => rehabilitate
un => an
chiíes => shiites
dominante => dominant
islámico => Islamic
alí => ali
seguridad => security
estructuras => structures
mohamed => mohamed
reconstrucción => reconstruction
primera => former
dignatarios => dignitaries
kurdos => kurds
posición => position
cuatro => cuatro
cual => cual
recientemente => recently
han => Han
omar => omar
gubernamentales => governmental
violencia => violence
destrucción => destruction
datos => data
no => no
durante => during
en => in
este => east
apertura => aperture
electoral => electoral
preocupación => preoccupation
equilibrio => equilibrium
alterar => alter
amiri => amiri
desde => desde
invasión => invasion
organizados => organized
votar => vote
iraquí => Iraqi
territorios => territories
aliados => allies
punto => count
entre => entre
una => one
listas => lists
populista => populist
escaños => seats
policía => police
capital => capital
fahmi => fahmi
límites => limit
husein => husein
mayoritaria => majoritarian
influencia => influence
a => at
septiembre => September
novedad => novelty
último => ultimate
parlamento => parliament
incidente => incident
presentado => presented
martes => marten
activó => active
comunistas => communists
político => politician
antigua => ancient
se => be
las => las
maliki => maliki
atacar => attack
salvar => save
ei => ei
digirió => digested
común => common
elegir => elect
frente => front
confesional => denominational
inglés => English
función => function
tarde => tardy
hora => hour
abed => abed
yihadistas => jihadists
dólares => dollars
votos => votes
de => dee
campaña => campaign
haider => haider
nivel => level
militar => military
local => local
con => to
comunidad => community
economía => economy
popular => popular
sus => Sus
kurdistán => kurdistan
uno => an
proporción => proportion
norte => north
gobierno => government
formación => formation
del => del
parte => part
devastado => devastated
fuera => far
estados => state
organización => organization
alianza => alliance
fuerte => fort
pero => Pero
sadam => sadam
prohibida => forbidden
espacio => space
urnas => urns
dominó => dominoes
grupo => group
periodo => period
principal => principal
papel => paper
anterior => anterior
hadi => hadi
referéndum => referendum
otra => other
fragmentación => fragmentation
región => region
presentan => present
presentaron => presented
organizado => organized
independencia => independence
tenor => tenor
deficientes => deficient
provincias => provinces
representantes => representatives
nuri => nuri
marginal => marginal
iraquíes => iraqi
centro => center
compromisos => compromises
ocupando => occupying
explica => explain
victoria => victory
estado => state
saliente => salient
count => count
decena => decade
ser => be
dominan => dominate
supervisar => supervise
policías => policemen
religiosos => religious
iraq => iraq
proclamada => proclaimed
es => is
diputados => deputies
fronteras => borders
el => her
muy => much
movilización => mobilization
diciembre => December
amal => Amal
jaafar => jaafar
contrario => contrary
civiles => civilians
haber => have
causa => cause
irán => iran
estabilicen => stabilize
familia => family
minoría => minority
número => number
votado => voted
predecesor => predecessor
resultados => results
veteranos => veterans
enemigos => enemies
contra => counter
tensiones => tensions
dictadura => dictatorship
hakim => hakim
candidato => candidate
alto => alto
dispositivo => disposition
seis => six
circulación => circulation
moqtada => moqtada
menos => minus
para => for
ya => yet
años => age
diwaniyah => diwaniyah
sistema => system
derrota => defeat
colegios => colleges
sábado => Sabbath
legislatura => legislature
pasado => past
facto => facto
kirkuk => Kirkuk
sadr => sadr
pese => despite
ammar => ammar
la => la
abadi => Abadi
padre => father
intercomunitarias => intercommunity
autónoma => autonomous
contexto => context
perpetrada => perpetrated
electorales => electoral
los => los
voto => vote